,Player,Nation,Pos,Age,90s,Tkl,TklW,Def 3rd,Mid 3rd,Att 3rd,Tkl,Att,Tkl%,Lost,Blocks,Sh,Pass,Int,Tkl+Int,Clr,Err,Matches,Squad,League
0,David Raya,es ESP,GK,29-232,35.0,0,0,0,0,0,0,2,0.0,2,0,0,0,2,2,18,6,Matches,Arsenal,Premier-League
1,William Saliba,fr FRA,DF,24-042,32.3,60,36,35,23,2,21,27,77.8,6,24,15,9,21,81,111,6,Matches,Arsenal,Premier-League
2,Declan Rice,eng ENG,MF,26-111,29.4,52,24,21,25,6,16,37,43.2,21,24,11,13,25,77,44,0,Matches,Arsenal,Premier-League
3,Thomas Partey,gh GHA,"MF,DF",31-326,28.1,80,49,23,37,20,44,72,61.1,28,25,7,18,33,113,46,4,Matches,Arsenal,Premier-League
4,Gabriel Magalhães,br BRA,DF,27-137,26.3,25,15,12,8,5,12,16,75.0,4,42,29,13,16,41,93,2,Matches,Arsenal,Premier-League
5,Jurriën Timber,nl NED,DF,23-322,26.9,58,38,17,30,11,18,27,66.7,9,19,4,15,22,80,44,1,Matches,Arsenal,Premier-League
6,Leandro Trossard,be BEL,FW,30-152,26.2,26,17,5,14,7,9,31,29.0,22,31,0,31,9,35,17,0,Matches,Arsenal,Premier-League
7,Martin Ødegaard,no NOR,MF,26-139,23.7,19,11,9,7,3,4,24,16.7,20,5,0,5,4,23,5,1,Matches,Arsenal,Premier-League
8,Gabriel Martinelli,br BRA,"FW,MF",23-321,22.7,20,15,8,5,7,7,23,30.4,16,10,0,10,4,24,15,0,Matches,Arsenal,Premier-League
9,Kai Havertz,de GER,"FW,MF",25-328,20.4,16,9,3,6,7,4,15,26.7,11,22,4,18,6,22,31,1,Matches,Arsenal,Premier-League
10,Bukayo Saka,eng ENG,"FW,MF",23-242,17.1,24,13,7,10,7,11,22,50.0,11,21,0,21,3,27,8,0,Matches,Arsenal,Premier-League
11,Mikel Merino,es ESP,"MF,FW",28-317,15.8,38,22,6,21,11,15,29,51.7,14,18,5,13,14,52,24,1,Matches,Arsenal,Premier-League
12,Myles Lewis-Skelly,eng ENG,DF,18-221,13.0,22,14,10,9,3,10,10,100.0,0,2,1,1,6,28,20,0,Matches,Arsenal,Premier-League
13,Riccardo Calafiori,it ITA,DF,22-351,10.3,26,18,15,9,2,18,29,62.1,11,12,6,6,9,35,25,0,Matches,Arsenal,Premier-League
14,Ben White,eng ENG,DF,27-209,10.5,13,9,9,2,2,11,28,39.3,17,9,7,2,15,28,35,0,Matches,Arsenal,Premier-League
15,Ethan Nwaneri,eng ENG,"FW,MF",18-045,9.1,11,7,4,4,3,7,18,38.9,11,8,2,6,2,13,4,1,Matches,Arsenal,Premier-League
16,Jorginho,it ITA,MF,33-136,7.8,12,4,1,7,4,8,20,40.0,12,3,0,3,7,19,2,2,Matches,Arsenal,Premier-League
17,Jakub Kiwior,pl POL,DF,25-079,9.5,13,7,7,5,1,8,11,72.7,3,8,5,3,3,16,37,2,Matches,Arsenal,Premier-League
18,Gabriel Jesus,br BRA,FW,28-032,6.8,10,6,4,3,3,4,9,44.4,5,10,1,9,4,14,8,0,Matches,Arsenal,Premier-League
19,Raheem Sterling,eng ENG,"FW,MF",30-148,4.9,8,4,1,2,5,4,8,50.0,4,3,0,3,1,9,3,0,Matches,Arsenal,Premier-League
20,Oleksandr Zinchenko,ua UKR,"DF,MF",28-141,5.1,4,1,1,2,1,2,7,28.6,5,5,0,5,4,8,6,0,Matches,Arsenal,Premier-League
21,Kieran Tierney,sct SCO,"DF,FW",27-334,2.0,5,4,3,1,1,3,5,60.0,2,0,0,0,2,7,5,0,Matches,Arsenal,Premier-League
22,Nathan Butler-Oyedeji,eng ENG,FW,22-121,0.1,0,0,0,0,0,0,0,,0,0,0,0,0,0,0,0,Matches,Arsenal,Premier-League
23,Takehiro Tomiyasu,jp JPN,DF,26-181,0.1,0,0,0,0,0,0,0,,0,0,0,0,0,0,1,0,Matches,Arsenal,Premier-League
24,Reiss Nelson,eng ENG,FW,25-146,0.0,1,0,0,1,0,0,1,0.0,1,0,0,0,0,1,1,0,Matches,Arsenal,Premier-League
25,Youri Tielemans,be BEL,MF,27-363,33.3,83,57,31,44,8,40,73,54.8,33,37,16,21,22,105,47,4,Matches,Aston-Villa,Premier-League
26,Emiliano Martínez,ar ARG,GK,32-245,33.0,3,3,3,0,0,2,2,100.0,0,1,0,1,0,3,17,6,Matches,Aston-Villa,Premier-League
27,Morgan Rogers,eng ENG,"FW,MF",22-283,31.7,36,18,13,13,10,19,39,48.7,20,25,7,18,5,41,19,2,Matches,Aston-Villa,Premier-League
28,Ezri Konsa,eng ENG,DF,27-194,29.6,32,17,19,9,4,18,22,81.8,4,18,10,8,21,53,101,4,Matches,Aston-Villa,Premier-League
29,Ollie Watkins,eng ENG,FW,29-126,25.9,9,6,0,5,4,3,11,27.3,8,11,3,8,8,17,15,2,Matches,Aston-Villa,Premier-League
30,Lucas Digne,fr FRA,DF,31-289,25.1,63,37,38,16,9,43,64,67.2,21,23,4,19,25,88,85,1,Matches,Aston-Villa,Premier-League
31,John McGinn,sct SCO,"MF,FW",30-199,22.8,31,22,10,13,8,11,27,40.7,16,21,2,19,14,45,16,3,Matches,Aston-Villa,Premier-League
32,Pau Torres,es ESP,DF,28-109,20.2,20,14,11,7,2,9,15,60.0,6,14,10,4,9,29,65,2,Matches,Aston-Villa,Premier-League
33,Matty Cash,pl POL,DF,27-271,20.0,47,27,25,19,3,24,34,70.6,10,18,7,11,21,68,57,2,Matches,Aston-Villa,Premier-League
34,Jacob Ramsey,eng ENG,"FW,MF",23-342,16.8,30,15,14,10,6,10,20,50.0,10,21,3,18,7,37,8,1,Matches,Aston-Villa,Premier-League
35,Boubacar Kamara,fr FRA,MF,25-163,16.3,49,20,28,17,4,28,54,51.9,26,17,7,10,17,66,48,3,Matches,Aston-Villa,Premier-League
36,Amadou Onana,be BEL,MF,23-262,15.3,47,24,21,22,4,14,26,53.8,12,14,6,8,24,71,37,3,Matches,Aston-Villa,Premier-League
37,Leon Bailey,jm JAM,"FW,MF",27-269,12.6,6,4,1,3,2,2,10,20.0,8,6,0,6,3,9,12,0,Matches,Aston-Villa,Premier-League
38,Tyrone Mings,eng ENG,DF,32-053,11.7,6,5,5,1,0,2,2,100.0,0,13,11,2,7,13,58,1,Matches,Aston-Villa,Premier-League
39,Ian Maatsen,nl NED,DF,23-056,10.6,27,15,16,8,3,16,22,72.7,6,11,0,11,15,42,33,2,Matches,Aston-Villa,Premier-League
40,Diego Carlos,br BRA,DF,32-051,9.2,8,3,6,1,1,4,6,66.7,2,13,7,6,5,13,36,2,Matches,Aston-Villa,Premier-League
41,Marco Asensio,es ESP,"MF,FW",29-104,6.0,7,5,0,7,0,3,9,33.3,6,2,0,2,1,8,3,0,Matches,Aston-Villa,Premier-League
42,Axel Disasi,fr FRA,DF,27-055,5.4,8,5,7,1,0,3,7,42.9,4,4,1,3,5,13,18,0,Matches,Aston-Villa,Premier-League
43,Lamare Bogarde,nl NED,"DF,MF",21-120,5.3,14,6,6,6,2,10,16,62.5,6,5,3,2,1,15,13,0,Matches,Aston-Villa,Premier-League
44,Andrés García,es ESP,"DF,MF",22-087,3.5,9,5,5,3,1,4,8,50.0,4,2,0,2,2,11,10,2,Matches,Aston-Villa,Premier-League
45,Jáder Durán,co COL,FW,21-143,7.1,8,7,1,2,5,1,4,25.0,3,5,0,5,0,8,13,0,Matches,Aston-Villa,Premier-League
46,Marcus Rashford,eng ENG,FW,27-186,4.9,10,7,2,3,5,4,6,66.7,2,2,0,2,1,11,3,0,Matches,Aston-Villa,Premier-League
47,Ross Barkley,eng ENG,MF,31-151,6.3,14,3,4,10,0,9,14,64.3,5,9,3,6,10,24,5,0,Matches,Aston-Villa,Premier-League
48,Jaden Philogene Bidace,eng ENG,"FW,MF",23-086,3.7,11,5,4,7,0,4,6,66.7,2,5,0,5,3,14,2,1,Matches,Aston-Villa,Premier-League
49,Donyell Malen,nl NED,FW,26-116,3.3,7,4,3,3,1,1,4,25.0,3,1,0,1,0,7,1,0,Matches,Aston-Villa,Premier-League
50,Robin Olsen,se SWE,GK,35-117,2.0,1,0,1,0,0,1,1,100.0,0,0,0,0,0,1,2,1,Matches,Aston-Villa,Premier-League
51,Kosta Nedeljković,rs SRB,DF,19-140,1.4,7,5,1,3,3,2,3,66.7,1,1,0,1,0,7,3,0,Matches,Aston-Villa,Premier-League
52,Emi Buendía,ar ARG,"MF,FW",28-131,1.1,6,6,3,2,1,0,5,0.0,5,5,1,4,0,6,2,0,Matches,Aston-Villa,Premier-League
53,Milos Kerkez,hu HUN,DF,21-180,34.2,50,26,25,19,6,23,37,62.2,14,36,11,25,42,92,103,3,Matches,Bournemouth,Premier-League
54,Antoine Semenyo,gh GHA,FW,25-119,32.6,53,34,16,24,13,16,42,38.1,26,59,8,51,10,63,35,1,Matches,Bournemouth,Premier-League
55,Illia Zabarnyi,ua UKR,DF,22-247,31.6,46,32,26,19,1,30,44,68.2,14,33,20,13,38,84,165,2,Matches,Bournemouth,Premier-League
56,Lewis Cook,eng ENG,"MF,DF",28-092,31.3,80,42,41,35,4,36,66,54.5,30,30,11,19,40,120,66,0,Matches,Bournemouth,Premier-League
57,Kepa Arrizabalaga,es ESP,GK,30-215,28.0,1,0,1,0,0,0,2,0.0,2,1,0,1,0,1,14,3,Matches,Bournemouth,Premier-League
58,Justin Kluivert,nl NED,"MF,FW",26-001,24.0,21,9,4,10,7,4,21,19.0,17,24,0,24,13,34,23,1,Matches,Bournemouth,Premier-League
59,Ryan Christie,sct SCO,MF,30-073,23.5,54,33,19,27,8,27,64,42.2,37,44,11,33,30,84,51,3,Matches,Bournemouth,Premier-League
60,Evanilson,br BRA,FW,25-212,22.9,16,10,6,5,5,8,12,66.7,4,10,2,8,0,16,21,0,Matches,Bournemouth,Premier-League
61,Dean Huijsen,es ESP,DF,20-022,24.8,33,23,16,16,1,15,25,60.0,10,36,28,8,49,82,175,4,Matches,Bournemouth,Premier-League
62,Dango Ouattara,bf BFA,FW,23-084,22.3,35,26,14,11,10,17,41,41.5,24,36,10,26,11,46,51,0,Matches,Bournemouth,Premier-League
63,Tyler Adams,us USA,MF,26-081,19.0,75,46,24,44,7,35,66,53.0,31,33,10,23,32,107,38,0,Matches,Bournemouth,Premier-League
64,Marcus Tavernier,eng ENG,"FW,MF",26-045,18.6,41,24,14,18,9,10,26,38.5,16,16,3,13,5,46,11,0,Matches,Bournemouth,Premier-League
65,Adam Smith,eng ENG,DF,34-007,15.7,21,10,10,5,6,12,25,48.0,13,12,5,7,14,35,47,1,Matches,Bournemouth,Premier-League
66,Marcos Senesi,ar ARG,DF,27-361,11.3,35,21,22,11,2,14,30,46.7,16,15,7,8,11,46,54,0,Matches,Bournemouth,Premier-League
67,David Brooks,wls WAL,"FW,MF",27-302,9.2,11,4,2,6,3,1,14,7.1,13,16,2,14,5,16,8,1,Matches,Bournemouth,Premier-League
68,Alex Scott,eng ENG,MF,21-258,7.9,26,13,10,8,8,18,40,45.0,22,17,4,13,10,36,13,0,Matches,Bournemouth,Premier-League
69,James Hill,eng ENG,DF,23-116,5.0,15,8,6,6,3,3,11,27.3,8,5,0,5,9,24,31,0,Matches,Bournemouth,Premier-League
70,Julian Araujo,mx MEX,DF,23-266,4.7,8,3,4,4,0,5,12,41.7,7,3,0,3,6,14,16,0,Matches,Bournemouth,Premier-League
71,Mark Travers,ie IRL,GK,25-353,5.0,0,0,0,0,0,0,0,,0,0,0,0,0,0,5,0,Matches,Bournemouth,Premier-League
72,Enes Ünal,tr TUR,"FW,MF",27-361,3.8,1,0,0,0,1,0,3,0.0,3,1,0,1,0,1,6,0,Matches,Bournemouth,Premier-League
73,Neto,br BRA,GK,35-291,2.0,0,0,0,0,0,0,0,,0,0,0,0,0,0,1,1,Matches,Bournemouth,Premier-League
74,Luis Sinisterra,co COL,"FW,MF",25-323,2.6,7,2,3,2,2,0,4,0.0,4,3,0,3,1,8,8,0,Matches,Bournemouth,Premier-League
75,Philip Billing,dk DEN,MF,28-329,2.0,14,5,7,6,1,3,4,75.0,1,3,0,3,5,19,2,0,Matches,Bournemouth,Premier-League
76,Max Aarons,eng ENG,DF,25-122,1.0,2,2,1,1,0,1,1,100.0,0,3,1,2,1,3,0,0,Matches,Bournemouth,Premier-League
77,Daniel Jebbison,eng ENG,FW,21-266,0.9,3,2,2,1,0,3,5,60.0,2,2,1,1,1,4,1,0,Matches,Bournemouth,Premier-League
78,Ben Winterburn,eng ENG,"FW,MF",20-244,0.3,0,0,0,0,0,0,1,0.0,1,0,0,0,2,2,0,0,Matches,Bournemouth,Premier-League
79,Julio Soler,ar ARG,FW,20-079,0.0,1,1,1,0,0,1,1,100.0,0,1,0,1,0,1,0,0,Matches,Bournemouth,Premier-League
80,Remy Rees-Dottin,eng ENG,FW,19-061,0.0,0,0,0,0,0,0,0,,0,0,0,0,0,0,0,0,Matches,Bournemouth,Premier-League
81,Zain Silcott-Duberry,ms MSR,FW,19-301,0.0,1,1,0,0,1,1,1,100.0,0,0,0,0,0,1,0,0,Matches,Bournemouth,Premier-League
82,Nathan Collins,ie IRL,DF,24-005,35.0,37,22,22,11,4,22,34,64.7,12,71,51,20,32,69,214,2,Matches,Brentford,Premier-League
83,Bryan Mbeumo,cm CMR,FW,25-271,34.9,45,29,17,14,14,18,31,58.1,13,24,3,21,14,59,48,1,Matches,Brentford,Premier-League
84,Mark Flekken,nl NED,GK,31-326,33.4,4,4,4,0,0,3,9,33.3,6,2,0,2,0,4,26,4,Matches,Brentford,Premier-League
85,Keane Lewis-Potter,eng ENG,"DF,FW",24-072,31.5,44,26,23,15,6,26,44,59.1,18,24,9,15,19,63,71,3,Matches,Brentford,Premier-League
86,Mikkel Damsgaard,dk DEN,"MF,FW",24-306,29.5,78,43,27,26,25,28,72,38.9,44,36,2,34,26,104,30,2,Matches,Brentford,Premier-League
87,Yoane Wissa,cd COD,FW,28-244,29.4,22,12,6,8,8,11,27,40.7,16,29,8,21,8,30,20,3,Matches,Brentford,Premier-League
88,Christian Nørgaard,dk DEN,MF,31-056,28.3,75,45,34,34,7,44,71,62.0,27,51,19,32,45,120,65,1,Matches,Brentford,Premier-League
89,Vitaly Janelt,de GER,MF,26-360,25.0,38,22,14,13,11,21,36,58.3,15,33,9,24,27,65,53,1,Matches,Brentford,Premier-League
90,Sepp van den Berg,nl NED,DF,23-136,25.7,37,22,23,10,4,18,27,66.7,9,50,36,14,20,57,118,2,Matches,Brentford,Premier-League
91,Kevin Schade,de GER,FW,23-159,23.0,35,23,14,10,11,12,20,60.0,8,17,2,15,5,40,31,0,Matches,Brentford,Premier-League
92,Ethan Pinnock,jm JAM,DF,31-341,21.3,35,19,15,16,4,13,24,54.2,11,29,18,11,24,59,142,4,Matches,Brentford,Premier-League
93,Kristoffer Ajer,no NOR,DF,27-018,15.6,25,17,14,10,1,14,26,53.8,12,17,4,13,12,37,49,0,Matches,Brentford,Premier-League
94,Yehor Yarmoliuk,ua UKR,MF,21-065,13.3,39,24,14,19,6,23,46,50.0,23,24,7,17,10,49,31,0,Matches,Brentford,Premier-League
95,Mads Roerslev,dk DEN,DF,25-315,12.2,18,8,14,3,1,11,28,39.3,17,12,5,7,4,22,35,0,Matches,Brentford,Premier-League
96,Mathias Jensen,dk DEN,MF,29-124,9.1,13,9,6,5,2,7,15,46.7,8,13,4,9,8,21,13,1,Matches,Brentford,Premier-League
97,Fabio Carvalho,pt POR,"FW,MF",22-248,5.1,13,9,4,4,5,6,13,46.2,7,6,1,5,3,16,2,0,Matches,Brentford,Premier-League
98,Michael Kayode,it ITA,DF,20-299,3.2,13,8,9,4,0,7,7,100.0,0,0,0,0,4,17,13,0,Matches,Brentford,Premier-League
99,Ben Mee,eng ENG,DF,35-226,2.0,2,2,0,2,0,1,1,100.0,0,3,3,0,4,6,7,0,Matches,Brentford,Premier-League
100,Hákon Rafn Valdimarsson,is ISL,GK,23-204,1.6,0,0,0,0,0,0,0,,0,0,0,0,0,0,2,0,Matches,Brentford,Premier-League
101,Thiago,br BRA,FW,23-313,1.6,3,2,1,0,2,0,1,0.0,1,2,0,2,2,5,2,1,Matches,Brentford,Premier-League
102,Edmond-Paris Maghoma,eng ENG,"MF,FW",23-362,1.3,2,1,0,2,0,1,3,33.3,2,2,2,0,1,3,2,0,Matches,Brentford,Premier-League
103,Rico Henry,eng ENG,DF,27-301,0.9,0,0,0,0,0,0,4,0.0,4,3,1,2,1,1,2,0,Matches,Brentford,Premier-League
104,Yunus Emre Konak,tr TUR,"FW,MF",19-115,0.5,4,4,0,4,0,1,2,50.0,1,2,0,2,0,4,0,0,Matches,Brentford,Premier-League
105,Kim Jisoo,kr KOR,DF,20-132,0.3,0,0,0,0,0,0,0,,0,0,0,0,0,0,2,0,Matches,Brentford,Premier-League
106,Frank Onyeka,ng NGA,MF,27-124,0.3,0,0,0,0,0,0,0,,0,0,0,0,0,0,0,0,Matches,Brentford,Premier-League
107,Gustavo Nunes,br BRA,"FW,MF",19-166,0.1,3,2,2,0,1,2,2,100.0,0,0,0,0,0,3,2,0,Matches,Brentford,Premier-League
108,Jayden Meghoma,eng ENG,DF,18-311,0.1,0,0,0,0,0,0,0,,0,0,0,0,0,0,0,0,Matches,Brentford,Premier-League
109,Ryan Trevitt,eng ENG,MF,22-054,0.0,1,1,1,0,0,0,0,,0,0,0,0,0,1,0,0,Matches,Brentford,Premier-League
110,Bart Verbruggen,nl NED,GK,22-261,33.0,0,0,0,0,0,0,3,0.0,3,1,0,1,0,0,28,5,Matches,Brighton-and-Hove-Albion,Premier-League
111,Jan Paul van Hecke,nl NED,DF,24-332,29.9,40,26,20,19,1,20,38,52.6,18,32,19,13,23,63,132,2,Matches,Brighton-and-Hove-Albion,Premier-League
112,Kaoru Mitoma,jp JPN,"FW,MF",27-351,28.0,43,26,14,13,16,18,46,39.1,28,46,3,43,13,56,10,0,Matches,Brighton-and-Hove-Albion,Premier-League
113,Carlos Baleba,cm CMR,MF,21-123,26.7,71,41,24,32,15,44,72,61.1,28,44,10,34,40,111,41,1,Matches,Brighton-and-Hove-Albion,Premier-League
114,Pervis Estupiñán,ec ECU,DF,27-105,24.7,58,39,30,21,7,31,46,67.4,15,16,2,14,34,92,55,2,Matches,Brighton-and-Hove-Albion,Premier-League
115,Lewis Dunk,eng ENG,DF,33-166,23.1,17,10,8,7,2,11,19,57.9,8,28,18,10,13,30,79,2,Matches,Brighton-and-Hove-Albion,Premier-League
116,João Pedro,br BRA,"FW,MF",23-222,21.6,16,12,6,6,4,4,11,36.4,7,12,0,12,9,25,12,0,Matches,Brighton-and-Hove-Albion,Premier-League
117,Danny Welbeck,eng ENG,FW,34-161,21.6,23,14,6,12,5,7,18,38.9,11,17,2,15,5,28,13,0,Matches,Brighton-and-Hove-Albion,Premier-League
118,Jack Hinshelwood,eng ENG,"DF,MF",20-025,19.4,26,18,8,10,8,11,27,40.7,16,8,3,5,15,41,37,1,Matches,Brighton-and-Hove-Albion,Premier-League
119,Yasin Ayari,se SWE,MF,21-212,19.5,54,29,15,29,10,21,51,41.2,30,23,6,17,20,74,24,0,Matches,Brighton-and-Hove-Albion,Premier-League
120,Joël Veltman,nl NED,DF,33-111,18.5,42,28,23,16,3,30,51,58.8,21,22,7,15,18,60,66,0,Matches,Brighton-and-Hove-Albion,Premier-League
121,Georginio Rutter,fr FRA,"MF,FW",23-016,18.4,39,15,13,18,8,14,36,38.9,22,20,3,17,10,49,13,2,Matches,Brighton-and-Hove-Albion,Premier-League
122,Yankuba Minteh,gm GAM,"FW,MF",20-288,17.6,45,32,24,13,8,17,45,37.8,28,20,0,20,11,56,31,0,Matches,Brighton-and-Hove-Albion,Premier-League
123,Simon Adingra,ci CIV,"FW,MF",23-125,10.6,23,14,10,8,5,10,22,45.5,12,12,0,12,8,31,6,1,Matches,Brighton-and-Hove-Albion,Premier-League
124,Matt O'Riley,dk DEN,MF,24-166,9.4,15,9,4,8,3,4,12,33.3,8,7,3,4,13,28,8,1,Matches,Brighton-and-Hove-Albion,Premier-League
125,Igor,br BRA,DF,27-088,10.0,4,4,2,1,1,4,10,40.0,6,23,14,9,4,8,39,1,Matches,Brighton-and-Hove-Albion,Premier-League
126,Tariq Lamptey,gh GHA,DF,24-218,8.9,14,10,8,6,0,7,22,31.8,15,14,7,7,6,20,22,1,Matches,Brighton-and-Hove-Albion,Premier-League
127,Adam Webster,eng ENG,DF,30-122,6.9,8,5,4,3,1,5,11,45.5,6,12,9,3,14,22,28,1,Matches,Brighton-and-Hove-Albion,Premier-League
128,Mats Wieffer,nl NED,"MF,DF",25-171,8.3,37,22,15,18,4,19,31,61.3,12,13,1,12,13,50,18,3,Matches,Brighton-and-Hove-Albion,Premier-League
129,Brajan Gruda,de GER,"FW,MF",20-340,5.6,14,6,6,5,3,7,14,50.0,7,8,0,8,2,16,5,1,Matches,Brighton-and-Hove-Albion,Premier-League
130,Ferdi Kadioglu,tr TUR,"DF,MF",25-211,4.3,10,6,4,5,1,6,15,40.0,9,2,2,0,8,18,17,0,Matches,Brighton-and-Hove-Albion,Premier-League
131,Diego Gómez,py PAR,MF,22-040,4.9,17,10,8,7,2,9,18,50.0,9,11,0,11,7,24,9,1,Matches,Brighton-and-Hove-Albion,Premier-League
132,James Milner,eng ENG,MF,39-122,1.9,5,2,1,3,1,3,3,100.0,0,4,2,2,2,7,2,1,Matches,Brighton-and-Hove-Albion,Premier-League
133,Julio Enciso,py PAR,"MF,FW",21-103,3.3,0,0,0,0,0,0,2,0.0,2,2,0,2,0,0,1,0,Matches,Brighton-and-Hove-Albion,Premier-League
134,Evan Ferguson,ie IRL,FW,20-199,2.7,4,3,0,3,1,2,5,40.0,3,3,1,2,0,4,4,0,Matches,Brighton-and-Hove-Albion,Premier-League
135,Jason Steele,eng ENG,GK,34-261,2.0,0,0,0,0,0,0,0,,0,0,0,0,0,0,1,0,Matches,Brighton-and-Hove-Albion,Premier-League
136,Solly March,eng ENG,"FW,MF",30-290,1.9,6,3,2,2,2,5,8,62.5,3,3,0,3,2,8,2,1,Matches,Brighton-and-Hove-Albion,Premier-League
137,Billy Gilmour,sct SCO,MF,23-329,1.1,3,3,2,1,0,3,4,75.0,1,1,0,1,0,3,1,0,Matches,Brighton-and-Hove-Albion,Premier-League
138,Eiran Cashin,ie IRL,DF,23-178,0.2,0,0,0,0,0,0,1,0.0,1,0,0,0,0,0,2,0,Matches,Brighton-and-Hove-Albion,Premier-League
139,Jakub Moder,pl POL,MF,26-029,0.1,1,0,1,0,0,0,2,0.0,2,0,0,0,0,1,3,0,Matches,Brighton-and-Hove-Albion,Premier-League
140,Jeremy Sarmiento,ec ECU,MF,22-324,0.1,0,0,0,0,0,0,0,,0,0,0,0,0,0,0,0,Matches,Brighton-and-Hove-Albion,Premier-League
141,Moisés Caicedo,ec ECU,"MF,DF",23-184,34.2,103,64,37,51,15,50,80,62.5,30,45,10,35,49,152,52,1,Matches,Chelsea,Premier-League
142,Cole Palmer,eng ENG,MF,22-364,32.5,27,17,11,9,7,9,23,39.1,14,14,1,13,11,38,18,1,Matches,Chelsea,Premier-League
143,Levi Colwill,eng ENG,DF,22-068,32.0,42,30,22,17,3,16,25,64.0,9,35,24,11,32,74,104,4,Matches,Chelsea,Premier-League
144,Marc Cucurella,es ESP,DF,26-287,30.2,59,39,30,24,5,26,53,49.1,27,45,14,31,25,84,84,3,Matches,Chelsea,Premier-League
145,Enzo Fernández,ar ARG,MF,24-108,29.7,63,32,17,29,17,31,83,37.3,52,36,7,29,13,76,22,4,Matches,Chelsea,Premier-League
146,Robert Sánchez,es ESP,GK,27-168,29.0,0,0,0,0,0,0,1,0.0,1,0,0,0,2,2,20,9,Matches,Chelsea,Premier-League
147,Nicolas Jackson,sn SEN,FW,23-319,24.3,22,13,6,7,9,5,10,50.0,5,14,2,12,3,25,15,0,Matches,Chelsea,Premier-League
148,Noni Madueke,eng ENG,FW,23-056,20.1,22,15,7,12,3,13,34,38.2,21,17,0,17,8,30,11,0,Matches,Chelsea,Premier-League
149,Pedro Neto,pt POR,FW,25-057,22.4,22,9,9,9,4,8,19,42.1,11,13,2,11,9,31,6,0,Matches,Chelsea,Premier-League
150,Malo Gusto,fr FRA,DF,21-351,20.4,43,28,26,15,2,24,47,51.1,23,29,8,21,23,66,48,5,Matches,Chelsea,Premier-League
151,Jadon Sancho,eng ENG,FW,25-041,18.7,10,6,3,2,5,5,12,41.7,7,9,0,9,2,12,6,2,Matches,Chelsea,Premier-League
152,Wesley Fofana,fr FRA,DF,24-139,13.0,13,12,6,7,0,6,14,42.9,8,14,9,5,14,27,55,2,Matches,Chelsea,Premier-League
153,Tosin Adarabioyo,eng ENG,DF,27-223,13.7,14,10,10,4,0,8,12,66.7,4,9,7,2,10,24,62,0,Matches,Chelsea,Premier-League
154,Reece James,eng ENG,"DF,MF",25-148,9.3,9,9,5,3,1,3,9,33.3,6,12,4,8,12,21,18,4,Matches,Chelsea,Premier-League
155,Trevoh Chalobah,eng ENG,DF,25-304,9.3,10,6,4,6,0,6,7,85.7,1,5,2,3,9,19,46,1,Matches,Chelsea,Premier-League
156,Roméo Lavia,be BEL,MF,21-119,7.6,21,13,5,12,4,9,19,47.4,10,6,0,6,14,35,8,0,Matches,Chelsea,Premier-League
157,Christopher Nkunku,fr FRA,FW,27-172,10.2,12,8,3,4,5,6,8,75.0,2,9,2,7,7,19,10,0,Matches,Chelsea,Premier-League
158,Filip Jørgensen,dk DEN,GK,23-019,6.0,0,0,0,0,0,0,0,,0,0,0,0,0,0,0,3,Matches,Chelsea,Premier-League
159,Axel Disasi,fr FRA,DF,27-055,4.0,7,4,5,1,1,6,11,54.5,5,4,1,3,2,9,11,1,Matches,Chelsea,Premier-League
160,João Félix,pt POR,"FW,MF",25-176,4.1,8,3,2,5,1,5,9,55.6,4,2,0,2,3,11,2,0,Matches,Chelsea,Premier-League
161,Benoît Badiashile,fr FRA,DF,24-040,3.7,9,6,5,4,0,4,5,80.0,1,2,2,0,6,15,12,2,Matches,Chelsea,Premier-League
162,Kiernan Dewsbury-Hall,eng ENG,"MF,FW",26-241,2.9,8,5,1,1,6,4,6,66.7,2,2,0,2,1,9,8,1,Matches,Chelsea,Premier-League
163,Joshua Acheampong,eng ENG,DF,19-000,1.9,2,1,2,0,0,2,2,100.0,0,1,0,1,1,3,2,0,Matches,Chelsea,Premier-League
164,Renato Veiga,pt POR,"DF,MF",21-280,2.0,9,6,6,3,0,4,12,33.3,8,3,1,2,1,10,2,0,Matches,Chelsea,Premier-League
165,Mykhailo Mudryk,ua UKR,FW,24-120,1.7,2,2,2,0,0,0,0,,0,3,1,2,0,2,1,0,Matches,Chelsea,Premier-League
166,Tyrique George,eng ENG,FW,19-090,1.1,2,0,2,0,0,2,3,66.7,1,0,0,0,1,3,1,0,Matches,Chelsea,Premier-League
167,Marc Guiu,es ESP,FW,19-121,0.8,1,1,0,1,0,1,1,100.0,0,0,0,0,0,1,0,0,Matches,Chelsea,Premier-League
168,Mathis Amougou,fr FRA,MF,19-107,0.1,0,0,0,0,0,0,0,,0,0,0,0,0,0,0,0,Matches,Chelsea,Premier-League
169,Shumaira Mheuka,eng ENG,MF,17-197,0.0,0,0,0,0,0,0,0,,0,0,0,0,0,0,0,0,Matches,Chelsea,Premier-League
170,Dean Henderson,eng ENG,GK,28-054,34.0,2,1,2,0,0,2,6,33.3,4,0,0,0,0,2,21,0,Matches,Crystal-Palace,Premier-League
171,Tyrick Mitchell,eng ENG,DF,25-246,31.7,85,52,53,25,7,21,41,51.2,20,62,12,50,14,99,97,2,Matches,Crystal-Palace,Premier-League
172,Daniel Muñoz,co COL,DF,28-344,31.9,109,70,52,34,23,49,86,57.0,37,35,3,32,39,148,97,1,Matches,Crystal-Palace,Premier-League
173,Marc Guéhi,eng ENG,DF,24-296,32.0,56,31,32,22,2,30,45,66.7,15,53,22,31,25,81,148,2,Matches,Crystal-Palace,Premier-League
174,Maxence Lacroix,fr FRA,DF,25-029,30.6,67,40,51,15,1,32,47,68.1,15,41,16,25,50,117,181,2,Matches,Crystal-Palace,Premier-League
175,Jean-Philippe Mateta,fr FRA,FW,27-311,27.1,17,12,4,11,2,3,16,18.8,13,16,3,13,2,19,22,0,Matches,Crystal-Palace,Premier-League
176,Eberechi Eze,eng ENG,"MF,FW",26-310,26.0,37,22,13,15,9,17,35,48.6,18,26,0,26,11,48,9,3,Matches,Crystal-Palace,Premier-League
177,Ismaila Sarr,sn SEN,"MF,FW",27-069,26.6,21,10,9,9,3,7,23,30.4,16,22,7,15,8,29,34,0,Matches,Crystal-Palace,Premier-League
178,Jefferson Lerma,co COL,"MF,DF",30-192,22.6,30,15,12,14,4,17,33,51.5,16,32,15,17,36,66,63,1,Matches,Crystal-Palace,Premier-League
179,Will Hughes,eng ENG,MF,30-018,20.8,61,33,17,31,13,27,59,45.8,32,29,14,15,19,80,23,3,Matches,Crystal-Palace,Premier-League
180,Chris Richards,us USA,DF,25-038,17.4,42,27,20,17,5,23,38,60.5,15,35,13,22,10,52,96,0,Matches,Crystal-Palace,Premier-League
181,Adam Wharton,eng ENG,MF,20-337,14.0,34,14,14,16,4,17,43,39.5,26,10,2,8,18,52,25,0,Matches,Crystal-Palace,Premier-League
182,Daichi Kamada,jp JPN,MF,28-273,14.9,43,25,17,22,4,12,37,32.4,25,19,4,15,16,59,13,0,Matches,Crystal-Palace,Premier-League
183,Trevoh Chalobah,eng ENG,DF,25-304,11.8,20,16,7,12,1,12,23,52.2,11,19,9,10,19,39,57,3,Matches,Crystal-Palace,Premier-League
184,Eddie Nketiah,eng ENG,"FW,MF",25-340,9.8,12,5,6,2,4,5,11,45.5,6,10,1,9,2,14,11,0,Matches,Crystal-Palace,Premier-League
185,Nathaniel Clyne,eng ENG,"DF,MF",34-030,5.4,12,8,8,3,1,6,11,54.5,5,4,2,2,3,15,14,1,Matches,Crystal-Palace,Premier-League
186,Cheick Doucouré,ml MLI,MF,25-117,5.0,16,8,6,8,2,5,11,45.5,6,4,0,4,11,27,10,1,Matches,Crystal-Palace,Premier-League
187,Justin Devenny,nir NIR,MF,21-206,4.8,14,9,6,7,1,7,14,50.0,7,3,0,3,0,14,10,0,Matches,Crystal-Palace,Premier-League
188,Odsonne Édouard,fr FRA,"MF,FW",27-109,1.3,1,0,0,1,0,0,2,0.0,2,1,0,1,0,1,1,0,Matches,Crystal-Palace,Premier-League
189,Joachim Andersen,dk DEN,DF,28-339,1.0,1,1,1,0,0,1,2,50.0,1,0,0,0,0,1,7,0,Matches,Crystal-Palace,Premier-League
190,Chadi Riad,ma MAR,DF,21-322,1.0,5,2,2,2,1,2,3,66.7,1,0,0,0,2,7,0,0,Matches,Crystal-Palace,Premier-League
191,Ben Chilwell,eng ENG,DF,28-135,1.5,4,4,2,2,0,0,3,0.0,3,3,1,2,4,8,11,0,Matches,Crystal-Palace,Premier-League
192,Jeffrey Schlupp,gh GHA,"MF,DF",32-133,1.1,2,0,1,0,1,0,3,0.0,3,6,0,6,0,2,2,0,Matches,Crystal-Palace,Premier-League
193,Romain Esse,eng ENG,MF,19-357,0.4,2,2,2,0,0,2,2,100.0,0,1,0,1,1,3,0,0,Matches,Crystal-Palace,Premier-League
194,Matheus França,br BRA,"FW,MF",21-034,0.3,1,0,0,1,0,0,0,,0,0,0,0,0,1,0,0,Matches,Crystal-Palace,Premier-League
195,Jordan Ayew,gh GHA,"FW,MF",33-236,0.2,1,0,0,0,1,0,0,,0,0,0,0,0,1,0,0,Matches,Crystal-Palace,Premier-League
196,Caleb Kporha,eng ENG,DF,18-294,0.1,2,1,2,0,0,2,2,100.0,0,0,0,0,0,2,1,0,Matches,Crystal-Palace,Premier-League
197,Asher Agbinone,eng ENG,MF,19-219,0.1,2,1,0,2,0,0,0,,0,0,0,0,0,2,0,0,Matches,Crystal-Palace,Premier-League
198,Joel Ward,eng ENG,DF,35-188,0.0,0,0,0,0,0,0,0,,0,0,0,0,0,0,0,0,Matches,Crystal-Palace,Premier-League
199,Jordan Pickford,eng ENG,GK,31-060,35.0,1,0,1,0,0,1,2,50.0,1,0,0,0,1,2,29,2,Matches,Everton,Premier-League
200,James Tarkowski,eng ENG,DF,32-168,32.5,64,40,39,22,3,24,39,61.5,15,57,42,15,41,105,213,4,Matches,Everton,Premier-League
201,Vitaliy Mykolenko,ua UKR,DF,25-342,31.2,55,33,33,14,8,26,51,51.0,25,24,9,15,37,92,135,1,Matches,Everton,Premier-League
202,Idrissa Gana Gueye,sn SEN,MF,35-222,31.0,124,74,57,51,16,54,90,60.0,36,45,9,36,44,168,30,1,Matches,Everton,Premier-League
203,Abdoulaye Doucouré,ml MLI,MF,32-125,26.9,45,27,20,18,7,13,39,33.3,26,30,6,24,9,54,19,1,Matches,Everton,Premier-League
204,Iliman Ndiaye,sn SEN,FW,25-061,25.0,48,25,18,15,15,19,45,42.2,26,27,5,22,17,65,24,1,Matches,Everton,Premier-League
205,Jarrad Branthwaite,eng ENG,DF,22-313,26.1,36,20,26,10,0,20,27,74.1,7,30,22,8,23,59,183,4,Matches,Everton,Premier-League
206,Jack Harrison,eng ENG,FW,28-167,21.1,30,21,12,11,7,14,40,35.0,26,18,2,16,9,39,32,2,Matches,Everton,Premier-League
207,Dominic Calvert-Lewin,eng ENG,FW,28-051,17.6,9,7,1,4,4,2,6,33.3,4,6,2,4,6,15,19,0,Matches,Everton,Premier-League
208,Ashley Young,eng ENG,"DF,FW",39-301,18.0,51,29,23,21,7,32,51,62.7,19,10,3,7,23,74,58,1,Matches,Everton,Premier-League
209,Jake O'Brien,ie IRL,DF,23-356,15.5,24,16,19,5,0,16,24,66.7,8,16,4,12,4,28,80,0,Matches,Everton,Premier-League
210,Jesper Lindstrøm,dk DEN,FW,25-066,13.8,45,25,24,19,2,19,55,34.5,36,15,3,12,12,57,17,0,Matches,Everton,Premier-League
211,James Garner,eng ENG,"MF,DF",24-054,14.7,41,27,24,15,2,19,35,54.3,16,15,3,12,17,58,36,0,Matches,Everton,Premier-League
212,Dwight McNeil,eng ENG,"MF,FW",25-165,14.0,11,6,5,4,2,8,19,42.1,11,7,0,7,5,16,2,1,Matches,Everton,Premier-League
213,Orel Mangala,be BEL,MF,27-049,14.0,16,8,3,11,2,5,8,62.5,3,8,3,5,21,37,24,1,Matches,Everton,Premier-League
214,Beto,gw GNB,FW,27-095,14.1,14,6,2,8,4,5,8,62.5,3,8,1,7,3,17,19,1,Matches,Everton,Premier-League
215,Michael Keane,eng ENG,DF,32-115,9.5,10,7,7,2,1,7,13,53.8,6,11,7,4,10,20,55,2,Matches,Everton,Premier-League
216,Carlos Alcaraz,ar ARG,"FW,MF",22-157,6.4,11,5,5,3,3,3,9,33.3,6,6,1,5,4,15,7,0,Matches,Everton,Premier-League
217,Tim Iroegbunam,eng ENG,MF,21-310,6.3,28,13,13,10,5,14,23,60.9,9,17,4,13,15,43,11,1,Matches,Everton,Premier-League
218,Armando Broja,al ALB,FW,23-238,3.7,3,1,1,1,1,0,0,,0,3,0,3,1,4,4,0,Matches,Everton,Premier-League
219,Nathan Patterson,sct SCO,DF,23-202,3.9,11,6,7,4,0,7,14,50.0,7,2,0,2,2,13,7,0,Matches,Everton,Premier-League
220,Séamus Coleman,ie IRL,DF,36-207,2.2,2,1,1,1,0,2,3,66.7,1,5,3,2,1,3,7,0,Matches,Everton,Premier-League
221,Roman Dixon,eng ENG,DF,20-131,1.0,5,5,3,2,0,4,4,100.0,0,1,0,1,1,6,3,0,Matches,Everton,Premier-League
222,Harrison Armstrong,eng ENG,MF,18-107,0.5,0,0,0,0,0,0,1,0.0,1,0,0,0,0,0,1,0,Matches,Everton,Premier-League
223,Youssef Chermiti,pt POR,"FW,MF",20-347,0.5,0,0,0,0,0,0,1,0.0,1,0,0,0,0,0,0,0,Matches,Everton,Premier-League
224,Mason Holgate,eng ENG,"FW,DF",28-196,0.1,0,0,0,0,0,0,0,,0,0,0,0,0,0,0,0,Matches,Everton,Premier-League
225,Bernd Leno,de GER,GK,33-063,35.0,2,2,2,0,0,2,2,100.0,0,1,0,1,0,2,9,4,Matches,Fulham,Premier-League
226,Antonee Robinson,us USA,DF,27-271,33.2,90,57,53,30,7,44,89,49.4,45,37,7,30,57,147,124,2,Matches,Fulham,Premier-League
227,Alex Iwobi,ng NGA,"FW,MF",29-003,31.1,39,23,13,19,7,19,30,63.3,11,25,1,24,13,52,28,0,Matches,Fulham,Premier-League
228,Calvin Bassey,ng NGA,DF,25-126,32.2,52,33,34,18,0,21,30,70.0,9,37,17,20,18,70,105,8,Matches,Fulham,Premier-League
229,Raúl Jiménez,mx MEX,FW,34-001,24.7,33,23,8,17,8,7,20,35.0,13,19,5,14,10,43,19,3,Matches,Fulham,Premier-League
230,Joachim Andersen,dk DEN,DF,28-340,25.7,25,17,18,6,1,13,20,65.0,7,33,26,7,30,55,162,1,Matches,Fulham,Premier-League
231,Saša Lukić,rs SRB,MF,28-266,24.1,66,37,21,39,6,21,53,39.6,32,19,7,12,26,92,32,0,Matches,Fulham,Premier-League
232,Sander Berge,no NOR,MF,27-081,23.2,48,28,22,22,4,25,37,67.6,12,26,8,18,20,68,34,1,Matches,Fulham,Premier-League
233,Emile Smith Rowe,eng ENG,MF,24-282,21.0,31,18,7,14,10,8,24,33.3,16,20,2,18,11,42,16,0,Matches,Fulham,Premier-League
234,Andreas Pereira,br BRA,MF,29-125,20.9,22,12,7,11,4,10,40,25.0,30,16,2,14,8,30,15,2,Matches,Fulham,Premier-League
235,Kenny Tete,nl NED,DF,29-209,16.7,50,34,24,14,12,20,34,58.8,14,22,6,16,29,79,52,0,Matches,Fulham,Premier-League
236,Timothy Castagne,be BEL,DF,29-152,18.3,46,29,28,15,3,26,45,57.8,19,15,6,9,22,68,83,0,Matches,Fulham,Premier-League
237,Adama Traoré,es ESP,"FW,MF",29-101,17.7,17,12,8,4,5,5,13,38.5,8,7,0,7,1,18,6,3,Matches,Fulham,Premier-League
238,Issa Diop,fr FRA,DF,28-117,14.9,26,12,18,8,0,13,18,72.2,5,10,7,3,9,35,72,2,Matches,Fulham,Premier-League
239,Harry Wilson,wls WAL,"FW,MF",28-045,11.1,14,9,8,3,3,9,15,60.0,6,13,1,12,5,19,7,1,Matches,Fulham,Premier-League
240,Rodrigo Muniz,br BRA,FW,24-002,10.7,10,5,3,5,2,4,4,100.0,0,9,2,7,5,15,14,0,Matches,Fulham,Premier-League
241,Ryan Sessegnon,eng ENG,"FW,DF",24-353,5.2,21,11,8,8,5,6,15,40.0,9,11,0,11,3,24,11,0,Matches,Fulham,Premier-League
242,Reiss Nelson,eng ENG,FW,25-147,5.4,8,6,3,3,2,5,13,38.5,8,11,0,11,5,13,2,0,Matches,Fulham,Premier-League
243,Jorge Cuenca,es ESP,DF,25-170,2.9,2,2,2,0,0,2,5,40.0,3,3,3,0,2,4,21,0,Matches,Fulham,Premier-League
244,Tom Cairney,sct SCO,MF,34-106,5.5,11,5,4,2,5,4,7,57.1,3,5,1,4,4,15,1,1,Matches,Fulham,Premier-League
245,Willian,br BRA,"FW,MF",36-270,2.7,3,1,0,2,1,1,5,20.0,4,0,0,0,1,4,1,0,Matches,Fulham,Premier-League
246,Joshua King,eng ENG,"MF,FW",18-123,0.9,5,3,2,3,0,0,2,0.0,2,2,0,2,1,6,1,0,Matches,Fulham,Premier-League
247,Harrison Reed,eng ENG,MF,30-099,1.2,6,3,3,2,1,1,3,33.3,2,1,0,1,1,7,3,0,Matches,Fulham,Premier-League
248,Martial Godo,eng ENG,FW,22-053,0.2,0,0,0,0,0,0,0,,0,1,0,1,1,1,0,0,Matches,Fulham,Premier-League
249,Carlos Vinícius,br BRA,"MF,FW",30-042,0.2,0,0,0,0,0,0,1,0.0,1,1,0,1,0,0,0,0,Matches,Fulham,Premier-League
250,Jay Stansfield,eng ENG,MF,22-163,0.0,0,0,0,0,0,0,0,,0,0,0,0,0,0,0,0,Matches,Fulham,Premier-League
251,Dara O'Shea,ie IRL,DF,26-063,31.7,47,30,33,11,3,20,31,64.5,11,59,47,12,31,78,204,4,Matches,Ipswich-Town,Premier-League
252,Liam Delap,eng ENG,FW,22-087,27.7,10,7,3,2,5,2,14,14.3,12,8,0,8,2,12,28,0,Matches,Ipswich-Town,Premier-League
253,Leif Davis,eng ENG,DF,25-114,28.5,45,26,32,9,4,29,46,63.0,17,24,8,16,25,70,72,3,Matches,Ipswich-Town,Premier-League
254,Sam Morsy,eg EGY,MF,33-238,27.6,62,36,35,23,4,26,57,45.6,31,32,13,19,28,90,43,4,Matches,Ipswich-Town,Premier-League
255,Omari Hutchinson,eng ENG,"MF,FW",21-188,25.7,31,12,14,10,7,13,45,28.9,32,25,1,24,10,41,13,1,Matches,Ipswich-Town,Premier-League
256,Jens Cajuste,se SWE,MF,25-269,19.8,39,19,18,20,1,19,47,40.4,28,24,9,15,25,64,33,2,Matches,Ipswich-Town,Premier-League
257,Jacob Greaves,eng ENG,DF,24-236,21.5,36,19,19,16,1,21,33,63.6,12,36,24,12,18,54,127,2,Matches,Ipswich-Town,Premier-League
258,Arijanet Muric,xk KVX,GK,26-180,18.0,0,0,0,0,0,0,2,0.0,2,0,0,0,0,0,10,5,Matches,Ipswich-Town,Premier-League
259,Axel Tuanzebe,cd COD,DF,27-173,16.1,29,17,20,3,6,16,24,66.7,8,18,9,9,21,50,53,1,Matches,Ipswich-Town,Premier-League
260,Cameron Burgess,au AUS,DF,29-197,16.1,15,10,12,3,0,7,9,77.8,2,18,13,5,14,29,116,3,Matches,Ipswich-Town,Premier-League
261,Ben Johnson,eng ENG,"DF,FW",25-102,15.0,38,22,23,12,3,20,41,48.8,21,22,5,17,13,51,54,1,Matches,Ipswich-Town,Premier-League
262,Kalvin Phillips,eng ENG,MF,29-155,13.7,35,19,8,20,7,15,39,38.5,24,35,6,29,19,54,37,2,Matches,Ipswich-Town,Premier-League
263,Sammie Szmodics,ie IRL,"FW,MF",29-224,10.9,15,9,4,9,2,6,23,26.1,17,10,2,8,6,21,14,0,Matches,Ipswich-Town,Premier-League
264,Luke Woolfenden,eng ENG,DF,26-197,13.2,9,6,5,4,0,2,5,40.0,3,21,14,7,19,28,76,0,Matches,Ipswich-Town,Premier-League
265,Wes Burns,wls WAL,"FW,DF",30-164,10.3,13,11,1,9,3,4,10,40.0,6,7,2,5,10,23,13,2,Matches,Ipswich-Town,Premier-League
266,Jack Clarke,eng ENG,"FW,MF",24-164,11.7,28,17,11,9,8,16,32,50.0,16,6,0,6,7,35,29,1,Matches,Ipswich-Town,Premier-League
267,Alex Palmer,eng ENG,GK,28-269,11.0,0,0,0,0,0,0,0,,0,0,0,0,0,0,12,0,Matches,Ipswich-Town,Premier-League
268,Julio Enciso,py PAR,"FW,MF",21-103,7.9,11,8,2,6,3,4,9,44.4,5,3,0,3,1,12,4,0,Matches,Ipswich-Town,Premier-League
269,Conor Chaplin,eng ENG,"MF,FW",28-079,7.9,12,5,4,6,2,6,13,46.2,7,8,1,7,3,15,3,0,Matches,Ipswich-Town,Premier-League
270,Nathan Broadhead,wls WAL,"MF,FW",27-031,6.7,7,3,2,5,0,3,9,33.3,6,6,1,5,4,11,5,0,Matches,Ipswich-Town,Premier-League
271,Christian Walton,eng ENG,GK,29-178,6.0,0,0,0,0,0,0,1,0.0,1,0,0,0,0,0,1,1,Matches,Ipswich-Town,Premier-League
272,Jaden Philogene Bidace,eng ENG,"FW,DF",23-087,5.3,14,7,6,6,2,8,15,53.3,7,11,1,10,10,24,9,1,Matches,Ipswich-Town,Premier-League
273,Harry Clarke,eng ENG,DF,24-065,4.2,5,3,3,2,0,3,6,50.0,3,5,4,1,4,9,14,3,Matches,Ipswich-Town,Premier-League
274,Jack Taylor,ie IRL,MF,26-317,8.5,20,10,6,11,3,12,23,52.2,11,10,3,7,9,29,23,0,Matches,Ipswich-Town,Premier-League
275,George Hirst,sct SCO,FW,26-080,5.5,3,3,1,0,2,1,3,33.3,2,1,1,0,2,5,9,0,Matches,Ipswich-Town,Premier-League
276,Conor Townsend,eng ENG,DF,32-063,3.7,11,8,9,2,0,8,11,72.7,3,8,6,2,4,15,16,0,Matches,Ipswich-Town,Premier-League
277,Chiedozie Ogbene,ie IRL,FW,28-005,2.6,7,3,1,2,4,2,4,50.0,2,1,0,1,1,8,3,0,Matches,Ipswich-Town,Premier-League
278,Massimo Luongo,au AUS,MF,32-223,2.2,8,5,6,1,1,4,7,57.1,3,4,2,2,2,10,2,0,Matches,Ipswich-Town,Premier-League
279,Ben Godfrey,eng ENG,DF,27-111,1.8,1,0,1,0,0,1,1,100.0,0,1,1,0,2,3,3,0,Matches,Ipswich-Town,Premier-League
280,Ali Al Hamadi,iq IRQ,FW,23-066,1.5,1,0,0,0,1,0,2,0.0,2,0,0,0,0,1,2,0,Matches,Ipswich-Town,Premier-League
281,Marcus Harness,eng ENG,MF,29-071,0.5,1,0,0,0,1,0,3,0.0,3,2,1,1,0,1,1,0,Matches,Ipswich-Town,Premier-League
282,George Edmundson,eng ENG,DF,27-248,0.0,0,0,0,0,0,0,0,,0,0,0,0,0,0,0,0,Matches,Ipswich-Town,Premier-League
283,Jamie Vardy,eng ENG,FW,38-114,29.5,18,13,6,7,5,4,13,30.8,9,8,4,4,5,23,23,0,Matches,Leicester-City,Premier-League
284,James Justin,eng ENG,DF,27-071,29.7,49,29,25,19,5,28,51,54.9,23,41,14,27,44,93,129,3,Matches,Leicester-City,Premier-League
285,Victor Bernth Kristiansen,dk DEN,DF,22-140,26.4,85,50,54,26,5,47,87,54.0,40,37,14,23,40,125,72,3,Matches,Leicester-City,Premier-League
286,Wout Faes,be BEL,DF,27-032,28.3,39,23,25,12,2,23,43,53.5,20,45,33,12,26,65,160,4,Matches,Leicester-City,Premier-League
287,Mads Hermansen,dk DEN,GK,24-298,26.5,1,1,1,0,0,1,1,100.0,0,1,0,1,0,1,13,4,Matches,Leicester-City,Premier-League
288,Wilfred Ndidi,ng NGA,MF,28-140,23.9,81,50,45,29,7,27,54,50.0,27,47,19,28,26,107,72,0,Matches,Leicester-City,Premier-League
289,Bilal El Khannouss,ma MAR,MF,20-360,22.3,46,26,15,26,5,15,28,53.6,13,21,4,17,6,52,9,3,Matches,Leicester-City,Premier-League
290,Boubakary Soumaré,fr FRA,MF,26-067,21.8,33,18,21,11,1,18,30,60.0,12,20,8,12,24,57,31,3,Matches,Leicester-City,Premier-League
291,Harry Winks,eng ENG,MF,29-092,17.1,24,11,12,10,2,13,30,43.3,17,19,7,12,9,33,20,0,Matches,Leicester-City,Premier-League
292,Stephy Mavididi,eng ENG,FW,26-339,17.9,34,19,16,10,8,14,42,33.3,28,26,2,24,11,45,15,0,Matches,Leicester-City,Premier-League
293,Conor Coady,eng ENG,DF,32-069,16.0,12,8,6,5,1,3,6,50.0,3,27,20,7,13,25,62,2,Matches,Leicester-City,Premier-League
294,Jordan Ayew,gh GHA,"FW,MF",33-236,15.8,24,13,7,12,5,6,19,31.6,13,16,0,16,12,36,17,0,Matches,Leicester-City,Premier-League
295,Jannik Vestergaard,dk DEN,DF,32-275,15.5,22,10,16,6,0,9,15,60.0,6,21,14,7,16,38,74,1,Matches,Leicester-City,Premier-League
296,Facundo Buonanotte,ar ARG,"FW,MF",20-133,16.4,53,32,17,22,14,21,67,31.3,46,32,6,26,11,64,14,0,Matches,Leicester-City,Premier-League
297,Caleb Okoli,it ITA,DF,23-296,12.5,25,14,8,15,2,11,18,61.1,7,24,14,10,15,40,79,3,Matches,Leicester-City,Premier-League
298,Luke Thomas,eng ENG,DF,23-329,9.7,25,20,19,4,2,18,32,56.3,14,13,5,8,18,43,39,1,Matches,Leicester-City,Premier-League
299,Bobby De Cordova-Reid,jm JAM,FW,32-092,8.3,9,4,3,6,0,4,14,28.6,10,6,1,5,0,9,10,0,Matches,Leicester-City,Premier-League
300,Oliver Skipp,eng ENG,MF,24-231,11.1,20,4,5,12,3,9,15,60.0,6,17,4,13,10,30,10,1,Matches,Leicester-City,Premier-League
301,Jakub Stolarczyk,pl POL,GK,24-137,7.0,2,1,2,0,0,1,2,50.0,1,0,0,0,0,2,5,0,Matches,Leicester-City,Premier-League
302,Kasey McAteer,ie IRL,"FW,MF",23-164,6.8,14,11,7,4,3,9,21,42.9,12,13,1,12,3,17,11,0,Matches,Leicester-City,Premier-League
303,Abdul Fatawu Issahaku,gh GHA,FW,21-058,6.4,21,15,13,2,6,11,19,57.9,8,7,0,7,4,25,12,0,Matches,Leicester-City,Premier-League
304,Patson Daka,zm ZAM,"FW,MF",26-208,7.3,17,9,4,9,4,7,17,41.2,10,7,1,6,1,18,10,0,Matches,Leicester-City,Premier-League
305,Ricardo Pereira,pt POR,DF,31-211,3.8,11,6,4,4,3,6,12,50.0,6,6,2,4,2,13,10,0,Matches,Leicester-City,Premier-League
306,Danny Ward,wls WAL,GK,31-317,1.5,0,0,0,0,0,0,0,,0,0,0,0,0,0,1,0,Matches,Leicester-City,Premier-League
307,Hamza Choudhury,bd BAN,"MF,DF",27-216,1.5,1,1,1,0,0,1,3,33.3,2,4,2,2,5,6,2,0,Matches,Leicester-City,Premier-League
308,Woyo Coulibaly,fr FRA,DF,25-350,1.2,6,4,4,2,0,2,2,100.0,0,3,1,2,5,11,1,0,Matches,Leicester-City,Premier-League
309,Jeremy Monga,,"FW,MF",,0.6,1,1,0,1,0,1,1,100.0,0,3,2,1,0,1,1,0,Matches,Leicester-City,Premier-League
310,Odsonne Édouard,fr FRA,FW,27-109,0.3,1,1,1,0,0,0,0,,0,0,0,0,0,1,1,0,Matches,Leicester-City,Premier-League
311,Jake Evans,,FW,,0.1,0,0,0,0,0,0,1,0.0,1,0,0,0,0,0,1,0,Matches,Leicester-City,Premier-League
312,Will Alves,eng ENG,FW,20-091,0.0,0,0,0,0,0,0,0,,0,0,0,0,0,0,0,0,Matches,Leicester-City,Premier-League
313,Michael Golding,eng ENG,MF,18-347,0.0,0,0,0,0,0,0,0,,0,0,0,0,0,0,0,0,Matches,Leicester-City,Premier-League
314,Virgil van Dijk,nl NED,DF,33-302,35.0,35,17,17,16,2,11,20,55.0,9,25,14,11,54,89,179,4,Matches,Liverpool,Premier-League
315,Mohamed Salah,eg EGY,FW,32-325,34.5,20,11,7,5,8,7,16,43.8,9,11,0,11,7,27,5,0,Matches,Liverpool,Premier-League
316,Ryan Gravenberch,nl NED,MF,22-355,32.5,65,34,25,29,11,30,51,58.8,21,34,10,24,57,122,56,1,Matches,Liverpool,Premier-League
317,Alexis Mac Allister,ar ARG,MF,26-133,28.6,95,58,28,51,16,55,104,52.9,49,61,6,55,22,117,29,1,Matches,Liverpool,Premier-League
318,Trent Alexander-Arnold,eng ENG,DF,26-211,25.5,70,49,43,18,9,48,103,46.6,55,26,9,17,30,100,54,4,Matches,Liverpool,Premier-League
319,Ibrahima Konaté,fr FRA,DF,25-346,25.8,36,25,24,11,1,24,34,70.6,10,27,15,12,12,48,124,2,Matches,Liverpool,Premier-League
320,Andrew Robertson,sct SCO,DF,31-056,25.6,38,22,24,10,4,30,47,63.8,17,9,4,5,20,58,51,2,Matches,Liverpool,Premier-League
321,Dominik Szoboszlai,hu HUN,MF,24-193,25.3,31,20,10,16,5,15,39,38.5,24,36,4,32,9,40,17,2,Matches,Liverpool,Premier-League
322,Luis Díaz,co COL,FW,28-113,24.7,33,21,10,17,6,13,34,38.2,21,18,0,18,7,40,7,1,Matches,Liverpool,Premier-League
323,Alisson,br BRA,GK,32-216,24.9,1,0,1,0,0,0,1,0.0,1,0,0,0,0,1,13,1,Matches,Liverpool,Premier-League
324,Cody Gakpo,nl NED,FW,25-364,19.1,26,14,5,12,9,11,23,47.8,12,19,2,17,11,37,16,1,Matches,Liverpool,Premier-League
325,Curtis Jones,eng ENG,"MF,DF",24-096,17.0,36,20,6,22,8,17,25,68.0,8,16,7,9,6,42,8,2,Matches,Liverpool,Premier-League
326,Diogo Jota,pt POR,FW,28-153,12.8,14,8,2,8,4,7,19,36.8,12,9,0,9,7,21,6,0,Matches,Liverpool,Premier-League
327,Caoimhín Kelleher,ie IRL,GK,26-164,10.0,0,0,0,0,0,0,0,,0,0,0,0,0,0,1,2,Matches,Liverpool,Premier-League
328,Darwin Núñez,uy URU,FW,25-316,11.7,19,16,11,3,5,6,16,37.5,10,6,0,6,3,22,12,0,Matches,Liverpool,Premier-League
329,Kostas Tsimikas,gr GRE,DF,28-359,8.3,29,18,13,11,5,13,20,65.0,7,5,2,3,10,39,20,0,Matches,Liverpool,Premier-League
330,Joe Gomez,eng ENG,DF,27-348,5.8,13,10,5,7,1,11,16,68.8,5,9,6,3,7,20,20,2,Matches,Liverpool,Premier-League
331,Conor Bradley,nir NIR,DF,21-301,6.3,11,8,5,4,2,8,17,47.1,9,4,0,4,3,14,21,0,Matches,Liverpool,Premier-League
332,Jarell Quansah,eng ENG,DF,22-097,4.5,11,8,8,3,0,6,8,75.0,2,8,7,1,6,17,18,1,Matches,Liverpool,Premier-League
333,Harvey Elliott,eng ENG,"MF,FW",22-032,3.0,4,3,2,1,1,1,5,20.0,4,5,1,4,1,5,2,0,Matches,Liverpool,Premier-League
334,Wataru Endo,jp JPN,MF,32-086,2.6,11,8,6,5,0,6,10,60.0,4,7,1,6,3,14,7,0,Matches,Liverpool,Premier-League
335,Federico Chiesa,it ITA,FW,27-193,0.5,0,0,0,0,0,0,2,0.0,2,1,0,1,0,0,0,1,Matches,Liverpool,Premier-League
336,Vitezslav Jaros,cz CZE,GK,23-287,0.1,0,0,0,0,0,0,0,,0,0,0,0,0,0,0,0,Matches,Liverpool,Premier-League
337,Jayden Danns,eng ENG,MF,19-110,0.1,0,0,0,0,0,0,1,0.0,1,0,0,0,0,0,0,0,Matches,Liverpool,Premier-League
338,Joško Gvardiol,hr CRO,DF,23-102,33.4,51,34,24,17,10,19,37,51.4,18,40,20,20,38,89,117,8,Matches,Manchester-City,Premier-League
339,Erling Haaland,no NOR,FW,24-288,27.6,9,5,3,3,3,2,6,33.3,4,11,1,10,5,14,23,0,Matches,Manchester-City,Premier-League
340,Bernardo Silva,pt POR,"MF,FW",30-268,26.7,52,34,15,28,9,24,52,46.2,28,33,7,26,20,72,28,3,Matches,Manchester-City,Premier-League
341,Ederson,br BRA,GK,31-261,22.8,0,0,0,0,0,0,2,0.0,2,0,0,0,1,1,9,2,Matches,Manchester-City,Premier-League
342,İlkay Gündoğan,de GER,MF,34-193,22.8,24,13,4,15,5,10,23,43.5,13,14,0,14,13,37,22,0,Matches,Manchester-City,Premier-League
343,Mateo Kovačić,hr CRO,MF,30-364,22.8,67,38,22,38,7,30,63,47.6,33,20,0,20,20,87,20,1,Matches,Manchester-City,Premier-League
344,Rúben Dias,pt POR,DF,27-356,22.2,16,10,6,9,1,7,11,63.6,4,17,14,3,18,34,59,3,Matches,Manchester-City,Premier-League
345,Sávio,br BRA,"FW,MF",21-025,19.3,22,16,5,10,7,9,18,50.0,9,13,2,11,6,28,9,1,Matches,Manchester-City,Premier-League
346,Rico Lewis,eng ENG,"DF,MF",20-165,20.2,29,19,13,12,4,13,21,61.9,8,28,7,21,13,42,43,1,Matches,Manchester-City,Premier-League
347,Manuel Akanji,ch SUI,DF,29-290,19.4,16,11,9,4,3,8,13,61.5,5,11,8,3,7,23,57,3,Matches,Manchester-City,Premier-League
348,Phil Foden,eng ENG,"MF,FW",24-342,18.8,12,5,5,4,3,7,17,41.2,10,12,1,11,9,21,7,1,Matches,Manchester-City,Premier-League
349,Kevin De Bruyne,be BEL,"MF,FW",33-311,17.1,17,9,7,5,5,5,23,21.7,18,8,0,8,7,24,10,1,Matches,Manchester-City,Premier-League
350,Matheus Nunes,pt POR,"DF,MF",26-251,16.6,32,21,13,13,6,15,34,44.1,19,14,3,11,13,45,35,1,Matches,Manchester-City,Premier-League
351,Jeremy Doku,be BEL,"FW,MF",22-343,15.5,28,19,9,12,7,7,14,50.0,7,10,1,9,4,32,2,0,Matches,Manchester-City,Premier-League
352,Stefan Ortega,de GER,GK,32-180,12.2,0,0,0,0,0,0,1,0.0,1,0,0,0,0,0,11,1,Matches,Manchester-City,Premier-League
353,Omar Marmoush,eg EGY,"FW,MF",26-087,11.1,11,6,2,7,2,7,15,46.7,8,15,1,14,5,16,3,0,Matches,Manchester-City,Premier-League
354,Kyle Walker,eng ENG,DF,34-342,10.8,17,10,7,7,3,14,26,53.8,12,13,4,9,3,20,13,1,Matches,Manchester-City,Premier-League
355,Nathan Aké,nl NED,DF,30-076,7.5,9,7,7,2,0,4,6,66.7,2,7,2,5,3,12,22,1,Matches,Manchester-City,Premier-League
356,Nicolás González,es ESP,MF,23-122,7.2,15,6,5,6,4,6,11,54.5,5,9,0,9,5,20,17,0,Matches,Manchester-City,Premier-League
357,Jack Grealish,eng ENG,"FW,MF",29-237,8.0,9,5,4,2,3,2,5,40.0,3,12,2,10,2,11,5,1,Matches,Manchester-City,Premier-League
358,John Stones,eng ENG,"DF,MF",30-342,6.1,6,2,3,2,1,5,5,100.0,0,5,3,2,4,10,19,1,Matches,Manchester-City,Premier-League
359,Nico O’Reilly,eng ENG,DF,20-045,5.7,9,4,3,3,3,4,8,50.0,4,5,1,4,4,13,12,0,Matches,Manchester-City,Premier-League
360,Abdukodir Khusanov,uz UZB,DF,21-065,5.6,5,4,4,1,0,2,3,66.7,1,5,4,1,3,8,29,1,Matches,Manchester-City,Premier-League
361,James Mcatee,eng ENG,"MF,FW",22-199,3.4,4,2,0,4,0,1,7,14.3,6,8,0,8,2,6,1,0,Matches,Manchester-City,Premier-League
362,Jahmai Simpson-Pusey,eng ENG,DF,19-182,1.1,1,0,1,0,0,0,1,0.0,1,1,1,0,0,1,2,0,Matches,Manchester-City,Premier-League
363,Rodri,es ESP,MF,28-317,0.7,2,1,1,1,0,0,0,,0,1,0,1,1,3,0,0,Matches,Manchester-City,Premier-League
364,Divin Mubama,eng ENG,FW,20-192,0.3,0,0,0,0,0,0,0,,0,0,0,0,0,0,0,0,Matches,Manchester-City,Premier-League
365,Oscar Bobb,no NOR,FW,21-297,0.2,0,0,0,0,0,0,0,,0,0,0,0,0,0,0,0,Matches,Manchester-City,Premier-League
366,Vitor Reis,br BRA,DF,19-113,0.0,0,0,0,0,0,0,0,,0,0,0,0,0,0,1,0,Matches,Manchester-City,Premier-League
367,André Onana,cm CMR,GK,29-033,33.0,1,1,1,0,0,1,3,33.3,2,0,0,0,0,1,11,4,Matches,Manchester-United,Premier-League
368,Bruno Fernandes,pt POR,MF,30-239,30.6,76,47,24,37,15,29,75,38.7,46,32,4,28,25,101,34,2,Matches,Manchester-United,Premier-League
369,Diogo Dalot,pt POR,DF,26-048,31.0,67,39,39,22,6,34,52,65.4,18,22,9,13,37,104,72,0,Matches,Manchester-United,Premier-League
370,Noussair Mazraoui,ma MAR,DF,27-172,29.3,102,60,53,36,13,51,85,60.0,34,33,8,25,34,136,88,1,Matches,Manchester-United,Premier-League
371,Matthijs de Ligt,nl NED,DF,25-266,23.6,30,22,17,12,1,23,32,71.9,9,29,21,8,33,63,96,0,Matches,Manchester-United,Premier-League
372,Alejandro Garnacho,ar ARG,"MF,FW",20-308,23.8,29,18,10,6,13,12,36,33.3,24,19,0,19,13,42,11,2,Matches,Manchester-United,Premier-League
373,Manuel Ugarte Ribeiro,uy URU,MF,24-024,19.0,74,46,32,34,8,28,66,42.4,38,31,4,27,26,100,16,1,Matches,Manchester-United,Premier-League
374,Lisandro Martínez,ar ARG,DF,27-107,19.5,40,24,25,12,3,21,36,58.3,15,22,8,14,32,72,57,1,Matches,Manchester-United,Premier-League
375,Rasmus Højlund,dk DEN,FW,22-090,19.4,3,1,0,2,1,0,4,0.0,4,5,0,5,1,4,6,0,Matches,Manchester-United,Premier-League
376,Kobbie Mainoo,eng ENG,MF,20-016,16.7,42,25,16,13,13,22,36,61.1,14,16,2,14,19,61,12,1,Matches,Manchester-United,Premier-League
377,Amad Diallo,ci CIV,"FW,MF",22-298,18.2,35,28,7,19,9,17,28,60.7,11,11,0,11,11,46,16,0,Matches,Manchester-United,Premier-League
378,Harry Maguire,eng ENG,DF,32-061,17.1,26,13,20,5,1,13,18,72.2,5,14,12,2,37,63,72,1,Matches,Manchester-United,Premier-League
379,Casemiro,br BRA,MF,33-071,14.8,77,46,45,23,9,41,66,62.1,25,33,10,23,12,89,48,3,Matches,Manchester-United,Premier-League
380,Joshua Zirkzee,nl NED,"FW,MF",23-348,15.6,14,8,3,8,3,5,10,50.0,5,15,4,11,6,20,8,1,Matches,Manchester-United,Premier-League
381,Marcus Rashford,eng ENG,"FW,MF",27-186,10.9,7,4,2,2,3,3,9,33.3,6,8,0,8,4,11,7,0,Matches,Manchester-United,Premier-League
382,Leny Yoro,fr FRA,DF,19-173,12.4,26,11,17,8,1,11,17,64.7,6,5,3,2,18,44,43,0,Matches,Manchester-United,Premier-League
383,Christian Eriksen,dk DEN,MF,33-080,11.4,19,9,4,12,3,11,26,42.3,15,14,4,10,7,26,7,0,Matches,Manchester-United,Premier-League
384,Patrick Dorgu,dk DEN,DF,20-191,7.0,23,17,12,9,2,12,17,70.6,5,9,0,9,4,27,19,2,Matches,Manchester-United,Premier-League
385,Mason Mount,eng ENG,"MF,FW",26-115,4.8,10,4,5,5,0,8,10,80.0,2,8,1,7,3,13,1,0,Matches,Manchester-United,Premier-League
386,Victor Lindelöf,se SWE,DF,30-292,5.4,5,1,5,0,0,2,3,66.7,1,4,2,2,7,12,33,1,Matches,Manchester-United,Premier-League
387,Jonny Evans,nir NIR,DF,37-122,3.2,7,5,4,3,0,2,4,50.0,2,2,1,1,4,11,13,0,Matches,Manchester-United,Premier-League
388,Harry Amass,eng ENG,DF,18-050,2.8,6,2,5,1,0,2,6,33.3,4,6,1,5,2,8,10,0,Matches,Manchester-United,Premier-League
389,Luke Shaw,eng ENG,DF,29-297,2.4,4,3,2,2,0,2,2,100.0,0,2,1,1,2,6,6,0,Matches,Manchester-United,Premier-League
390,Altay Bayındır,tr TUR,GK,27-021,2.0,0,0,0,0,0,0,1,0.0,1,0,0,0,0,0,5,1,Matches,Manchester-United,Premier-League
391,Tyler Fredricson,eng ENG,DF,20-071,1.8,5,3,3,2,0,1,2,50.0,1,2,0,2,1,6,11,0,Matches,Manchester-United,Premier-League
392,Tyrell Malacia,nl NED,DF,25-261,1.1,2,1,2,0,0,1,2,50.0,1,0,0,0,1,3,1,1,Matches,Manchester-United,Premier-League
393,Chidozie Obi-Martin,dk DEN,FW,17-157,1.7,2,1,0,0,2,2,2,100.0,0,0,0,0,0,2,1,0,Matches,Manchester-United,Premier-League
394,Ayden Heaven,eng ENG,DF,18-225,1.1,3,3,1,2,0,2,2,100.0,0,2,2,0,1,4,6,0,Matches,Manchester-United,Premier-League
395,Toby Collyer,eng ENG,MF,21-122,2.0,12,9,6,6,0,5,6,83.3,1,2,1,1,2,14,3,0,Matches,Manchester-United,Premier-League
396,Antony,br BRA,"DF,MF",25-070,1.6,6,3,4,2,0,2,5,40.0,3,2,0,2,2,8,0,0,Matches,Manchester-United,Premier-League
397,Scott McTominay,sct SCO,MF,28-148,0.2,0,0,0,0,0,0,1,0.0,1,0,0,0,0,0,1,0,Matches,Manchester-United,Premier-League
398,Bruno Guimarães,br BRA,MF,27-170,33.4,75,43,36,28,11,31,64,48.4,33,34,9,25,27,102,41,4,Matches,Newcastle-United,Premier-League
399,Dan Burn,eng ENG,DF,32-361,34.0,34,19,20,12,2,17,32,53.1,15,32,23,9,25,59,180,3,Matches,Newcastle-United,Premier-League
400,Alexander Isak,se SWE,FW,25-226,28.6,12,5,2,3,7,5,13,38.5,8,18,2,16,3,15,17,1,Matches,Newcastle-United,Premier-League
401,Fabian Schär,ch SUI,DF,33-136,29.6,34,21,15,17,2,14,34,41.2,20,37,24,13,41,75,116,3,Matches,Newcastle-United,Premier-League
402,Valentino Livramento,eng ENG,DF,22-174,28.6,52,34,33,15,4,30,56,53.6,26,34,10,24,21,73,99,1,Matches,Newcastle-United,Premier-League
403,Joelinton,br BRA,"MF,FW",28-264,26.6,57,35,23,23,11,25,44,56.8,19,37,7,30,23,80,47,2,Matches,Newcastle-United,Premier-League
404,Jacob Murphy,eng ENG,FW,30-070,23.8,22,15,7,9,6,16,31,51.6,15,31,0,31,11,33,26,1,Matches,Newcastle-United,Premier-League
405,Sandro Tonali,it ITA,MF,24-362,26.2,47,30,20,22,5,22,44,50.0,22,32,10,22,33,80,32,2,Matches,Newcastle-United,Premier-League
406,Nick Pope,eng ENG,GK,33-016,25.0,0,0,0,0,0,0,0,,0,1,0,1,1,1,30,5,Matches,Newcastle-United,Premier-League
407,Anthony Gordon,eng ENG,FW,24-070,24.8,31,17,9,18,4,12,34,35.3,22,24,2,22,6,37,9,2,Matches,Newcastle-United,Premier-League
408,Lewis Hall,eng ENG,DF,20-239,24.3,58,41,28,22,8,40,74,54.1,34,33,18,15,18,76,75,3,Matches,Newcastle-United,Premier-League
409,Harvey Barnes,eng ENG,FW,27-147,16.7,16,9,4,6,6,3,10,30.0,7,7,1,6,6,22,12,1,Matches,Newcastle-United,Premier-League
410,Kieran Trippier,eng ENG,DF,34-228,14.2,37,20,18,13,6,21,35,60.0,14,11,3,8,12,49,49,0,Matches,Newcastle-United,Premier-League
411,Joe Willock,eng ENG,"MF,FW",25-258,11.4,28,16,15,10,3,18,29,62.1,11,24,6,18,6,34,7,0,Matches,Newcastle-United,Premier-League
412,Martin Dúbravka,sk SVK,GK,36-110,10.0,0,0,0,0,0,0,0,,0,0,0,0,0,0,3,0,Matches,Newcastle-United,Premier-League
413,Sean Longstaff,eng ENG,MF,27-187,8.9,27,16,10,9,8,18,27,66.7,9,17,5,12,7,34,8,0,Matches,Newcastle-United,Premier-League
414,Lloyd Kelly,eng ENG,DF,26-211,3.4,5,4,4,1,0,1,1,100.0,0,6,4,2,1,6,17,0,Matches,Newcastle-United,Premier-League
415,Sven Botman,nl NED,DF,25-113,2.6,6,4,3,3,0,2,3,66.7,1,2,1,1,4,10,16,0,Matches,Newcastle-United,Premier-League
416,Emil Krafth,se SWE,DF,30-276,3.2,4,2,2,1,1,2,3,66.7,1,5,4,1,2,6,11,0,Matches,Newcastle-United,Premier-League
417,Callum Wilson,eng ENG,FW,33-067,3.2,2,2,0,1,1,0,2,0.0,2,2,0,2,1,3,1,0,Matches,Newcastle-United,Premier-League
418,Lewis Miley,eng ENG,MF,19-004,2.8,11,9,4,6,1,6,11,54.5,5,5,1,4,2,13,5,2,Matches,Newcastle-United,Premier-League
419,Miguel Almirón,py PAR,FW,31-084,1.7,3,2,2,0,1,2,3,66.7,1,2,0,2,0,3,0,0,Matches,Newcastle-United,Premier-League
420,William Osula,dk DEN,FW,21-274,1.2,1,0,0,0,1,0,2,0.0,2,0,0,0,4,5,2,0,Matches,Newcastle-United,Premier-League
421,Matt Targett,eng ENG,DF,29-229,0.2,0,0,0,0,0,0,1,0.0,1,0,0,0,1,1,1,0,Matches,Newcastle-United,Premier-League
422,Matz Sels,be BEL,GK,33-068,34.0,1,1,1,0,0,1,1,100.0,0,0,0,0,0,1,22,1,Matches,Nottingham-Forest,Premier-League
423,Nikola Milenković,rs SRB,DF,27-205,33.0,43,26,30,11,2,21,27,77.8,6,39,23,16,24,67,178,1,Matches,Nottingham-Forest,Premier-League
424,Murillo,br BRA,DF,22-305,32.5,52,36,37,12,3,26,45,57.8,19,66,43,23,30,82,225,3,Matches,Nottingham-Forest,Premier-League
425,Ola Aina,ng NGA,DF,28-209,29.4,54,41,39,14,1,35,62,56.5,27,32,12,20,31,85,99,3,Matches,Nottingham-Forest,Premier-League
426,Chris Wood,nz NZL,FW,33-149,28.9,4,4,1,1,2,1,8,12.5,7,11,7,4,5,9,23,1,Matches,Nottingham-Forest,Premier-League
427,Morgan Gibbs-White,eng ENG,MF,25-098,27.2,39,18,14,19,6,15,30,50.0,15,14,4,10,18,57,27,1,Matches,Nottingham-Forest,Premier-League
428,Elliot Anderson,eng ENG,MF,22-180,26.4,79,50,48,24,7,42,94,44.7,52,41,8,33,28,107,62,3,Matches,Nottingham-Forest,Premier-League
429,Anthony Elanga,se SWE,"FW,MF",23-008,23.8,17,12,7,8,2,4,16,25.0,12,11,1,10,5,22,25,0,Matches,Nottingham-Forest,Premier-League
430,Callum Hudson-Odoi,eng ENG,"FW,MF",24-179,23.9,20,14,7,8,5,11,17,64.7,6,11,0,11,13,33,11,1,Matches,Nottingham-Forest,Premier-League
431,Neco Williams,wls WAL,DF,24-022,24.8,73,44,54,14,5,43,70,61.4,27,39,9,30,24,97,119,2,Matches,Nottingham-Forest,Premier-League
432,Nicolás Domínguez,ar ARG,"MF,FW",26-311,18.5,75,40,35,29,11,29,64,45.3,35,34,11,23,27,102,44,1,Matches,Nottingham-Forest,Premier-League
433,Ryan Yates,eng ENG,MF,27-165,20.7,41,21,23,14,4,17,37,45.9,20,35,9,26,26,67,59,1,Matches,Nottingham-Forest,Premier-League
434,Álex Moreno,es ESP,"DF,MF",31-331,10.6,25,18,20,5,0,15,39,38.5,24,11,5,6,15,40,43,0,Matches,Nottingham-Forest,Premier-League
435,Jota Silva,pt POR,"FW,MF",25-277,9.4,25,13,12,11,2,5,25,20.0,20,9,1,8,12,37,17,0,Matches,Nottingham-Forest,Premier-League
436,Morato,br BRA,DF,23-309,8.9,21,13,18,2,1,13,20,65.0,7,11,4,7,10,31,71,2,Matches,Nottingham-Forest,Premier-League
437,James Ward-Prowse,eng ENG,MF,30-185,4.4,4,1,1,3,0,2,2,100.0,0,3,2,1,5,9,8,0,Matches,Nottingham-Forest,Premier-League
438,Danilo,br BRA,"MF,FW",24-006,3.0,6,3,5,1,0,2,4,50.0,2,2,1,1,3,9,3,0,Matches,Nottingham-Forest,Premier-League
439,Taiwo Awoniyi,ng NGA,FW,27-266,4.5,6,3,0,3,3,4,5,80.0,1,1,0,1,0,6,7,0,Matches,Nottingham-Forest,Premier-League
440,Ibrahim Sangaré,ci CIV,MF,27-154,3.3,18,10,5,12,1,4,10,40.0,6,5,0,5,3,21,4,0,Matches,Nottingham-Forest,Premier-League
441,Ramón Sosa,py PAR,"FW,MF",25-247,3.0,5,3,3,0,2,1,4,25.0,3,7,0,7,3,8,4,0,Matches,Nottingham-Forest,Premier-League
442,Willy Boly,ci CIV,DF,34-091,1.7,6,1,5,1,0,4,4,100.0,0,4,2,2,3,9,12,0,Matches,Nottingham-Forest,Premier-League
443,Harry Toffolo,eng ENG,DF,29-259,1.5,5,3,3,1,1,3,4,75.0,1,2,2,0,2,7,12,0,Matches,Nottingham-Forest,Premier-League
444,Eric da Silva Moreira,de GER,"MF,DF",19-002,0.3,2,2,2,0,0,2,6,33.3,4,0,0,0,1,3,0,0,Matches,Nottingham-Forest,Premier-League
445,Kyle Walker-Peters,eng ENG,DF,28-023,32.4,44,29,22,15,7,16,35,45.7,19,27,15,12,19,63,90,1,Matches,Southampton,Premier-League
446,Mateus Fernandes,pt POR,MF,20-300,29.3,86,46,43,28,15,33,64,51.6,31,40,6,34,21,107,31,6,Matches,Southampton,Premier-League
447,Taylor Harwood-Bellis,eng ENG,DF,23-096,29.5,27,19,13,11,3,19,34,55.9,15,60,38,22,30,57,133,6,Matches,Southampton,Premier-League
448,Jan Bednarek,pl POL,DF,29-024,27.1,35,18,22,13,0,15,30,50.0,15,44,33,11,54,89,177,5,Matches,Southampton,Premier-League
449,Aaron Ramsdale,eng ENG,GK,26-357,27.0,0,0,0,0,0,0,2,0.0,2,0,0,0,2,2,8,2,Matches,Southampton,Premier-League
450,Flynn Downes,eng ENG,MF,26-106,20.9,44,24,19,20,5,14,32,43.8,18,24,6,18,30,74,38,4,Matches,Southampton,Premier-League
451,Joe Aribo,ng NGA,"MF,DF",28-289,21.2,44,30,15,23,6,17,34,50.0,17,24,9,15,20,64,29,3,Matches,Southampton,Premier-League
452,Tyler Dibling,eng ENG,"FW,MF",19-055,19.4,34,20,13,18,3,16,26,61.5,10,19,5,14,8,42,15,1,Matches,Southampton,Premier-League
453,Ryan Manning,ie IRL,"DF,MF",28-326,16.2,28,17,16,10,2,14,26,53.8,12,20,11,9,17,45,45,0,Matches,Southampton,Premier-League
454,Lesley Ugochukwu,fr FRA,MF,21-041,16.9,49,24,15,30,4,18,33,54.5,15,26,9,17,14,63,21,1,Matches,Southampton,Premier-League
455,Yukinari Sugawara,jp JPN,"DF,MF",24-312,16.3,29,16,14,14,1,18,30,60.0,12,17,7,10,10,39,46,3,Matches,Southampton,Premier-League
456,Adam Armstrong,eng ENG,"FW,MF",28-085,13.9,12,3,2,7,3,3,14,21.4,11,6,1,5,3,15,8,0,Matches,Southampton,Premier-League
457,Jack Stephens,eng ENG,DF,31-099,13.4,32,19,23,9,0,15,27,55.6,12,15,10,5,11,43,44,2,Matches,Southampton,Premier-League
458,Kamaldeen Sulemana,gh GHA,"FW,MF",23-080,13.1,16,14,6,4,6,8,13,61.5,5,9,0,9,6,22,9,0,Matches,Southampton,Premier-League
459,Cameron Archer,eng ENG,FW,23-289,15.3,11,7,6,3,2,2,9,22.2,7,5,1,4,2,13,9,0,Matches,Southampton,Premier-League
460,Paul Onuachu,ng NGA,FW,30-343,11.4,7,2,1,5,1,3,7,42.9,4,7,2,5,1,8,16,1,Matches,Southampton,Premier-League
461,James Bree,eng ENG,DF,27-207,9.9,15,10,5,9,1,7,17,41.2,10,8,3,5,8,23,24,0,Matches,Southampton,Premier-League
462,Nathan Wood-Gordon,eng ENG,DF,22-340,6.9,10,7,6,3,1,5,8,62.5,3,8,5,3,4,14,26,2,Matches,Southampton,Premier-League
463,William Smallbone,ie IRL,MF,25-074,7.2,18,11,8,8,2,7,21,33.3,14,8,0,8,2,20,12,2,Matches,Southampton,Premier-League
464,Alex McCarthy,eng ENG,GK,35-154,5.0,0,0,0,0,0,0,0,,0,0,0,0,0,0,1,4,Matches,Southampton,Premier-League
465,Adam Lallana,eng ENG,MF,36-361,4.0,8,5,4,4,0,2,12,16.7,10,4,1,3,5,13,5,0,Matches,Southampton,Premier-League
466,Ben Brereton,cl CHI,FW,26-018,5.0,3,2,0,2,1,1,9,11.1,8,2,1,1,0,3,4,0,Matches,Southampton,Premier-League
467,Ryan Fraser,sct SCO,"FW,DF",31-071,3.4,6,2,2,4,0,4,6,66.7,2,1,1,0,1,7,9,0,Matches,Southampton,Premier-League
468,Ross Stewart,sct SCO,FW,28-299,3.2,3,2,1,0,2,2,6,33.3,4,3,0,3,0,3,6,0,Matches,Southampton,Premier-League
469,Joe Lumley,eng ENG,GK,30-080,3.0,0,0,0,0,0,0,0,,0,0,0,0,0,0,3,3,Matches,Southampton,Premier-League
470,Welington,br BRA,"DF,MF",24-076,2.4,13,5,9,3,1,7,12,58.3,5,3,1,2,3,16,12,0,Matches,Southampton,Premier-League
471,Armel Bella Kotchap,de GER,DF,23-146,3.7,7,5,5,2,0,3,6,50.0,3,2,2,0,5,12,21,1,Matches,Southampton,Premier-League
472,Charlie Taylor,eng ENG,DF,31-230,3.0,7,5,4,3,0,5,6,83.3,1,5,3,2,3,10,22,1,Matches,Southampton,Premier-League
473,Albert Grønbaek,dk DEN,"FW,MF",23-348,1.6,4,1,1,1,2,3,10,30.0,7,1,1,0,0,4,1,0,Matches,Southampton,Premier-League
474,Maxwel Cornet,ci CIV,FW,28-221,0.8,5,5,1,4,0,0,4,0.0,4,0,0,0,0,5,2,0,Matches,Southampton,Premier-League
475,Samuel Edozie,eng ENG,"DF,FW",22-098,0.7,3,1,0,1,2,2,2,100.0,0,0,0,0,0,3,0,0,Matches,Southampton,Premier-League
476,Jay Robinson,eng ENG,"MF,FW",18-052,0.4,2,1,2,0,0,0,0,,0,0,0,0,0,2,0,0,Matches,Southampton,Premier-League
477,Samuel Amo-Ameyaw,eng ENG,"FW,DF",18-292,0.3,1,0,0,1,0,1,1,100.0,0,0,0,0,0,1,0,0,Matches,Southampton,Premier-League
478,Ronnie Edwards,eng ENG,DF,22-039,0.1,0,0,0,0,0,0,0,,0,1,1,0,0,0,0,0,Matches,Southampton,Premier-League
479,Carlos Alcaraz,ar ARG,MF,22-157,0.1,0,0,0,0,0,0,0,,0,0,0,0,1,1,0,0,Matches,Southampton,Premier-League
480,Pedro Porro,es ESP,DF,25-234,27.4,63,46,31,22,10,42,73,57.5,31,44,17,27,34,97,80,1,Matches,Tottenham-Hotspur,Premier-League
481,Dejan Kulusevski,se SWE,"MF,FW",25-010,26.3,45,23,17,13,15,19,51,37.3,32,34,5,29,13,58,10,1,Matches,Tottenham-Hotspur,Premier-League
482,Dominic Solanke,eng ENG,FW,27-233,23.5,18,11,1,12,5,4,14,28.6,10,18,7,11,0,18,22,0,Matches,Tottenham-Hotspur,Premier-League
483,Brennan Johnson,wls WAL,FW,23-347,23.1,39,26,9,20,10,16,31,51.6,15,25,3,22,4,43,11,0,Matches,Tottenham-Hotspur,Premier-League
484,Guglielmo Vicario,it ITA,GK,28-210,23.0,0,0,0,0,0,0,0,,0,0,0,0,1,1,14,6,Matches,Tottenham-Hotspur,Premier-League
485,Son Heung-min,kr KOR,FW,32-301,22.3,17,9,3,8,6,5,23,21.7,18,10,0,10,5,22,16,1,Matches,Tottenham-Hotspur,Premier-League
486,Destiny Udogie,it ITA,DF,22-158,20.4,74,47,41,26,7,33,47,70.2,14,40,6,34,21,95,35,1,Matches,Tottenham-Hotspur,Premier-League
487,James Maddison,eng ENG,MF,28-163,20.1,31,19,8,16,7,9,29,31.0,20,15,4,11,12,43,19,1,Matches,Tottenham-Hotspur,Premier-League
488,Pape Matar Sarr,sn SEN,MF,22-233,19.2,44,32,17,22,5,11,23,47.8,12,23,9,14,26,70,20,1,Matches,Tottenham-Hotspur,Premier-League
489,Rodrigo Bentancur,uy URU,MF,27-314,16.9,38,20,17,17,4,19,39,48.7,20,24,8,16,36,74,33,1,Matches,Tottenham-Hotspur,Premier-League
490,Cristian Romero,ar ARG,DF,27-008,15.7,35,29,26,8,1,21,30,70.0,9,18,3,15,21,56,57,2,Matches,Tottenham-Hotspur,Premier-League
491,Djed Spence,eng ENG,DF,24-269,17.8,40,30,22,12,6,20,27,74.1,7,24,9,15,18,58,64,1,Matches,Tottenham-Hotspur,Premier-League
492,Archie Gray,eng ENG,"DF,MF",19-054,16.5,13,7,4,6,3,7,17,41.2,10,19,10,9,13,26,42,2,Matches,Tottenham-Hotspur,Premier-League
493,Yves Bissouma,ml MLI,MF,28-248,14.4,47,29,19,25,3,18,33,54.5,15,9,6,3,16,63,35,4,Matches,Tottenham-Hotspur,Premier-League
494,Radu Drăgușin,ro ROU,DF,23-091,13.9,10,6,8,2,0,6,12,50.0,6,22,16,6,15,25,49,4,Matches,Tottenham-Hotspur,Premier-League
495,Ben Davies,wls WAL,DF,32-011,12.5,14,10,6,8,0,7,14,50.0,7,24,16,8,12,26,65,1,Matches,Tottenham-Hotspur,Premier-League
496,Lucas Bergvall,se SWE,MF,19-092,13.5,39,19,14,20,5,17,32,53.1,15,18,8,10,24,63,22,3,Matches,Tottenham-Hotspur,Premier-League
497,Micky van de Ven,nl NED,DF,24-016,10.6,10,6,5,4,1,8,14,57.1,6,9,6,3,10,20,36,1,Matches,Tottenham-Hotspur,Premier-League
498,Mathys Tel,fr FRA,FW,20-008,7.2,8,3,0,4,4,2,9,22.2,7,6,0,6,0,8,2,2,Matches,Tottenham-Hotspur,Premier-League
499,Fraser Forster,eng ENG,GK,37-049,7.0,0,0,0,0,0,0,1,0.0,1,0,0,0,0,0,7,3,Matches,Tottenham-Hotspur,Premier-League
500,Wilson Odobert,fr FRA,FW,20-158,7.0,9,3,4,3,2,6,11,54.5,5,4,0,4,3,12,3,1,Matches,Tottenham-Hotspur,Premier-League
501,Kevin Danso,at AUT,DF,26-228,6.4,6,5,3,3,0,5,8,62.5,3,7,7,0,3,9,44,1,Matches,Tottenham-Hotspur,Premier-League
502,Timo Werner,de GER,"FW,MF",29-060,5.7,6,4,3,3,0,3,13,23.1,10,10,1,9,1,7,7,0,Matches,Tottenham-Hotspur,Premier-League
503,Richarlison,br BRA,FW,27-360,5.3,4,3,0,3,1,0,2,0.0,2,1,1,0,0,4,8,0,Matches,Tottenham-Hotspur,Premier-League
504,Antonín Kinský,cz CZE,GK,22-053,4.0,3,1,3,0,0,1,1,100.0,0,0,0,0,0,3,5,1,Matches,Tottenham-Hotspur,Premier-League
505,Mikey Moore,eng ENG,FW,17-267,2.3,0,0,0,0,0,0,1,0.0,1,1,0,1,1,1,1,0,Matches,Tottenham-Hotspur,Premier-League
506,Brandon Austin,eng ENG,GK,26-117,1.0,0,0,0,0,0,0,0,,0,0,0,0,0,0,1,0,Matches,Tottenham-Hotspur,Premier-League
507,Sergio Reguilón,es ESP,DF,28-140,1.4,4,3,1,3,0,2,3,66.7,1,4,0,4,2,6,3,0,Matches,Tottenham-Hotspur,Premier-League
508,Dane Scarlett,eng ENG,"FW,MF",21-042,0.4,1,0,0,1,0,0,0,,0,0,0,0,0,1,1,0,Matches,Tottenham-Hotspur,Premier-League
509,Alfie Dorrington,eng ENG,DF,20-015,0.2,0,0,0,0,0,0,0,,0,0,0,0,0,0,0,0,Matches,Tottenham-Hotspur,Premier-League
510,Will Lankshear,eng ENG,"FW,MF",20-015,0.1,0,0,0,0,0,0,0,,0,0,0,0,0,0,0,0,Matches,Tottenham-Hotspur,Premier-League
511,Max Kilman,eng ENG,DF,27-347,34.2,33,20,13,17,3,21,25,84.0,4,55,37,18,38,71,196,5,Matches,West-Ham-United,Premier-League
512,Aaron Wan-Bissaka,eng ENG,DF,27-160,32.0,64,45,29,30,5,20,27,74.1,7,32,9,23,60,124,116,0,Matches,West-Ham-United,Premier-League
513,Jarrod Bowen,eng ENG,"FW,MF",28-136,30.2,37,24,13,10,14,17,37,45.9,20,21,3,18,16,53,23,0,Matches,West-Ham-United,Premier-League
514,Mohammed Kudus,gh GHA,"FW,MF",24-276,26.9,35,21,7,17,11,10,27,37.0,17,24,1,23,4,39,8,2,Matches,West-Ham-United,Premier-League
515,Lucas Paquetá,br BRA,"MF,FW",27-251,26.0,66,37,25,30,11,27,54,50.0,27,28,4,24,17,83,37,6,Matches,West-Ham-United,Premier-League
516,Tomáš Souček,cz CZE,MF,30-067,25.9,42,19,19,20,3,22,39,56.4,17,35,17,18,18,60,74,1,Matches,West-Ham-United,Premier-League
517,Emerson Palmieri,it ITA,DF,30-275,23.4,60,31,37,18,5,27,48,56.3,21,32,8,24,21,81,59,0,Matches,West-Ham-United,Premier-League
518,Alphonse Areola,fr FRA,GK,32-067,23.1,2,2,2,0,0,2,3,66.7,1,0,0,0,0,2,15,2,Matches,West-Ham-United,Premier-League
519,Konstantinos Mavropanos,gr GRE,DF,27-145,21.6,32,22,22,9,1,14,25,56.0,11,23,17,6,38,70,117,1,Matches,West-Ham-United,Premier-League
520,Edson Álvarez,mx MEX,MF,27-193,18.1,44,23,24,12,8,15,33,45.5,18,21,8,13,16,60,39,1,Matches,West-Ham-United,Premier-League
521,Jean-Clair Todibo,fr FRA,DF,25-126,17.4,40,24,26,13,1,25,33,75.8,8,24,12,12,21,61,70,3,Matches,West-Ham-United,Premier-League
522,Carlos Soler,es ESP,"MF,FW",28-123,15.1,15,11,8,6,1,7,23,30.4,16,19,6,13,8,23,21,2,Matches,West-Ham-United,Premier-League
523,Guido Rodríguez,ar ARG,MF,31-023,11.3,30,16,19,11,0,14,30,46.7,16,21,9,12,12,42,28,1,Matches,West-Ham-United,Premier-League
524,Łukasz Fabiański,pl POL,GK,40-017,11.9,0,0,0,0,0,0,1,0.0,1,0,0,0,0,0,5,1,Matches,West-Ham-United,Premier-League
525,Michail Antonio,jm JAM,FW,35-038,9.3,2,2,0,1,1,2,3,66.7,1,6,0,6,0,2,2,0,Matches,West-Ham-United,Premier-League
526,Vladimír Coufal,cz CZE,DF,32-256,9.7,17,11,10,5,2,7,18,38.9,11,13,11,2,8,25,37,1,Matches,West-Ham-United,Premier-League
527,James Ward-Prowse,eng ENG,MF,30-185,9.0,15,10,7,5,3,4,13,30.8,9,6,3,3,5,20,13,0,Matches,West-Ham-United,Premier-League
528,Aaron Cresswell,eng ENG,DF,35-141,7.5,9,5,4,4,1,7,9,77.8,2,9,4,5,8,17,34,0,Matches,West-Ham-United,Premier-League
529,Crysencio Summerville,nl NED,"FW,MF",23-187,8.7,13,7,2,8,3,3,9,33.3,6,13,4,9,0,13,7,0,Matches,West-Ham-United,Premier-League
530,Oliver Scarles,eng ENG,DF,19-144,6.6,17,11,13,3,1,13,21,61.9,8,14,2,12,10,27,24,0,Matches,West-Ham-United,Premier-League
531,Niclas Füllkrug,de GER,FW,32-085,7.4,2,2,0,1,1,2,3,66.7,1,1,0,1,0,2,12,0,Matches,West-Ham-United,Premier-League
532,Danny Ings,eng ENG,"FW,MF",32-286,3.2,4,2,2,2,0,1,3,33.3,2,5,0,5,1,5,4,0,Matches,West-Ham-United,Premier-League
533,Andy Irving,sct SCO,MF,24-357,1.8,7,4,3,3,1,1,5,20.0,4,5,1,4,1,8,5,0,Matches,West-Ham-United,Premier-League
534,Evan Ferguson,ie IRL,FW,20-198,1.7,3,1,0,1,2,0,0,,0,2,1,1,1,4,1,0,Matches,West-Ham-United,Premier-League
535,Luis Guilherme,br BRA,"MF,FW",19-085,1.5,1,0,1,0,0,0,3,0.0,3,7,0,7,3,4,2,0,Matches,West-Ham-United,Premier-League
536,Lewis Orford,eng ENG,MF,19-076,0.5,0,0,0,0,0,0,0,,0,1,0,1,1,1,0,0,Matches,West-Ham-United,Premier-League
537,Kaelan Casey,eng ENG,DF,20-189,0.0,0,0,0,0,0,0,0,,0,0,0,0,0,0,1,0,Matches,West-Ham-United,Premier-League
538,Rayan Aït-Nouri,dz ALG,DF,23-334,31.8,82,52,50,25,7,41,67,61.2,26,40,6,34,24,106,67,1,Matches,Wolverhampton-Wanderers,Premier-League
539,João Gomes,br BRA,MF,24-083,30.9,105,62,53,48,4,42,102,41.2,60,42,4,38,25,130,32,0,Matches,Wolverhampton-Wanderers,Premier-League
540,Nélson Semedo,pt POR,DF,31-171,29.6,58,34,31,20,7,30,53,56.6,23,28,10,18,23,81,100,3,Matches,Wolverhampton-Wanderers,Premier-League
541,Jørgen Strand Larsen,no NOR,FW,25-089,27.4,9,6,2,3,4,4,27,14.8,23,18,4,14,5,14,27,0,Matches,Wolverhampton-Wanderers,Premier-League
542,André,br BRA,MF,23-294,25.0,80,48,36,37,7,32,57,56.1,25,41,8,33,32,112,27,1,Matches,Wolverhampton-Wanderers,Premier-League
543,José Sá,pt POR,GK,32-109,27.0,2,2,2,0,0,2,2,100.0,0,0,0,0,0,2,14,1,Matches,Wolverhampton-Wanderers,Premier-League
544,Matheus Cunha,br BRA,"MF,FW",25-344,26.9,35,21,16,15,4,11,36,30.6,25,19,1,18,17,52,23,0,Matches,Wolverhampton-Wanderers,Premier-League
545,Toti Gomes,pt POR,DF,26-110,26.0,53,38,37,14,2,30,37,81.1,7,28,17,11,23,76,134,5,Matches,Wolverhampton-Wanderers,Premier-League
546,Matt Doherty,ie IRL,DF,33-110,21.8,37,20,25,12,0,16,24,66.7,8,26,15,11,21,58,91,3,Matches,Wolverhampton-Wanderers,Premier-League
547,Jean-Ricner Bellegarde,fr FRA,"MF,FW",26-313,17.2,37,22,17,17,3,13,19,68.4,6,19,3,16,10,47,17,1,Matches,Wolverhampton-Wanderers,Premier-League
548,Santiago Bueno,uy URU,DF,26-178,18.7,40,21,21,18,1,17,22,77.3,5,35,20,15,15,55,70,0,Matches,Wolverhampton-Wanderers,Premier-League
549,Mario Lemina,ga GAB,"MF,DF",31-247,15.2,51,31,27,19,5,20,29,69.0,9,12,7,5,27,78,50,3,Matches,Wolverhampton-Wanderers,Premier-League
550,Emmanuel Agbadou,ci CIV,DF,27-323,12.7,27,18,18,9,0,11,17,64.7,6,16,12,4,9,36,77,0,Matches,Wolverhampton-Wanderers,Premier-League
551,Craig Dawson,eng ENG,DF,35-000,10.8,15,3,8,6,1,12,15,80.0,3,16,11,5,9,24,52,1,Matches,Wolverhampton-Wanderers,Premier-League
552,Marshall Munetsi,zw ZIM,"MF,FW",28-318,9.8,21,10,6,9,6,12,20,60.0,8,12,1,11,6,27,15,0,Matches,Wolverhampton-Wanderers,Premier-League
553,Gonçalo Guedes,pt POR,"MF,FW",28-158,8.7,14,4,2,5,7,3,15,20.0,12,9,0,9,5,19,3,0,Matches,Wolverhampton-Wanderers,Premier-League
554,Sam Johnstone,eng ENG,GK,32-042,7.0,0,0,0,0,0,0,1,0.0,1,0,0,0,0,0,7,0,Matches,Wolverhampton-Wanderers,Premier-League
555,Pablo Sarabia,es ESP,"MF,FW",32-360,8.0,15,8,4,8,3,9,14,64.3,5,10,0,10,4,19,7,1,Matches,Wolverhampton-Wanderers,Premier-League
556,Rodrigo Gomes,pt POR,"DF,FW",21-303,7.5,21,13,12,9,0,10,19,52.6,9,8,1,7,5,26,20,1,Matches,Wolverhampton-Wanderers,Premier-League
557,Hwang Hee-chan,kr KOR,"MF,FW",29-100,7.2,6,4,2,1,3,2,6,33.3,4,9,0,9,2,8,11,0,Matches,Wolverhampton-Wanderers,Premier-League
558,Yerson Mosquera,co COL,DF,24-004,4.9,11,7,9,2,0,9,14,64.3,5,13,10,3,10,21,14,0,Matches,Wolverhampton-Wanderers,Premier-League
559,Tommy Doyle,eng ENG,MF,23-201,5.4,11,6,6,3,2,6,15,40.0,9,11,5,6,5,16,11,1,Matches,Wolverhampton-Wanderers,Premier-League
560,Carlos Forbs,pt POR,"MF,FW",21-048,2.7,8,5,5,2,1,4,6,66.7,2,3,0,3,1,9,2,1,Matches,Wolverhampton-Wanderers,Premier-League
561,Daniel Bentley,eng ENG,GK,31-297,1.0,0,0,0,0,0,0,0,,0,0,0,0,0,0,0,0,Matches,Wolverhampton-Wanderers,Premier-League
562,Pedro Lima,br BRA,DF,18-309,0.8,1,0,0,0,1,1,3,33.3,2,0,0,0,2,3,5,0,Matches,Wolverhampton-Wanderers,Premier-League
563,Daniel Podence,pt POR,"MF,FW",29-197,0.5,0,0,0,0,0,0,1,0.0,1,0,0,0,0,0,0,0,Matches,Wolverhampton-Wanderers,Premier-League
564,Nasser Djiga,bf BFA,"DF,FW",22-172,0.2,0,0,0,0,0,0,0,,0,0,0,0,2,2,3,1,Matches,Wolverhampton-Wanderers,Premier-League
565,Chiquinho,pt POR,MF,25-090,0.1,0,0,0,0,0,0,0,,0,0,0,0,0,0,0,0,Matches,Wolverhampton-Wanderers,Premier-League
566,Alfie Pond,eng ENG,DF,21-066,0.0,0,0,0,0,0,0,0,,0,0,0,0,0,0,0,0,Matches,Wolverhampton-Wanderers,Premier-League
567,Boubacar Traoré,ml MLI,MF,23-259,0.0,2,0,0,2,0,1,1,100.0,0,0,0,0,0,2,0,0,Matches,Wolverhampton-Wanderers,Premier-League
568,Carlos Vicente,es ESP,"FW,MF",26-012,30.4,41,26,23,10,8,23,57,40.4,34,28,2,26,13,54,37,0,Matches,Alaves,La-Liga
569,Nahuel Tenaglia,ar ARG,DF,29-073,29.3,87,52,54,28,5,46,75,61.3,29,29,7,22,37,124,115,2,Matches,Alaves,La-Liga
570,Abdel Abqar,ma MAR,DF,26-056,27.4,36,23,24,11,1,20,34,58.8,14,28,18,10,39,75,146,1,Matches,Alaves,La-Liga
571,Antonio Sivera,es ESP,GK,28-267,27.2,2,1,2,0,0,2,2,100.0,0,1,0,1,0,2,17,0,Matches,Alaves,La-Liga
572,Antonio Blanco,es ESP,MF,24-286,26.6,60,37,20,36,4,31,71,43.7,40,27,6,21,39,99,43,1,Matches,Alaves,La-Liga
573,Kiké,es ESP,FW,35-161,25.6,17,12,1,11,5,5,11,45.5,6,9,2,7,1,18,22,0,Matches,Alaves,La-Liga
574,Manu Sánchez,es ESP,DF,24-254,25.5,69,45,34,25,10,35,57,61.4,22,46,9,37,28,97,61,1,Matches,Alaves,La-Liga
575,Jon Guridi,es ESP,"MF,FW",30-066,20.0,33,17,6,21,6,15,39,38.5,24,19,1,18,12,45,11,0,Matches,Alaves,La-Liga
576,Moussa Diarra,ml MLI,DF,24-176,19.7,38,23,19,16,3,17,28,60.7,11,14,5,9,21,59,40,1,Matches,Alaves,La-Liga
577,Ander Guevara,es ESP,MF,27-302,18.6,43,26,18,24,1,18,42,42.9,24,19,5,14,11,54,40,1,Matches,Alaves,La-Liga
578,Santiago Mouriño,uy URU,DF,23-081,17.5,34,24,26,8,0,18,32,56.3,14,25,11,14,25,59,102,0,Matches,Alaves,La-Liga
579,Carlos Martín,es ESP,"FW,MF",23-013,14.5,39,20,15,16,8,13,49,26.5,36,30,1,29,5,44,18,0,Matches,Alaves,La-Liga
580,Joan Jordán,es ESP,MF,30-303,15.1,31,17,11,16,4,16,29,55.2,13,12,0,12,8,39,20,0,Matches,Alaves,La-Liga
581,Tomás Conechny,ar ARG,"FW,MF",27-036,8.8,12,9,4,6,2,8,24,33.3,16,13,2,11,6,18,8,0,Matches,Alaves,La-Liga
582,Carles Aleñá,es ESP,"MF,FW",27-120,8.5,17,10,6,6,5,7,15,46.7,8,7,0,7,2,19,3,0,Matches,Alaves,La-Liga
583,Toni Martínez,es ESP,"FW,MF",27-309,10.1,11,6,4,4,3,3,4,75.0,1,7,2,5,0,11,11,0,Matches,Alaves,La-Liga
584,Stoichkov,es ESP,"MF,FW",31-181,7.8,14,9,6,7,1,6,11,54.5,5,2,0,2,1,15,7,0,Matches,Alaves,La-Liga
585,Aleksandar Sedlar,rs SRB,DF,33-143,5.7,17,9,7,10,0,8,10,80.0,2,2,1,1,9,26,18,1,Matches,Alaves,La-Liga
586,Jesús Owono,gq EQG,GK,24-065,5.4,1,1,1,0,0,1,1,100.0,0,0,0,0,0,1,2,0,Matches,Alaves,La-Liga
587,Pica,es ESP,DF,23-124,5.4,9,7,7,2,0,4,9,44.4,5,7,6,1,8,17,23,0,Matches,Alaves,La-Liga
588,Carlos Benavídez,uy URU,MF,27-036,4.4,12,9,6,4,2,4,8,50.0,4,4,2,2,8,20,11,1,Matches,Alaves,La-Liga
589,Abderrahman Rebbach,dz ALG,"FW,MF",26-267,4.3,3,2,3,0,0,0,6,0.0,6,4,0,4,0,3,6,0,Matches,Alaves,La-Liga
590,Facundo Garcés,ar ARG,DF,25-242,3.5,2,0,2,0,0,1,2,50.0,1,6,5,1,2,4,28,0,Matches,Alaves,La-Liga
591,Asier Villalibre,es ESP,FW,27-217,3.5,1,1,0,0,1,1,2,50.0,1,1,0,1,1,2,7,0,Matches,Alaves,La-Liga
592,Hugo Novoa,es ESP,"DF,MF",22-124,2.6,8,5,4,3,1,5,5,100.0,0,2,1,1,0,8,6,0,Matches,Alaves,La-Liga
593,Luka Romero,ar ARG,"FW,MF",20-168,2.2,4,4,1,1,2,2,3,66.7,1,2,0,2,1,5,0,0,Matches,Alaves,La-Liga
594,Pau Cabanes,es ESP,"MF,FW",20-077,2.0,7,2,4,2,1,5,11,45.5,6,1,0,1,0,7,1,0,Matches,Alaves,La-Liga
595,Adrian Rodriguez,es ESP,GK,24-144,1.4,0,0,0,0,0,0,1,0.0,1,0,0,0,0,0,3,1,Matches,Alaves,La-Liga
596,Luis Rioja,es ESP,FW,31-201,0.3,2,1,0,1,1,1,2,50.0,1,2,0,2,0,2,0,0,Matches,Alaves,La-Liga
597,Iñaki Williams,gh GHA,FW,30-324,29.0,17,10,4,8,5,12,23,52.2,11,34,5,29,12,29,32,0,Matches,Athletic-Club,La-Liga
598,Daniel Vivian,es ESP,DF,25-294,25.7,37,23,21,13,3,19,30,63.3,11,24,9,15,38,75,120,2,Matches,Athletic-Club,La-Liga
599,Álex Berenguer,es ESP,"FW,MF",29-305,23.0,29,13,4,16,9,13,26,50.0,13,18,2,16,9,38,17,0,Matches,Athletic-Club,La-Liga
600,Mikel Jauregizar,es ESP,MF,21-174,21.8,76,43,23,40,13,39,74,52.7,35,22,3,19,26,102,28,2,Matches,Athletic-Club,La-Liga
601,Nico Williams,es ESP,FW,22-297,21.3,27,17,10,11,6,10,31,32.3,21,19,1,18,6,33,9,0,Matches,Athletic-Club,La-Liga
602,Beñat Prados,es ESP,MF,24-086,17.9,51,33,19,24,8,23,51,45.1,28,21,2,19,28,79,25,0,Matches,Athletic-Club,La-Liga
603,Gorka Guruzeta,es ESP,FW,28-235,18.1,15,8,1,12,2,7,28,25.0,21,27,4,23,8,23,19,0,Matches,Athletic-Club,La-Liga
604,Aitor Paredes,es ESP,DF,25-006,18.1,11,9,8,3,0,5,12,41.7,7,22,12,10,22,33,107,4,Matches,Athletic-Club,La-Liga
605,Yuri Berchiche,es ESP,DF,35-084,18.7,32,20,18,11,3,19,30,63.3,11,20,3,17,20,52,47,2,Matches,Athletic-Club,La-Liga
606,Yeray Álvarez,es ESP,DF,30-101,17.8,24,13,13,9,2,14,20,70.0,6,10,6,4,33,57,104,1,Matches,Athletic-Club,La-Liga
607,Oihan Sancet,es ESP,MF,25-010,16.3,12,7,6,5,1,4,12,33.3,8,9,0,9,5,17,5,0,Matches,Athletic-Club,La-Liga
608,Unai Simón,es ESP,GK,27-328,17.0,0,0,0,0,0,0,0,,0,1,0,1,1,1,10,4,Matches,Athletic-Club,La-Liga
609,Andoni Gorosabel,es ESP,DF,28-274,15.6,43,25,27,9,7,27,41,65.9,14,17,2,15,17,60,54,0,Matches,Athletic-Club,La-Liga
610,Óscar de Marcos,es ESP,DF,36-021,15.3,28,13,13,11,4,19,34,55.9,15,15,1,14,14,42,30,0,Matches,Athletic-Club,La-Liga
611,Iñigo Ruiz de Galarreta,es ESP,MF,31-272,13.9,34,21,11,17,6,19,29,65.5,10,8,3,5,12,46,9,2,Matches,Athletic-Club,La-Liga
612,Julen Agirrezabala,es ESP,GK,24-130,13.4,0,0,0,0,0,0,1,0.0,1,0,0,0,0,0,4,0,Matches,Athletic-Club,La-Liga
613,Unai Gómez,es ESP,"MF,FW",21-345,12.3,10,6,3,6,1,4,6,66.7,2,12,1,11,2,12,12,0,Matches,Athletic-Club,La-Liga
614,Adama Boiro,es ESP,DF,22-317,11.2,20,11,11,7,2,10,14,71.4,4,8,3,5,12,32,26,1,Matches,Athletic-Club,La-Liga
615,Mikel Vesga,es ESP,MF,31-349,9.8,20,14,7,12,1,10,26,38.5,16,10,1,9,13,33,20,0,Matches,Athletic-Club,La-Liga
616,Iñigo Lekue,es ESP,DF,32-001,7.6,15,12,12,3,0,9,17,52.9,8,7,2,5,7,22,26,2,Matches,Athletic-Club,La-Liga
617,Álvaro djaló,es ESP,FW,25-262,6.7,7,5,3,2,2,1,3,33.3,2,3,0,3,1,8,4,0,Matches,Athletic-Club,La-Liga
618,Unai Núñez,es ESP,DF,28-095,6.5,9,4,6,3,0,3,6,50.0,3,4,4,0,17,26,42,1,Matches,Athletic-Club,La-Liga
619,Maroan Sannadi,es ESP,FW,24-093,5.7,1,0,1,0,0,1,4,25.0,3,1,0,1,0,1,1,0,Matches,Athletic-Club,La-Liga
620,Alex Padilla,es ESP,GK,21-246,3.6,0,0,0,0,0,0,0,,0,0,0,0,0,0,2,1,Matches,Athletic-Club,La-Liga
621,Ander Herrera,es ESP,MF,35-264,3.0,8,4,1,7,0,3,6,50.0,3,1,0,1,2,10,10,0,Matches,Athletic-Club,La-Liga
622,Peio Canales,es ESP,"MF,FW",20-108,2.1,2,2,0,0,2,1,1,100.0,0,1,0,1,2,4,1,0,Matches,Athletic-Club,La-Liga
623,Nicolás Serrano,es ESP,FW,22-061,1.2,1,1,0,1,0,1,3,33.3,2,4,0,4,1,2,1,0,Matches,Athletic-Club,La-Liga
624,Javi Martón,es ESP,"FW,MF",25-364,0.6,0,0,0,0,0,0,0,,0,0,0,0,0,0,0,0,Matches,Athletic-Club,La-Liga
625,Adu Ares,es ESP,FW,23-205,0.2,0,0,0,0,0,0,1,0.0,1,0,0,0,0,0,0,0,Matches,Athletic-Club,La-Liga
626,Endika Buján,es ESP,FW,22-109,0.1,0,0,0,0,0,0,1,0.0,1,0,0,0,0,0,0,0,Matches,Athletic-Club,La-Liga
627,Jan Oblak,si SVN,GK,32-118,33.0,0,0,0,0,0,0,0,,0,0,0,0,0,0,15,2,Matches,Atletico-Madrid,La-Liga
628,Antoine Griezmann,fr FRA,"FW,MF",34-045,26.0,30,17,13,13,4,7,29,24.1,22,16,1,15,6,36,23,1,Matches,Atletico-Madrid,La-Liga
629,Julián Álvarez,ar ARG,FW,25-094,25.2,24,16,5,10,9,8,28,28.6,20,14,0,14,0,24,10,1,Matches,Atletico-Madrid,La-Liga
630,Pablo Barrios,es ESP,MF,21-324,24.6,44,25,21,20,3,22,45,48.9,23,14,4,10,33,77,33,7,Matches,Atletico-Madrid,La-Liga
631,Marcos Llorente,es ESP,"DF,MF",30-095,23.9,61,45,34,24,3,33,48,68.8,15,27,7,20,22,83,47,1,Matches,Atletico-Madrid,La-Liga
632,Giuliano Simeone,ar ARG,MF,22-138,19.0,24,12,6,8,10,14,28,50.0,14,19,2,17,12,36,18,0,Matches,Atletico-Madrid,La-Liga
633,Robin Le Normand,es ESP,DF,28-175,20.9,25,16,21,4,0,11,18,61.1,7,17,8,9,8,33,108,1,Matches,Atletico-Madrid,La-Liga
634,Clément Lenglet,fr FRA,DF,29-322,19.9,22,14,16,6,0,8,11,72.7,3,24,18,6,20,42,96,1,Matches,Atletico-Madrid,La-Liga
635,Rodrigo De Paul,ar ARG,MF,30-346,20.0,28,23,11,13,4,13,30,43.3,17,22,2,20,5,33,13,3,Matches,Atletico-Madrid,La-Liga
636,Conor Gallagher,eng ENG,MF,25-088,17.2,42,30,16,16,10,20,46,43.5,26,23,5,18,19,61,23,0,Matches,Atletico-Madrid,La-Liga
637,José María Giménez,uy URU,DF,30-105,20.2,22,14,15,7,0,16,27,59.3,11,26,16,10,25,47,104,2,Matches,Atletico-Madrid,La-Liga
638,Javi Galán,es ESP,DF,30-167,17.3,48,29,29,15,4,24,46,52.2,22,12,3,9,9,57,41,0,Matches,Atletico-Madrid,La-Liga
639,Samuel Lino,br BRA,"MF,DF",25-133,14.4,25,13,20,4,1,18,45,40.0,27,19,4,15,7,32,12,0,Matches,Atletico-Madrid,La-Liga
640,Koke,es ESP,MF,33-117,17.9,43,22,17,20,6,20,38,52.6,18,21,2,19,18,61,25,1,Matches,Atletico-Madrid,La-Liga
641,Nahuel Molina,ar ARG,DF,27-029,16.0,40,17,19,20,1,29,52,55.8,23,16,3,13,11,51,49,0,Matches,Atletico-Madrid,La-Liga
642,Alexander Sørloth,no NOR,FW,29-151,14.8,8,4,2,4,2,3,5,60.0,2,5,1,4,1,9,23,0,Matches,Atletico-Madrid,La-Liga
643,Reinildo Mandava,mz MOZ,DF,31-104,10.5,18,11,10,7,1,10,18,55.6,8,11,5,6,16,34,35,0,Matches,Atletico-Madrid,La-Liga
644,César Azpilicueta,es ESP,DF,35-250,8.2,23,12,11,8,4,16,22,72.7,6,6,2,4,3,26,27,0,Matches,Atletico-Madrid,La-Liga
645,Axel Witsel,be BEL,DF,36-113,8.5,13,12,4,8,1,10,12,83.3,2,15,8,7,9,22,32,1,Matches,Atletico-Madrid,La-Liga
646,Rodrigo Riquelme,es ESP,"MF,DF",25-033,5.7,11,5,4,6,1,6,11,54.5,5,3,0,3,2,13,3,0,Matches,Atletico-Madrid,La-Liga
647,Ángel Correa,ar ARG,"FW,MF",30-057,8.1,8,2,4,1,3,4,14,28.6,10,9,0,9,4,12,7,0,Matches,Atletico-Madrid,La-Liga
648,Juan Musso,ar ARG,GK,30-364,1.0,0,0,0,0,0,0,0,,0,0,0,0,0,0,0,0,Matches,Atletico-Madrid,La-Liga
649,Thomas Lemar,fr FRA,MF,29-174,0.7,2,1,1,1,0,2,4,50.0,2,0,0,0,0,2,0,0,Matches,Atletico-Madrid,La-Liga
650,Adrian Niño,es ESP,FW,20-320,0.1,0,0,0,0,0,0,0,,0,0,0,0,0,0,0,0,Matches,Atletico-Madrid,La-Liga
651,Pedri,es ESP,MF,22-161,28.6,55,30,13,33,9,22,62,35.5,40,40,3,37,26,81,21,1,Matches,Barcelona,La-Liga
652,Jules Koundé,fr FRA,DF,26-174,28.9,63,43,29,23,11,44,66,66.7,22,35,5,30,20,83,68,2,Matches,Barcelona,La-Liga
653,Robert Lewandowski,pl POL,FW,36-257,27.1,9,4,1,5,3,4,10,40.0,6,14,2,12,3,12,24,0,Matches,Barcelona,La-Liga
654,Raphinha,br BRA,"FW,MF",28-142,27.8,35,21,6,18,11,19,35,54.3,16,26,2,24,8,43,24,0,Matches,Barcelona,La-Liga
655,Lamine Yamal,es ESP,FW,17-296,27.7,39,26,5,17,17,15,34,44.1,19,12,0,12,13,52,3,0,Matches,Barcelona,La-Liga
656,Pau Cubarsí,es ESP,DF,18-103,26.0,28,18,18,7,3,16,25,64.0,9,10,8,2,13,41,75,1,Matches,Barcelona,La-Liga
657,Iñigo Martínez,es ESP,DF,33-353,25.7,23,13,18,5,0,15,21,71.4,6,18,7,11,18,41,104,1,Matches,Barcelona,La-Liga
658,Alejandro Balde,es ESP,DF,21-199,23.1,16,10,9,4,3,9,14,64.3,5,23,4,19,5,21,25,0,Matches,Barcelona,La-Liga
659,Marc Casado,es ESP,MF,21-233,17.9,44,25,7,30,7,20,41,48.8,21,20,5,15,22,66,22,1,Matches,Barcelona,La-Liga
660,Iñaki Peña,es ESP,GK,26-064,14.5,0,0,0,0,0,0,2,0.0,2,0,0,0,0,0,20,1,Matches,Barcelona,La-Liga
661,Wojciech Szczęsny,pl POL,GK,35-017,13.0,1,1,1,0,0,0,0,,0,0,0,0,0,1,14,1,Matches,Barcelona,La-Liga
662,Gavi,es ESP,"MF,FW",20-273,9.9,19,15,4,11,4,10,18,55.6,8,13,1,12,10,29,5,0,Matches,Barcelona,La-Liga
663,Dani Olmo,es ESP,"MF,FW",26-363,11.4,14,9,8,4,2,3,11,27.3,8,6,3,3,3,17,10,1,Matches,Barcelona,La-Liga
664,Ferrán Torres,es ESP,"FW,MF",25-065,11.3,7,4,2,2,3,3,8,37.5,5,7,1,6,4,11,5,0,Matches,Barcelona,La-Liga
665,Eric García,es ESP,"MF,DF",24-116,13.7,28,16,7,19,2,14,20,70.0,6,20,7,13,10,38,36,0,Matches,Barcelona,La-Liga
666,Fermin López,es ESP,"MF,FW",21-359,11.5,18,14,3,8,7,7,25,28.0,18,8,0,8,4,22,3,0,Matches,Barcelona,La-Liga
667,Ronald Araújo,uy URU,DF,26-059,7.1,12,9,6,5,1,4,4,100.0,0,6,4,2,8,20,19,0,Matches,Barcelona,La-Liga
668,Gerard Martín,es ESP,DF,23-124,9.8,20,9,8,7,5,10,15,66.7,5,15,2,13,8,28,25,0,Matches,Barcelona,La-Liga
669,Frenkie de Jong,nl NED,MF,27-358,10.1,15,9,4,5,6,7,14,50.0,7,6,0,6,5,20,6,1,Matches,Barcelona,La-Liga
670,Marc-André ter Stegen,de GER,GK,33-005,6.5,0,0,0,0,0,0,1,0.0,1,0,0,0,0,0,2,2,Matches,Barcelona,La-Liga
671,Héctor Fort,es ESP,DF,18-276,6.0,13,8,6,4,3,10,15,66.7,5,11,0,11,6,19,15,0,Matches,Barcelona,La-Liga
672,Pablo Torre,es ESP,"MF,FW",22-032,3.4,5,4,1,3,1,2,4,50.0,2,0,0,0,3,8,5,1,Matches,Barcelona,La-Liga
673,Marc Bernal,es ESP,MF,17-344,2.7,8,6,2,5,1,7,8,87.5,1,5,1,4,1,9,4,0,Matches,Barcelona,La-Liga
674,Ansu Fati,es ESP,FW,22-186,2.6,4,1,0,2,2,1,2,50.0,1,1,0,1,1,5,0,1,Matches,Barcelona,La-Liga
675,Pau Victor Delgado,es ESP,FW,23-160,3.3,2,1,0,1,1,0,3,0.0,3,6,1,5,2,4,5,0,Matches,Barcelona,La-Liga
676,Sergi Dominguez,es ESP,DF,20-034,1.9,1,1,1,0,0,0,0,,0,0,0,0,3,4,7,0,Matches,Barcelona,La-Liga
677,Andreas Christensen,dk DEN,DF,29-025,1.3,1,1,0,1,0,1,1,100.0,0,0,0,0,0,1,3,0,Matches,Barcelona,La-Liga
678,Daniel Rodriguez,es ESP,FW,19-269,0.4,0,0,0,0,0,0,0,,0,1,0,1,0,0,0,0,Matches,Barcelona,La-Liga
679,Diego Llorente,es ESP,DF,31-262,28.0,36,20,23,12,1,25,38,65.8,13,29,20,9,43,79,154,1,Matches,Real-Betis,La-Liga
680,Johnny Cardoso,us USA,MF,23-227,21.7,51,28,12,31,8,20,50,40.0,30,26,12,14,46,97,58,1,Matches,Real-Betis,La-Liga
681,Marc Bartra,es ESP,DF,34-110,20.5,26,16,17,9,0,12,20,60.0,8,33,21,12,30,56,141,0,Matches,Real-Betis,La-Liga
682,Romain Perraud,fr FRA,DF,27-225,20.1,35,21,15,15,5,20,45,44.4,25,15,3,12,21,56,66,1,Matches,Real-Betis,La-Liga
683,Abde Ezzalzouli,ma MAR,"FW,MF",23-139,19.6,35,25,17,15,3,14,25,56.0,11,20,3,17,6,41,15,0,Matches,Real-Betis,La-Liga
684,Natan,br BRA,DF,24-088,20.2,32,21,21,9,2,23,27,85.2,4,22,13,9,23,55,104,1,Matches,Real-Betis,La-Liga
685,Sergi Altimira,es ESP,MF,23-253,19.5,54,32,15,33,6,32,55,58.2,23,27,1,26,20,74,40,2,Matches,Real-Betis,La-Liga
686,Youssouf Sabaly,sn SEN,DF,32-061,17.3,39,25,20,15,4,24,32,75.0,8,20,3,17,13,52,39,0,Matches,Real-Betis,La-Liga
687,Pablo Fornals,es ESP,"MF,FW",29-072,17.1,16,10,9,6,1,6,24,25.0,18,19,1,18,20,36,13,1,Matches,Real-Betis,La-Liga
688,Adrián,es ESP,GK,38-122,15.0,0,0,0,0,0,0,2,0.0,2,0,0,0,0,0,9,2,Matches,Real-Betis,La-Liga
689,Rui Silva,pt POR,GK,31-087,15.0,0,0,0,0,0,0,1,0.0,1,1,0,1,0,0,7,0,Matches,Real-Betis,La-Liga
690,Isco,es ESP,MF,33-014,14.6,16,9,1,11,4,7,26,26.9,19,9,0,9,8,24,6,0,Matches,Real-Betis,La-Liga
691,Vitor Roque,br BRA,FW,20-066,13.7,11,6,1,6,4,1,5,20.0,4,5,0,5,7,18,4,0,Matches,Real-Betis,La-Liga
692,Giovani Lo Celso,ar ARG,"MF,FW",29-026,14.5,33,22,8,16,9,16,24,66.7,8,14,2,12,5,38,3,1,Matches,Real-Betis,La-Liga
693,Ricardo Rodríguez,ch SUI,DF,32-253,12.3,25,13,13,5,7,16,25,64.0,9,8,1,7,6,31,45,0,Matches,Real-Betis,La-Liga
694,Antony,br BRA,FW,25-070,12.2,18,7,3,8,7,5,17,29.4,12,10,1,9,9,27,9,1,Matches,Real-Betis,La-Liga
695,Jesus Rodríguez,es ESP,FW,19-165,10.8,16,14,6,6,4,5,12,41.7,7,13,0,13,6,22,2,0,Matches,Real-Betis,La-Liga
696,Marc Roca,es ESP,MF,28-160,10.1,20,14,10,9,1,9,17,52.9,8,17,5,12,14,34,14,2,Matches,Real-Betis,La-Liga
697,Cucho,co COL,FW,26-015,9.7,12,8,1,5,6,5,9,55.6,4,13,1,12,6,18,3,0,Matches,Real-Betis,La-Liga
698,Aitor Ruibal,es ESP,"DF,FW",29-044,11.0,21,15,15,3,3,16,27,59.3,11,15,4,11,11,32,27,0,Matches,Real-Betis,La-Liga
699,Ezequiel Ávila,ar ARG,FW,31-088,7.5,8,3,2,2,4,4,10,40.0,6,4,0,4,2,10,8,0,Matches,Real-Betis,La-Liga
700,Héctor Bellerín,es ESP,DF,30-047,6.4,13,7,7,4,2,10,17,58.8,7,5,3,2,6,19,21,0,Matches,Real-Betis,La-Liga
701,Cédric Bakambu,cd COD,FW,34-024,6.9,6,4,0,5,1,3,7,42.9,4,11,2,9,0,6,5,0,Matches,Real-Betis,La-Liga
702,William Carvalho,pt POR,MF,33-028,4.3,5,3,1,4,0,3,5,60.0,2,5,1,4,3,8,4,0,Matches,Real-Betis,La-Liga
703,Fran Vieites,es ESP,GK,25-363,4.0,0,0,0,0,0,0,0,,0,0,0,0,0,0,1,0,Matches,Real-Betis,La-Liga
704,Ángel Ortíz,es ESP,DF,20-284,3.8,10,7,7,3,0,6,15,40.0,9,6,0,6,5,15,7,0,Matches,Real-Betis,La-Liga
705,Iker Losada,es ESP,"MF,FW",23-277,3.7,10,7,2,4,4,5,10,50.0,5,2,0,2,3,13,2,0,Matches,Real-Betis,La-Liga
706,Assane Diao,sn SEN,FW,19-240,3.1,5,3,1,3,1,4,9,44.4,5,3,0,3,0,5,3,0,Matches,Real-Betis,La-Liga
707,Juanmi,es ESP,"FW,MF",31-350,2.7,7,4,3,3,1,4,6,66.7,2,4,0,4,1,8,4,0,Matches,Real-Betis,La-Liga
708,Nabil Fekir,fr FRA,MF,31-291,2.0,3,2,1,1,1,1,2,50.0,1,2,0,2,0,3,0,0,Matches,Real-Betis,La-Liga
709,Carlos Guirao,es ESP,MF,22-008,1.2,5,3,1,4,0,4,6,66.7,2,1,1,0,3,8,2,0,Matches,Real-Betis,La-Liga
710,Mateo Flores,es ESP,MF,21-028,1.7,3,1,3,0,0,1,1,100.0,0,1,0,1,2,5,3,0,Matches,Real-Betis,La-Liga
711,Rodri,es ESP,FW,24-354,1.3,2,1,1,1,0,1,2,50.0,1,2,1,1,1,3,1,1,Matches,Real-Betis,La-Liga
712,Sergio Arribas,es ESP,DF,22-084,1.0,7,4,4,3,0,6,7,85.7,1,2,2,0,3,10,4,0,Matches,Real-Betis,La-Liga
713,Pablo Garcia,es ESP,FW,18-263,0.3,0,0,0,0,0,0,0,,0,1,0,1,0,0,0,0,Matches,Real-Betis,La-Liga
714,Vicente Guaita,es ESP,GK,38-115,30.0,0,0,0,0,0,0,0,,0,0,0,0,0,0,20,1,Matches,Celta-Vigo,La-Liga
715,Óscar Mingueza,es ESP,"MF,DF",25-357,26.6,34,20,17,12,5,24,60,40.0,36,28,4,24,20,54,40,4,Matches,Celta-Vigo,La-Liga
716,Marcos Alonso,es ESP,DF,34-128,27.0,33,20,18,12,3,24,43,55.8,19,22,7,15,32,65,115,4,Matches,Celta-Vigo,La-Liga
717,Carl Starfelt,se SWE,DF,29-338,25.2,40,20,25,14,1,18,27,66.7,9,29,21,8,31,71,129,3,Matches,Celta-Vigo,La-Liga
718,Fran Beltrán,es ESP,MF,26-091,23.4,42,30,19,18,5,19,48,39.6,29,23,5,18,23,65,29,3,Matches,Celta-Vigo,La-Liga
719,Javi Rodríguez,es ESP,DF,21-313,24.4,47,34,31,16,0,30,43,69.8,13,28,9,19,31,78,86,1,Matches,Celta-Vigo,La-Liga
720,Borja Iglesias,es ESP,FW,32-108,19.9,10,9,2,5,3,4,14,28.6,10,8,2,6,6,16,6,0,Matches,Celta-Vigo,La-Liga
721,Ilaix Moriba,gn GUI,MF,22-106,19.7,58,36,19,26,13,26,46,56.5,20,23,4,19,13,71,26,1,Matches,Celta-Vigo,La-Liga
722,Iago Aspas,es ESP,"FW,MF",37-277,17.7,13,8,4,5,4,8,19,42.1,11,16,1,15,7,20,5,0,Matches,Celta-Vigo,La-Liga
723,Sergio Carreira,es ESP,"MF,DF",24-204,16.4,27,16,15,6,6,14,24,58.3,10,18,2,16,17,44,35,0,Matches,Celta-Vigo,La-Liga
724,Hugo Álvarez,es ESP,"MF,DF",21-307,16.4,23,9,11,10,2,9,17,52.9,8,18,1,17,8,31,28,1,Matches,Celta-Vigo,La-Liga
725,Hugo Sotelo,es ESP,MF,21-137,13.9,28,17,8,10,10,13,30,43.3,17,9,1,8,5,33,9,1,Matches,Celta-Vigo,La-Liga
726,Pablo Durán,es ESP,"FW,MF",23-345,13.1,14,9,4,7,3,3,12,25.0,9,8,2,6,8,22,9,0,Matches,Celta-Vigo,La-Liga
727,Williot Swedberg,se SWE,"FW,MF",21-093,13.0,19,13,6,9,4,11,17,64.7,6,12,1,11,3,22,9,1,Matches,Celta-Vigo,La-Liga
728,Alfon,es ESP,"FW,MF",26-001,13.5,6,2,2,2,2,2,10,20.0,8,6,0,6,4,10,5,1,Matches,Celta-Vigo,La-Liga
729,Carlos Dominguez,es ESP,DF,24-083,10.0,20,11,12,8,0,14,19,73.7,5,9,6,3,8,28,51,1,Matches,Celta-Vigo,La-Liga
730,Jonathan Bamba,ci CIV,"FW,MF",29-040,9.0,12,7,4,6,2,5,12,41.7,7,6,0,6,5,17,6,0,Matches,Celta-Vigo,La-Liga
731,Damián Rodríguez,es ESP,MF,22-049,9.8,14,9,3,10,1,6,16,37.5,10,6,1,5,6,20,11,0,Matches,Celta-Vigo,La-Liga
732,Javier Manquillo,es ESP,DF,31-000,5.7,7,5,4,3,0,2,10,20.0,8,5,3,2,7,14,14,0,Matches,Celta-Vigo,La-Liga
733,Anastasios Douvikas,gr GRE,FW,25-276,7.8,9,4,2,6,1,3,6,50.0,3,5,2,3,3,12,6,0,Matches,Celta-Vigo,La-Liga
734,Jailson Siqueira,br BRA,"DF,MF",29-240,6.8,13,11,9,3,1,9,11,81.8,2,6,4,2,9,22,28,1,Matches,Celta-Vigo,La-Liga
735,Fer López,,"FW,MF",,5.9,7,3,1,4,2,0,6,0.0,6,8,0,8,2,9,7,0,Matches,Celta-Vigo,La-Liga
736,Yoel Lago,es ESP,DF,21-041,4.3,7,4,4,2,1,3,4,75.0,1,3,2,1,4,11,14,0,Matches,Celta-Vigo,La-Liga
737,Iván Villar,es ESP,GK,27-300,4.0,0,0,0,0,0,0,0,,0,0,0,0,0,0,3,0,Matches,Celta-Vigo,La-Liga
738,Iker Losada,es ESP,"FW,MF",23-277,3.8,3,3,0,1,2,1,5,20.0,4,3,0,3,1,4,7,0,Matches,Celta-Vigo,La-Liga
739,Franco Cervi,ar ARG,"FW,MF",30-344,2.9,8,3,2,6,0,3,7,42.9,4,4,0,4,8,16,6,0,Matches,Celta-Vigo,La-Liga
740,Mihailo Ristić,rs SRB,"MF,DF",29-186,2.7,3,3,2,1,0,1,3,33.3,2,0,0,0,1,4,6,0,Matches,Celta-Vigo,La-Liga
741,Luca de la Torre,us USA,MF,26-347,0.0,0,0,0,0,0,0,0,,0,0,0,0,0,0,0,0,Matches,Celta-Vigo,La-Liga
742,Joseph Aidoo,gh GHA,DF,29-218,0.0,1,0,1,0,0,0,0,,0,0,0,0,0,1,0,0,Matches,Celta-Vigo,La-Liga
743,Tadeo Allende,ar ARG,FW,26-074,0.0,0,0,0,0,0,0,0,,0,0,0,0,0,0,0,0,Matches,Celta-Vigo,La-Liga
744,Joan García,es ESP,GK,24-001,34.0,0,0,0,0,0,0,1,0.0,1,1,0,1,0,0,18,4,Matches,Espanyol,La-Liga
745,Omar El Hilali,ma MAR,DF,21-235,32.1,106,76,77,24,5,60,90,66.7,30,48,12,36,43,149,140,2,Matches,Espanyol,La-Liga
746,Marash Kumbulla,al ALB,DF,25-086,30.0,49,24,34,13,2,24,39,61.5,15,44,33,11,31,80,207,2,Matches,Espanyol,La-Liga
747,Javi Puado,es ESP,"FW,MF",26-345,29.5,19,15,11,4,4,8,15,53.3,7,14,2,12,5,24,19,0,Matches,Espanyol,La-Liga
748,Leandro Cabrera,uy URU,DF,33-322,29.0,37,21,26,8,3,17,30,56.7,13,34,24,10,28,65,188,2,Matches,Espanyol,La-Liga
749,Alex Král,cz CZE,MF,26-351,29.2,54,36,28,23,3,16,29,55.2,13,33,14,19,27,81,49,2,Matches,Espanyol,La-Liga
750,Carlos Romero,es ESP,DF,23-188,24.4,59,37,43,13,3,36,68,52.9,32,43,14,29,23,82,91,1,Matches,Espanyol,La-Liga
751,Jofre,es ESP,"MF,FW",23-322,22.4,21,15,13,5,3,12,21,57.1,9,13,0,13,15,36,28,0,Matches,Espanyol,La-Liga
752,Pol Lozano,es ESP,MF,25-211,19.8,50,33,20,25,5,24,54,44.4,30,28,5,23,21,71,29,0,Matches,Espanyol,La-Liga
753,Roberto Férnandez,es ESP,FW,22-306,13.1,4,4,2,1,1,0,3,0.0,3,7,1,6,3,7,21,0,Matches,Espanyol,La-Liga
754,Álvaro Tejero,es ESP,"MF,DF",28-289,13.2,12,4,5,6,1,5,20,25.0,15,9,1,8,12,24,34,1,Matches,Espanyol,La-Liga
755,Urko González,es ESP,MF,24-046,11.5,36,20,21,14,1,22,31,71.0,9,22,10,12,7,43,29,0,Matches,Espanyol,La-Liga
756,Brian Oliván,es ESP,DF,31-034,11.3,13,10,7,6,0,4,13,30.8,9,6,2,4,10,23,23,0,Matches,Espanyol,La-Liga
757,Antoniu,es ESP,"MF,FW",22-242,9.8,20,9,8,8,4,9,18,50.0,9,13,2,11,7,27,10,1,Matches,Espanyol,La-Liga
758,Alejo Véliz,ar ARG,FW,21-228,11.2,1,1,0,1,0,1,6,16.7,5,11,2,9,4,5,21,1,Matches,Espanyol,La-Liga
759,Edu Expósito,es ESP,MF,28-277,8.0,16,9,5,11,0,6,18,33.3,12,3,0,3,10,26,16,2,Matches,Espanyol,La-Liga
760,José Gragera,es ESP,MF,24-156,6.3,25,16,11,14,0,9,17,52.9,8,9,1,8,5,30,13,0,Matches,Espanyol,La-Liga
761,Sergi Gómez,es ESP,DF,33-038,7.2,8,5,7,1,0,2,3,66.7,1,12,8,4,7,15,36,0,Matches,Espanyol,La-Liga
762,Walid Cheddira,ma MAR,FW,27-103,6.8,5,0,1,1,3,0,1,0.0,1,4,0,4,1,6,6,0,Matches,Espanyol,La-Liga
763,Irvin Cardona,fr FRA,"FW,MF",27-270,6.7,8,5,2,4,2,6,16,37.5,10,5,1,4,4,12,10,0,Matches,Espanyol,La-Liga
764,Álvaro Aguado,es ESP,MF,29-004,4.8,4,2,2,2,0,2,8,25.0,6,6,1,5,4,8,5,1,Matches,Espanyol,La-Liga
765,Fernando Calero,es ESP,"DF,MF",29-233,5.3,12,6,9,3,0,5,6,83.3,1,11,6,5,13,25,31,0,Matches,Espanyol,La-Liga
766,Justin Smith,ca CAN,MF,22-090,2.3,9,3,3,6,0,4,6,66.7,2,5,1,4,4,13,3,0,Matches,Espanyol,La-Liga
767,Rafael Bauza,es ESP,MF,20-095,2.0,5,3,3,1,1,4,7,57.1,3,3,1,2,0,5,5,0,Matches,Espanyol,La-Liga
768,Pere Milla,es ESP,"MF,FW",32-224,3.5,4,1,3,0,1,0,14,0.0,14,9,2,7,2,6,4,0,Matches,Espanyol,La-Liga
769,Naci Ünüvar,nl NED,"MF,DF",21-326,0.3,2,2,1,1,0,1,2,50.0,1,0,0,0,0,2,0,0,Matches,Espanyol,La-Liga
770,Roger Hinojo,es ESP,DF,20-073,0.1,0,0,0,0,0,0,0,,0,0,0,0,0,0,1,0,Matches,Espanyol,La-Liga
771,David Soria,es ESP,GK,32-031,34.0,4,4,4,0,0,4,5,80.0,1,0,0,0,1,5,17,2,Matches,Getafe,La-Liga
772,Omar Alderete,py PAR,DF,28-130,30.4,41,27,29,10,2,20,30,66.7,10,33,21,12,36,77,207,1,Matches,Getafe,La-Liga
773,Djené,tg TOG,"DF,MF",33-125,27.3,25,13,12,11,2,12,31,38.7,19,18,8,10,21,46,104,3,Matches,Getafe,La-Liga
774,Luis Milla,es ESP,MF,30-210,28.9,52,34,27,20,5,29,62,46.8,33,23,0,23,21,73,27,2,Matches,Getafe,La-Liga
775,Iglesias,es ESP,DF,26-306,28.3,75,46,39,30,6,43,82,52.4,39,43,7,36,41,116,123,1,Matches,Getafe,La-Liga
776,Diego Rico,es ESP,DF,32-071,27.3,74,45,44,27,3,42,77,54.5,35,37,3,34,31,105,90,2,Matches,Getafe,La-Liga
777,Mauro Arambarri,uy URU,MF,29-217,26.9,45,26,9,31,5,21,44,47.7,23,33,6,27,13,58,41,0,Matches,Getafe,La-Liga
778,Chrisantus Uche,ng NGA,"FW,MF",21-351,24.8,28,17,6,16,6,6,15,40.0,9,18,2,16,9,37,17,0,Matches,Getafe,La-Liga
779,Domingos Duarte,pt POR,DF,30-056,17.0,23,11,18,4,1,13,17,76.5,4,24,14,10,13,36,124,1,Matches,Getafe,La-Liga
780,Carles Pérez,es ESP,"MF,FW",27-078,15.9,33,23,11,14,8,21,48,43.8,27,19,2,17,6,39,22,0,Matches,Getafe,La-Liga
781,Bertuğ Yıldırım,tr TUR,FW,22-297,11.6,10,5,0,7,3,2,7,28.6,5,12,2,10,1,11,16,0,Matches,Getafe,La-Liga
782,Alex Sola,es ESP,"MF,FW",25-330,11.4,21,14,9,12,0,9,25,36.0,16,8,0,8,7,28,11,1,Matches,Getafe,La-Liga
783,Ramón Terrats,es ESP,"MF,FW",24-199,10.1,14,6,7,2,5,7,24,29.2,17,7,1,6,4,18,12,0,Matches,Getafe,La-Liga
784,Coba da Costa,es ESP,"MF,FW",22-283,9.9,27,12,9,15,3,12,24,50.0,12,21,0,21,7,34,7,0,Matches,Getafe,La-Liga
785,Juan Berrocal,es ESP,DF,26-001,10.6,14,7,10,4,0,10,13,76.9,3,3,2,1,13,27,50,0,Matches,Getafe,La-Liga
786,Allan Nyom,cm CMR,"DF,MF",36-360,7.7,13,7,5,7,1,10,12,83.3,2,4,2,2,2,15,18,0,Matches,Getafe,La-Liga
787,Juanmi,es ESP,"FW,MF",31-350,7.4,14,11,4,7,3,6,16,37.5,10,6,0,6,2,16,3,0,Matches,Getafe,La-Liga
788,Juan Bernat,es ESP,"MF,DF",32-065,7.0,16,12,8,5,3,6,11,54.5,5,8,3,5,2,18,8,0,Matches,Getafe,La-Liga
789,Álvaro Rodríguez,uy URU,FW,20-295,7.9,9,6,0,6,3,4,8,50.0,4,21,0,21,3,12,12,0,Matches,Getafe,La-Liga
790,Carles Aleñá,es ESP,"MF,FW",27-120,5.0,6,3,2,3,1,4,13,30.8,9,9,1,8,0,6,7,0,Matches,Getafe,La-Liga
791,Borja Mayoral,es ESP,FW,28-030,9.3,2,2,1,1,0,1,5,20.0,4,3,0,3,0,2,6,0,Matches,Getafe,La-Liga
792,Jesús Santiago,es ESP,MF,20-345,3.6,12,7,6,6,0,5,9,55.6,4,5,2,3,1,13,3,0,Matches,Getafe,La-Liga
793,Nabil Aberdin,fr FRA,MF,22-255,2.9,6,4,3,3,0,1,1,100.0,0,3,0,3,0,6,5,0,Matches,Getafe,La-Liga
794,Peter González,do DOM,"MF,FW",22-284,4.4,9,5,1,4,4,4,7,57.1,3,6,0,6,1,10,5,0,Matches,Getafe,La-Liga
795,Abdoulaye Keita,es ESP,"FW,MF",22-246,1.1,2,2,0,1,1,2,4,50.0,2,1,0,1,0,2,3,0,Matches,Getafe,La-Liga
796,Alberto Risco,es ESP,"MF,FW",19-248,0.8,4,4,2,0,2,1,6,16.7,5,2,0,2,0,4,0,0,Matches,Getafe,La-Liga
797,John Joe,ie IRL,"MF,FW",21-193,0.5,0,0,0,0,0,0,0,,0,1,1,0,0,0,1,0,Matches,Getafe,La-Liga
798,Gorka Rivera Alonso,es ESP,"DF,MF",20-277,0.2,2,0,0,2,0,2,2,100.0,0,0,0,0,0,2,0,0,Matches,Getafe,La-Liga
799,Ismael Bekhoucha,ma MAR,"DF,MF",20-166,0.1,0,0,0,0,0,0,0,,0,0,0,0,2,2,0,0,Matches,Getafe,La-Liga
800,David Argüelles,es ESP,MF,23-124,0.1,0,0,0,0,0,0,0,,0,2,0,2,0,0,0,0,Matches,Getafe,La-Liga
801,Paulo Gazzaniga,ar ARG,GK,33-123,32.5,1,1,1,0,0,1,1,100.0,0,1,0,1,0,1,12,3,Matches,Girona,La-Liga
802,Miguel Gutiérrez,es ESP,"DF,MF",23-282,27.3,37,24,18,16,3,17,37,45.9,20,17,7,10,16,53,34,3,Matches,Girona,La-Liga
803,Daley Blind,nl NED,DF,35-057,25.9,40,23,22,14,4,25,37,67.6,12,28,8,20,22,62,78,1,Matches,Girona,La-Liga
804,Arnau Martinez,es ESP,"DF,MF",22-010,24.7,38,19,24,9,5,26,53,49.1,27,13,5,8,24,62,63,2,Matches,Girona,La-Liga
805,David López,es ESP,DF,35-208,24.0,28,20,19,6,3,17,30,56.7,13,21,11,10,12,40,95,1,Matches,Girona,La-Liga
806,Ladislav Krejčí,cz CZE,DF,26-015,23.1,21,15,17,4,0,12,24,50.0,12,24,19,5,31,52,81,4,Matches,Girona,La-Liga
807,Yangel Herrera,ve VEN,MF,27-111,21.3,54,34,25,24,5,25,50,50.0,25,18,3,15,27,81,41,1,Matches,Girona,La-Liga
808,Iván Martín,es ESP,MF,26-080,19.5,28,16,13,12,3,13,31,41.9,18,17,4,13,10,38,15,1,Matches,Girona,La-Liga
809,Bryan Gil,es ESP,"FW,MF",24-083,19.1,34,20,10,15,9,14,30,46.7,16,24,0,24,10,44,9,4,Matches,Girona,La-Liga
810,Viktor Tsyhankov,ua UKR,"FW,MF",27-171,16.6,15,11,2,5,8,6,15,40.0,9,4,0,4,11,26,11,1,Matches,Girona,La-Liga
811,Donny van de Beek,nl NED,MF,28-017,15.8,29,18,17,7,5,13,26,50.0,13,19,3,16,10,39,12,0,Matches,Girona,La-Liga
812,Oriol Romeu,es ESP,MF,33-223,13.7,32,22,13,16,3,12,22,54.5,10,19,6,13,11,43,17,3,Matches,Girona,La-Liga
813,Abel Ruiz,es ESP,FW,25-097,13.6,6,2,2,2,2,2,5,40.0,3,7,2,5,4,10,7,0,Matches,Girona,La-Liga
814,Arnaut Danjuma,nl NED,"FW,MF",28-094,14.6,8,6,3,3,2,2,7,28.6,5,5,1,4,2,10,4,0,Matches,Girona,La-Liga
815,Yaser Asprilla,co COL,"FW,MF",21-167,12.5,14,8,5,6,3,5,14,35.7,9,10,0,10,5,19,4,1,Matches,Girona,La-Liga
816,Bojan Miovski,mk MKD,FW,25-315,9.4,7,5,2,2,3,2,7,28.6,5,4,0,4,2,9,7,0,Matches,Girona,La-Liga
817,Alejandro Francés,es ESP,DF,22-277,10.6,29,21,15,13,1,22,31,71.0,9,12,5,7,15,44,37,0,Matches,Girona,La-Liga
818,Juanpe,es ESP,DF,34-005,6.8,8,5,5,3,0,6,8,75.0,2,14,9,5,8,16,46,1,Matches,Girona,La-Liga
819,Arthur Melo,br BRA,MF,28-266,6.3,20,8,7,12,1,12,21,57.1,9,3,1,2,5,25,6,1,Matches,Girona,La-Liga
820,Cristhian Stuani,uy URU,FW,38-205,8.3,7,6,1,5,1,3,4,75.0,1,4,1,3,5,12,7,0,Matches,Girona,La-Liga
821,Portu,es ESP,"FW,MF",32-349,5.3,11,5,5,3,3,6,8,75.0,2,6,0,6,0,11,1,0,Matches,Girona,La-Liga
822,Jhon Solis,co COL,MF,20-214,5.2,10,5,3,6,1,5,13,38.5,8,12,1,11,4,14,6,1,Matches,Girona,La-Liga
823,Silvi Clúa,es ESP,MF,20-096,1.8,8,7,4,3,1,4,6,66.7,2,1,0,1,2,10,6,0,Matches,Girona,La-Liga
824,Gabriel Osei Misehouy,nl NED,"FW,MF",19-291,2.9,1,1,0,1,0,0,1,0.0,1,0,0,0,0,1,0,0,Matches,Girona,La-Liga
825,Iker Almena,es ESP,"FW,DF",21-001,0.5,0,0,0,0,0,0,1,0.0,1,1,0,1,0,0,2,0,Matches,Girona,La-Liga
826,Papa Ba,es ESP,MF,20-235,0.5,1,1,1,0,0,0,0,,0,1,0,1,0,1,1,0,Matches,Girona,La-Liga
827,Pau López,es ESP,GK,30-143,0.5,0,0,0,0,0,0,0,,0,0,0,0,0,0,1,0,Matches,Girona,La-Liga
828,Kim Minsu,kr KOR,"MF,FW",19-106,0.2,1,0,0,1,0,0,0,,0,0,0,0,0,1,0,0,Matches,Girona,La-Liga
829,Ferrán Ruiz,es ESP,MF,22-009,0.2,0,0,0,0,0,0,0,,0,2,1,1,1,1,0,0,Matches,Girona,La-Liga
830,Alberto Moleiro,es ESP,"FW,MF",21-217,27.4,25,11,10,14,1,18,48,37.5,30,23,0,23,16,41,8,0,Matches,Las-Palmas,La-Liga
831,Álex Suárez,es ESP,DF,32-048,25.8,39,22,29,9,1,20,27,74.1,7,35,21,14,12,51,100,1,Matches,Las-Palmas,La-Liga
832,Javier Muñoz,es ESP,"MF,DF",30-066,27.8,43,34,18,15,10,15,43,34.9,28,24,4,20,29,72,36,3,Matches,Las-Palmas,La-Liga
833,Jasper Cillessen,nl NED,GK,36-013,25.9,1,0,1,0,0,1,4,25.0,3,0,0,0,0,1,11,2,Matches,Las-Palmas,La-Liga
834,Scott McKenna,sct SCO,DF,28-174,25.4,18,12,13,5,0,9,12,75.0,3,34,26,8,9,27,146,2,Matches,Las-Palmas,La-Liga
835,Mika Mármol,es ESP,DF,23-308,23.7,53,23,31,20,2,29,43,67.4,14,41,13,28,36,89,105,2,Matches,Las-Palmas,La-Liga
836,Sandro Ramírez,es ESP,"FW,MF",29-300,21.4,26,15,9,13,4,13,29,44.8,16,18,0,18,16,42,21,2,Matches,Las-Palmas,La-Liga
837,Fábio Silva,pt POR,FW,22-290,20.7,12,7,4,5,3,4,14,28.6,10,12,0,12,4,16,27,0,Matches,Las-Palmas,La-Liga
838,Dario Essugo,pt POR,MF,20-052,18.9,54,42,27,22,5,26,43,60.5,17,24,9,15,41,95,43,7,Matches,Las-Palmas,La-Liga
839,Kirian Rodríguez,es ESP,MF,29-061,19.5,33,17,12,18,3,22,43,51.2,21,22,4,18,10,43,21,0,Matches,Las-Palmas,La-Liga
840,Viti,es ESP,DF,27-231,19.5,65,43,41,17,7,29,43,67.4,14,26,6,20,24,89,52,0,Matches,Las-Palmas,La-Liga
841,Oliver McBurnie,sct SCO,FW,28-335,17.4,13,7,5,6,2,5,11,45.5,6,14,5,9,5,18,21,0,Matches,Las-Palmas,La-Liga
842,Álex Muñoz,es ESP,DF,30-279,15.2,38,29,22,15,1,20,37,54.1,17,28,11,17,16,54,68,0,Matches,Las-Palmas,La-Liga
843,José Campaña,es ESP,MF,31-339,12.2,18,14,7,9,2,9,16,56.3,7,8,0,8,18,36,19,2,Matches,Las-Palmas,La-Liga
844,Juan Herzog,es ESP,DF,21-357,10.7,11,11,11,0,0,9,14,64.3,5,13,8,5,14,25,54,0,Matches,Las-Palmas,La-Liga
845,Stefan Bajcetic,es ESP,"MF,DF",20-195,9.3,25,13,12,10,3,9,24,37.5,15,24,4,20,14,39,24,1,Matches,Las-Palmas,La-Liga
846,Marvin,es ESP,"DF,FW",24-306,9.1,21,10,10,7,4,9,22,40.9,13,15,5,10,9,30,25,0,Matches,Las-Palmas,La-Liga
847,Dinko Horkaš,hr CRO,GK,26-056,8.1,0,0,0,0,0,0,0,,0,0,0,0,0,0,6,1,Matches,Las-Palmas,La-Liga
848,Manuel Fuster,es ESP,"FW,MF",27-195,8.8,16,8,3,8,5,14,26,53.8,12,13,3,10,4,20,14,0,Matches,Las-Palmas,La-Liga
849,Enzo Loiodice,fr FRA,MF,24-159,5.6,11,4,6,5,0,3,9,33.3,6,4,1,3,5,16,7,2,Matches,Las-Palmas,La-Liga
850,Jaime Mata,es ESP,FW,36-193,5.9,6,1,1,5,0,3,9,33.3,6,4,1,3,3,9,9,0,Matches,Las-Palmas,La-Liga
851,Adnan Januzaj,be BEL,"MF,FW",30-089,4.5,9,5,1,5,3,5,7,71.4,2,5,0,5,0,9,2,0,Matches,Las-Palmas,La-Liga
852,Andy Pelmard,fr FRA,DF,25-054,2.3,5,0,3,2,0,4,5,80.0,1,3,1,2,2,7,20,0,Matches,Las-Palmas,La-Liga
853,Benito Ramírez,es ESP,"DF,MF",29-298,4.3,10,5,4,6,0,9,16,56.3,7,6,3,3,1,11,14,1,Matches,Las-Palmas,La-Liga
854,Daley Sinkgraven,nl NED,DF,29-305,1.0,5,1,3,2,0,1,3,33.3,2,1,0,1,1,6,2,0,Matches,Las-Palmas,La-Liga
855,Marc Cardona,es ESP,"FW,DF",29-301,1.2,2,1,1,1,0,0,1,0.0,1,0,0,0,0,2,0,0,Matches,Las-Palmas,La-Liga
856,Fabio González,es ESP,MF,28-082,0.6,0,0,0,0,0,0,1,0.0,1,0,0,0,0,0,0,0,Matches,Las-Palmas,La-Liga
857,Pejiño,es ESP,FW,28-280,0.2,1,1,0,1,0,1,1,100.0,0,0,0,0,0,1,0,0,Matches,Las-Palmas,La-Liga
858,Valentín Pezzolesi,es ESP,DF,18-019,0.1,0,0,0,0,0,0,0,,0,0,0,0,0,0,1,1,Matches,Las-Palmas,La-Liga
859,Aboubacar Bassinga,ci CIV,MF,19-296,0.0,0,0,0,0,0,0,0,,0,0,0,0,0,0,0,0,Matches,Las-Palmas,La-Liga
860,Sergi,es ESP,DF,33-015,31.4,38,28,22,15,1,17,31,54.8,14,35,28,7,39,77,182,2,Matches,Leganes,La-Liga
861,Marko Dmitrović,rs SRB,GK,33-101,28.0,1,1,1,0,0,1,2,50.0,1,0,0,0,0,1,25,3,Matches,Leganes,La-Liga
862,Seydouba Cissé,gn GUI,MF,24-084,23.2,47,30,17,22,8,19,39,48.7,20,23,1,22,11,58,40,1,Matches,Leganes,La-Liga
863,Valentin Rosier,fr FRA,DF,28-259,27.1,69,51,48,15,6,41,66,62.1,25,39,14,25,50,119,143,2,Matches,Leganes,La-Liga
864,Yvan Neyou,cm CMR,MF,28-122,24.1,53,33,21,26,6,22,45,48.9,23,33,5,28,25,78,37,1,Matches,Leganes,La-Liga
865,Javi Hernández,es ESP,DF,27-003,23.5,25,15,16,6,3,16,42,38.1,26,22,3,19,22,47,89,0,Matches,Leganes,La-Liga
866,Renato Tapia,pe PER,"MF,DF",29-281,23.2,54,31,26,24,4,20,43,46.5,23,53,20,33,23,77,73,2,Matches,Leganes,La-Liga
867,Juan Cruz,es ESP,"FW,MF",25-010,23.1,30,19,13,15,2,16,32,50.0,16,14,2,12,11,41,27,0,Matches,Leganes,La-Liga
868,Matija Nastasić,rs SRB,DF,32-038,22.6,24,11,21,3,0,16,24,66.7,8,39,30,9,19,43,155,0,Matches,Leganes,La-Liga
869,Dani Raba,es ESP,"FW,MF",29-188,18.1,34,21,16,14,4,15,37,40.5,22,25,2,23,14,48,14,1,Matches,Leganes,La-Liga
870,Miguel,es ESP,FW,25-244,18.6,16,7,6,4,6,4,14,28.6,10,14,4,10,4,20,23,1,Matches,Leganes,La-Liga
871,Darko Brašanac,rs SRB,MF,33-082,17.3,26,11,5,15,6,9,17,52.9,8,24,11,13,15,41,31,0,Matches,Leganes,La-Liga
872,Jorge Sáenz,es ESP,DF,28-169,14.8,30,21,15,14,1,8,14,57.1,6,22,14,8,21,51,138,0,Matches,Leganes,La-Liga
873,Adrià Altimira,es ESP,"DF,FW",24-038,14.1,32,16,21,9,2,17,31,54.8,14,11,6,5,14,46,43,2,Matches,Leganes,La-Liga
874,Óscar Rodríguez Arnaiz,es ESP,"MF,FW",26-311,13.9,31,16,10,15,6,13,29,44.8,16,9,1,8,18,49,18,0,Matches,Leganes,La-Liga
875,Diego,es ESP,"FW,MF",25-017,10.3,0,0,0,0,0,0,4,0.0,4,3,1,2,2,2,10,0,Matches,Leganes,La-Liga
876,Munir El Haddadi,ma MAR,"FW,MF",29-246,7.4,11,8,5,4,2,3,10,30.0,7,6,1,5,1,12,1,1,Matches,Leganes,La-Liga
877,Enric Franquesa,es ESP,"DF,FW",28-068,6.8,17,9,9,6,2,9,13,69.2,4,7,1,6,5,22,12,0,Matches,Leganes,La-Liga
878,Juan Soriano,es ESP,GK,27-255,6.0,1,1,1,0,0,1,1,100.0,0,0,0,0,0,1,2,0,Matches,Leganes,La-Liga
879,Sébastien Haller,ci CIV,FW,30-317,4.5,2,0,1,0,1,1,2,50.0,1,1,0,1,0,2,7,0,Matches,Leganes,La-Liga
880,Roberto López,es ESP,MF,25-011,4.4,8,6,4,4,0,5,15,33.3,10,5,0,5,1,9,7,2,Matches,Leganes,La-Liga
881,Yan Diomandé,ci CIV,"FW,MF",18-172,2.6,2,1,1,0,1,1,7,14.3,6,6,0,6,3,5,2,0,Matches,Leganes,La-Liga
882,Julián Chicco,ar ARG,"MF,DF",27-112,3.3,11,7,3,6,2,5,8,62.5,3,2,0,2,3,14,9,0,Matches,Leganes,La-Liga
883,Aritz Arambarri,es ESP,DF,27-094,2.0,1,1,1,0,0,1,1,100.0,0,2,2,0,3,4,8,0,Matches,Leganes,La-Liga
884,Duk,cv CPV,"MF,FW",25-078,1.6,6,3,1,3,2,2,4,50.0,2,3,0,3,0,6,2,0,Matches,Leganes,La-Liga
885,Borna Barišić,hr CRO,DF,32-176,0.1,0,0,0,0,0,0,0,,0,0,0,0,0,0,0,0,Matches,Leganes,La-Liga
886,Antonio Raillo,es ESP,DF,33-209,30.6,28,16,15,10,3,14,18,77.8,4,38,30,8,27,55,187,1,Matches,Mallorca,La-Liga
887,Sergi Darder,es ESP,"MF,FW",31-134,25.7,36,22,15,14,7,14,38,36.8,24,18,1,17,14,50,19,1,Matches,Mallorca,La-Liga
888,Johan Mojica,co COL,DF,32-257,27.3,33,22,25,5,3,18,36,50.0,18,10,4,6,25,58,74,2,Matches,Mallorca,La-Liga
889,Dominik Greif,sk SVK,GK,28-029,27.0,0,0,0,0,0,0,0,,0,0,0,0,0,0,7,1,Matches,Mallorca,La-Liga
890,Martin Valjent,sk SVK,DF,29-145,26.7,27,18,20,6,1,13,16,81.3,3,28,18,10,16,43,168,1,Matches,Mallorca,La-Liga
891,Samu Costa,pt POR,MF,24-159,24.6,75,36,36,37,2,27,66,40.9,39,39,12,27,28,103,73,1,Matches,Mallorca,La-Liga
892,Pablo Maffeo,es ESP,DF,27-297,23.5,56,37,41,12,3,32,43,74.4,11,31,11,20,22,78,89,1,Matches,Mallorca,La-Liga
893,Dani Rodríguez,es ESP,"MF,FW",36-333,21.1,42,25,13,19,10,13,26,50.0,13,19,2,17,12,54,22,0,Matches,Mallorca,La-Liga
894,Vedat Muriqi,xk KVX,FW,31-011,19.4,6,4,3,2,1,3,6,50.0,3,5,1,4,7,13,33,0,Matches,Mallorca,La-Liga
895,Cyle Larin,ca CAN,FW,30-018,17.2,11,5,1,5,5,2,7,28.6,5,12,3,9,1,12,13,0,Matches,Mallorca,La-Liga
896,Omar Mascarell,gq EQG,MF,32-092,18.7,24,13,11,12,1,12,28,42.9,16,27,18,9,45,69,49,2,Matches,Mallorca,La-Liga
897,Manu Morlanes,es ESP,MF,26-113,14.4,43,27,18,20,5,18,30,60.0,12,18,7,11,24,67,16,0,Matches,Mallorca,La-Liga
898,Roberto Navarro,es ESP,"MF,FW",23-023,14.2,29,22,14,11,4,9,19,47.4,10,18,0,18,19,48,12,0,Matches,Mallorca,La-Liga
899,Copete,es ESP,DF,25-207,15.3,26,14,16,9,1,9,10,90.0,1,22,15,7,16,42,113,1,Matches,Mallorca,La-Liga
900,Takuma Asano,jp JPN,"FW,MF",30-176,10.6,13,9,5,7,1,6,11,54.5,5,6,0,6,5,18,8,0,Matches,Mallorca,La-Liga
901,Antonio Sánchez,es ESP,"MF,DF",28-124,12.9,26,16,15,7,4,14,28,50.0,14,12,2,10,16,42,29,0,Matches,Mallorca,La-Liga
902,Leo Román,es ESP,GK,24-303,6.0,0,0,0,0,0,0,0,,0,0,0,0,0,0,4,0,Matches,Mallorca,La-Liga
903,Mateu Morey,es ESP,DF,25-064,5.4,14,13,8,4,2,10,17,58.8,7,8,0,8,9,23,15,1,Matches,Mallorca,La-Liga
904,Toni Lato,es ESP,DF,27-165,5.1,16,10,6,4,6,6,9,66.7,3,6,2,4,4,20,27,0,Matches,Mallorca,La-Liga
905,Abdón Prats,es ESP,"FW,MF",32-149,5.1,2,1,1,1,0,1,2,50.0,1,2,1,1,1,3,5,0,Matches,Mallorca,La-Liga
906,Marc Domenech,es ESP,"FW,MF",19-124,2.1,2,2,1,1,0,2,4,50.0,2,2,0,2,0,2,0,0,Matches,Mallorca,La-Liga
907,Valery Fernández,es ESP,"MF,FW",25-163,3.3,8,7,3,2,3,5,7,71.4,2,3,1,2,0,8,1,0,Matches,Mallorca,La-Liga
908,Chiquinho,pt POR,"MF,FW",25-089,1.6,1,0,0,1,0,0,7,0.0,7,3,0,3,2,3,0,0,Matches,Mallorca,La-Liga
909,Siebe Van Der Heyden,be BEL,"DF,MF",26-340,1.1,1,1,0,1,0,0,0,,0,1,0,1,2,3,3,0,Matches,Mallorca,La-Liga
910,David López,es ESP,DF,22-091,0.9,1,1,1,0,0,1,1,100.0,0,0,0,0,1,2,3,0,Matches,Mallorca,La-Liga
911,Javier Llabrés,es ESP,FW,22-236,0.6,0,0,0,0,0,0,0,,0,1,0,1,0,0,0,0,Matches,Mallorca,La-Liga
912,Jan Salas,es ESP,MF,19-268,0.3,2,1,1,1,0,1,1,100.0,0,0,0,0,0,2,0,0,Matches,Mallorca,La-Liga
913,Daniel Luna,co COL,MF,21-363,0.2,0,0,0,0,0,0,0,,0,1,0,1,0,0,0,0,Matches,Mallorca,La-Liga
914,Sergio Herrera,es ESP,GK,31-334,33.0,2,1,2,0,0,2,5,40.0,3,1,0,1,0,2,27,1,Matches,Osasuna,La-Liga
915,Jesús Areso,es ESP,DF,25-307,30.2,45,34,29,11,5,35,51,68.6,16,25,4,21,8,53,79,0,Matches,Osasuna,La-Liga
916,Catena,es ESP,DF,30-189,30.2,43,25,32,9,2,25,41,61.0,16,35,21,14,31,74,193,1,Matches,Osasuna,La-Liga
917,Lucas Torró,es ESP,MF,30-290,29.4,69,39,30,35,4,35,62,56.5,27,33,9,24,43,112,55,3,Matches,Osasuna,La-Liga
918,Aimar Oroz,es ESP,"MF,FW",23-159,29.0,32,18,15,11,6,14,44,31.8,30,27,2,25,18,50,7,0,Matches,Osasuna,La-Liga
919,Ante Budimir,hr CRO,FW,33-287,29.1,20,9,3,11,6,3,12,25.0,9,18,4,14,2,22,19,0,Matches,Osasuna,La-Liga
920,Enzo Boyomo,cm CMR,DF,23-210,29.2,61,37,42,15,4,26,33,78.8,7,33,19,14,36,97,114,3,Matches,Osasuna,La-Liga
921,Rubén García,es ESP,"FW,MF",31-295,24.5,46,29,17,19,10,23,51,45.1,28,32,2,30,14,60,30,1,Matches,Osasuna,La-Liga
922,Jon Moncayola,es ESP,MF,26-357,22.9,68,40,28,32,8,30,59,50.8,29,34,3,31,11,79,19,0,Matches,Osasuna,La-Liga
923,Abel,es ESP,DF,24-257,22.4,59,35,28,24,7,37,59,62.7,22,28,4,24,18,77,61,2,Matches,Osasuna,La-Liga
924,Bryan Zaragoza,es ESP,"FW,MF",24-010,16.9,13,9,8,4,1,6,20,30.0,14,9,0,9,1,14,8,0,Matches,Osasuna,La-Liga
925,Jorge Herrando,es ESP,DF,24-066,15.2,17,11,9,5,3,9,15,60.0,6,20,14,6,12,29,65,2,Matches,Osasuna,La-Liga
926,Juan Cruz Armada,es ESP,DF,32-281,13.0,20,10,9,10,1,11,19,57.9,8,14,4,10,8,28,44,0,Matches,Osasuna,La-Liga
927,Pablo Ibáñez,es ESP,MF,26-227,11.4,18,9,6,11,1,9,37,24.3,28,18,6,12,14,32,19,0,Matches,Osasuna,La-Liga
928,Moi Gómez,es ESP,"MF,FW",30-316,8.8,13,9,4,7,2,4,8,50.0,4,5,2,3,5,18,7,1,Matches,Osasuna,La-Liga
929,Rubén Peña,es ESP,"FW,DF",33-291,7.6,9,3,3,2,4,3,18,16.7,15,10,0,10,5,14,11,0,Matches,Osasuna,La-Liga
930,Raúl,es ESP,"FW,MF",24-183,7.7,11,6,3,5,3,4,9,44.4,5,4,0,4,0,11,5,0,Matches,Osasuna,La-Liga
931,Iker Muñoz,es ESP,MF,22-181,5.6,5,2,3,2,0,3,8,37.5,5,7,1,6,4,9,10,1,Matches,Osasuna,La-Liga
932,Kike Barja,es ESP,"FW,MF",28-034,2.9,5,4,1,3,1,2,3,66.7,1,5,0,5,3,8,4,0,Matches,Osasuna,La-Liga
933,Nacho Vidal,es ESP,DF,30-101,1.4,2,0,0,1,1,1,4,25.0,3,1,0,1,0,2,6,0,Matches,Osasuna,La-Liga
934,José Arnaiz,es ESP,"MF,FW",30-020,1.4,6,4,3,2,1,4,7,57.1,3,2,0,2,3,9,1,0,Matches,Osasuna,La-Liga
935,Aitor Fernández,es ESP,GK,34-002,1.0,0,0,0,0,0,0,0,,0,0,0,0,0,0,2,0,Matches,Osasuna,La-Liga
936,Unai García,es ESP,DF,33-091,0.7,0,0,0,0,0,0,0,,0,1,0,1,0,0,1,0,Matches,Osasuna,La-Liga
937,Iker Benito,es ESP,"FW,MF",22-268,0.4,0,0,0,0,0,0,1,0.0,1,0,0,0,1,1,2,0,Matches,Osasuna,La-Liga
938,Javi Martínez,es ESP,MF,25-134,0.1,0,0,0,0,0,0,0,,0,0,0,0,0,0,0,0,Matches,Osasuna,La-Liga
939,Florian Lejeune,fr FRA,DF,33-350,32.9,43,26,28,13,2,21,39,53.8,18,35,29,6,30,73,162,1,Matches,Rayo-Vallecano,La-Liga
940,Andrei Ratiu,ro ROU,DF,26-319,30.2,65,37,40,17,8,39,64,60.9,25,36,3,33,26,91,68,2,Matches,Rayo-Vallecano,La-Liga
941,Augusto Batalla,ar ARG,GK,29-005,28.0,4,2,4,0,0,4,6,66.7,2,0,0,0,0,4,11,4,Matches,Rayo-Vallecano,La-Liga
942,Jorge de Frutos,es ESP,"FW,MF",28-074,24.7,35,19,15,13,7,12,40,30.0,28,20,0,20,17,52,20,1,Matches,Rayo-Vallecano,La-Liga
943,Pep Chavarría,es ESP,"DF,FW",27-025,25.4,39,30,25,13,1,24,38,63.2,14,31,8,23,26,65,98,1,Matches,Rayo-Vallecano,La-Liga
944,Álvaro García,es ESP,"FW,MF",32-190,25.2,31,22,19,8,4,12,28,42.9,16,30,0,30,30,61,39,1,Matches,Rayo-Vallecano,La-Liga
945,Abdul Mumin,gh GHA,DF,26-333,22.4,37,25,30,7,0,17,27,63.0,10,40,29,11,23,60,125,0,Matches,Rayo-Vallecano,La-Liga
946,Pathé Ciss,sn SEN,"MF,DF",31-050,21.0,45,22,23,21,1,20,40,50.0,20,28,7,21,34,79,57,3,Matches,Rayo-Vallecano,La-Liga
947,Isaac Palazón Camacho,es ESP,"MF,FW",30-129,20.0,22,17,10,6,6,8,31,25.8,23,18,1,17,8,30,12,1,Matches,Rayo-Vallecano,La-Liga
948,Unai López,es ESP,MF,29-187,16.8,24,16,11,8,5,12,28,42.9,16,14,3,11,20,44,19,0,Matches,Rayo-Vallecano,La-Liga
949,Óscar Valentín,es ESP,MF,30-258,18.6,53,40,21,19,13,32,68,47.1,36,33,6,27,21,74,48,2,Matches,Rayo-Vallecano,La-Liga
950,Adri Embarba,es ESP,"FW,MF",32-363,16.5,37,17,14,16,7,16,42,38.1,26,17,1,16,12,49,13,1,Matches,Rayo-Vallecano,La-Liga
951,Randy Nteka,ao ANG,FW,27-150,12.5,16,5,3,9,4,5,12,41.7,7,13,2,11,4,20,20,0,Matches,Rayo-Vallecano,La-Liga
952,Sergio Camello,es ESP,FW,24-084,12.6,9,3,2,5,2,4,6,66.7,2,8,1,7,4,13,16,0,Matches,Rayo-Vallecano,La-Liga
953,Pedro Díaz,es ESP,MF,26-334,11.5,21,13,6,13,2,12,35,34.3,23,13,0,13,6,27,6,1,Matches,Rayo-Vallecano,La-Liga
954,Iván Balliu,al ALB,DF,33-124,10.0,12,9,4,5,3,4,12,33.3,8,13,3,10,10,22,30,0,Matches,Rayo-Vallecano,La-Liga
955,Aridane Hernández,es ESP,DF,36-043,8.4,9,7,5,4,0,2,4,50.0,2,7,5,2,3,12,69,2,Matches,Rayo-Vallecano,La-Liga
956,Alfonso Espino,uy URU,DF,33-120,8.2,37,20,29,6,2,23,42,54.8,19,14,6,8,10,47,28,1,Matches,Rayo-Vallecano,La-Liga
957,Gerard Gumbau,es ESP,MF,30-138,8.6,16,12,8,6,2,7,15,46.7,8,10,4,6,5,21,11,0,Matches,Rayo-Vallecano,La-Liga
958,Cárdenas,es ESP,GK,28-038,6.0,0,0,0,0,0,0,0,,0,0,0,0,0,0,3,0,Matches,Rayo-Vallecano,La-Liga
959,Óscar Trejo,ar ARG,MF,37-009,5.4,7,5,1,4,2,3,9,33.3,6,8,0,8,4,11,5,0,Matches,Rayo-Vallecano,La-Liga
960,Sergi Guardiola,es ESP,FW,33-341,4.0,5,3,0,5,0,2,3,66.7,1,1,0,1,1,6,2,0,Matches,Rayo-Vallecano,La-Liga
961,James Rodríguez,co COL,"MF,FW",33-297,1.6,3,2,1,2,0,0,2,0.0,2,2,0,2,1,4,0,0,Matches,Rayo-Vallecano,La-Liga
962,Pelayo Fernandez,es ESP,DF,22-006,1.0,0,0,0,0,0,0,0,,0,0,0,0,1,1,8,0,Matches,Rayo-Vallecano,La-Liga
963,Etienne Eto'o,cm CMR,FW,22-260,0.4,0,0,0,0,0,0,1,0.0,1,0,0,0,0,0,1,0,Matches,Rayo-Vallecano,La-Liga
964,Raúl de Tomás,es ESP,"DF,FW",30-200,0.2,2,2,1,0,1,0,0,,0,0,0,0,0,2,0,0,Matches,Rayo-Vallecano,La-Liga
965,Federico Valverde,uy URU,"MF,DF",26-287,29.7,42,26,17,20,5,24,35,68.6,11,35,6,29,51,93,48,1,Matches,Real-Madrid,La-Liga
966,Kylian Mbappé,fr FRA,FW,26-136,28.3,8,5,1,3,4,1,5,20.0,4,3,0,3,1,9,1,0,Matches,Real-Madrid,La-Liga
967,Thibaut Courtois,be BEL,GK,32-359,28.0,0,0,0,0,0,0,0,,0,0,0,0,1,1,13,1,Matches,Real-Madrid,La-Liga
968,Aurélien Tchouaméni,fr FRA,"DF,MF",25-098,27.3,41,20,21,18,2,19,38,50.0,19,31,22,9,43,84,80,1,Matches,Real-Madrid,La-Liga
969,Antonio Rüdiger,de GER,DF,32-063,25.5,20,13,14,6,0,11,15,73.3,4,22,14,8,9,29,96,1,Matches,Real-Madrid,La-Liga
970,Jude Bellingham,eng ENG,MF,21-310,24.6,55,31,16,25,14,26,39,66.7,13,32,2,30,25,80,19,1,Matches,Real-Madrid,La-Liga
971,Vinicius Júnior,br BRA,FW,24-297,23.7,20,10,7,4,9,4,17,23.5,13,6,0,6,3,23,1,2,Matches,Real-Madrid,La-Liga
972,Lucas Vázquez,es ESP,DF,33-308,22.4,51,32,30,14,7,25,46,54.3,21,22,5,17,17,68,31,0,Matches,Real-Madrid,La-Liga
973,Rodrygo,br BRA,"FW,MF",24-116,21.4,21,14,14,5,2,7,23,30.4,16,18,1,17,11,32,9,0,Matches,Real-Madrid,La-Liga
974,Fran Garcia,es ESP,DF,25-264,20.3,38,26,22,12,4,19,33,57.6,14,22,4,18,23,61,62,1,Matches,Real-Madrid,La-Liga
975,Raúl Asencio,es ESP,DF,22-081,15.9,19,13,16,3,0,9,12,75.0,3,6,4,2,12,31,77,2,Matches,Real-Madrid,La-Liga
976,Brahim Díaz,ma MAR,"FW,MF",25-275,14.3,24,18,9,12,3,7,18,38.9,11,16,1,15,4,28,1,1,Matches,Real-Madrid,La-Liga
977,Luka Modrić,hr CRO,MF,39-238,16.8,28,18,16,11,1,14,31,45.2,17,14,5,9,23,51,16,0,Matches,Real-Madrid,La-Liga
978,Ferland Mendy,fr FRA,DF,29-331,11.2,17,14,7,6,4,9,12,75.0,3,11,4,7,9,26,8,1,Matches,Real-Madrid,La-Liga
979,Dani Ceballos,es ESP,MF,28-271,10.8,35,19,15,15,5,16,27,59.3,11,15,3,12,13,48,9,1,Matches,Real-Madrid,La-Liga
980,Eduardo Camavinga,fr FRA,"MF,DF",22-176,12.2,42,26,23,16,3,19,33,57.6,14,24,8,16,18,60,23,0,Matches,Real-Madrid,La-Liga
981,Éder Militão,br BRA,DF,27-107,10.4,19,17,14,5,0,7,12,58.3,5,13,8,5,12,31,35,0,Matches,Real-Madrid,La-Liga
982,Arda Güler,tr TUR,"MF,FW",20-069,10.5,22,11,8,6,8,7,18,38.9,11,14,0,14,5,27,8,0,Matches,Real-Madrid,La-Liga
983,Dani Carvajal,es ESP,DF,33-114,6.8,12,8,7,3,2,9,12,75.0,3,8,3,5,10,22,19,1,Matches,Real-Madrid,La-Liga
984,Andriy Lunin,ua UKR,GK,26-083,5.0,0,0,0,0,0,0,0,,0,0,0,0,0,0,2,0,Matches,Real-Madrid,La-Liga
985,David Alaba,at AUT,DF,32-315,3.5,1,0,1,0,0,0,0,,0,5,5,0,6,7,7,0,Matches,Real-Madrid,La-Liga
986,Endrick,br BRA,FW,18-288,2.5,1,1,1,0,0,1,3,33.3,2,0,0,0,3,4,1,0,Matches,Real-Madrid,La-Liga
987,Fran,es ESP,GK,19-315,1.0,0,0,0,0,0,0,0,,0,0,0,0,0,0,2,0,Matches,Real-Madrid,La-Liga
988,Jacobo Ramón,es ESP,DF,20-119,0.3,2,1,2,0,0,1,1,100.0,0,0,0,0,0,2,0,0,Matches,Real-Madrid,La-Liga
989,Jesús Vallejo,es ESP,DF,28-120,0.1,0,0,0,0,0,0,0,,0,0,0,0,0,0,2,0,Matches,Real-Madrid,La-Liga
990,Chema,es ESP,MF,20-010,0.1,0,0,0,0,0,0,0,,0,0,0,0,0,0,1,0,Matches,Real-Madrid,La-Liga
991,Lorenzo Aguado,es ESP,DF,22-228,0.1,0,0,0,0,0,0,0,,0,0,0,0,0,0,2,0,Matches,Real-Madrid,La-Liga
992,Daniel Yáñez,es ESP,FW,18-038,0.0,0,0,0,0,0,0,0,,0,0,0,0,0,0,0,0,Matches,Real-Madrid,La-Liga
993,Álex Remiro,es ESP,GK,30-042,33.0,1,0,1,0,0,1,2,50.0,1,0,0,0,0,1,17,4,Matches,Real-Sociedad,La-Liga
994,Martín Zubimendi,es ESP,MF,26-092,29.9,70,37,30,29,11,28,44,63.6,16,39,16,23,39,109,74,3,Matches,Real-Sociedad,La-Liga
995,Sergio Gómez,es ESP,"MF,DF",24-243,28.2,68,38,27,29,12,28,53,52.8,25,40,2,38,17,85,28,2,Matches,Real-Sociedad,La-Liga
996,Jon Aramburu,ve VEN,DF,22-286,24.7,91,65,52,29,10,60,91,65.9,31,35,8,27,28,119,92,0,Matches,Real-Sociedad,La-Liga
997,Igor Zubeldia,es ESP,DF,28-036,22.7,32,21,21,9,2,14,25,56.0,11,31,18,13,25,57,91,2,Matches,Real-Sociedad,La-Liga
998,Mikel Oyarzabal,es ESP,"FW,MF",28-014,22.3,19,11,7,7,5,9,18,50.0,9,15,1,14,4,23,14,0,Matches,Real-Sociedad,La-Liga
999,Takefusa Kubo,jp JPN,"MF,FW",23-335,22.9,29,18,10,11,8,16,37,43.2,21,32,1,31,13,42,13,1,Matches,Real-Sociedad,La-Liga
1000,Nayef Aguerd,ma MAR,DF,29-036,19.6,30,24,17,12,1,12,18,66.7,6,21,15,6,13,43,91,0,Matches,Real-Sociedad,La-Liga
1001,Javi López,es ESP,DF,23-041,19.5,38,23,22,12,4,21,35,60.0,14,20,7,13,8,46,55,1,Matches,Real-Sociedad,La-Liga
1002,Luka Sučić,hr CRO,MF,22-239,17.8,24,17,7,12,5,9,24,37.5,15,27,2,25,13,37,15,1,Matches,Real-Sociedad,La-Liga
1003,Brais Méndez,es ESP,MF,28-118,15.5,21,13,6,11,4,8,22,36.4,14,13,1,12,7,28,16,1,Matches,Real-Sociedad,La-Liga
1004,Aritz Elustondo,es ESP,DF,31-038,13.2,17,9,12,3,2,9,17,52.9,8,16,12,4,9,26,81,0,Matches,Real-Sociedad,La-Liga
1005,Ander Barrenetxea,es ESP,"MF,FW",23-129,12.3,23,16,7,11,5,5,20,25.0,15,15,0,15,10,33,15,1,Matches,Real-Sociedad,La-Liga
1006,Sheraldo Becker,sr SUR,"FW,MF",30-085,11.1,3,2,0,3,0,0,2,0.0,2,4,0,4,1,4,10,0,Matches,Real-Sociedad,La-Liga
1007,Aihen Muñoz,es ESP,DF,27-262,10.3,23,12,13,8,2,13,27,48.1,14,10,6,4,13,36,45,0,Matches,Real-Sociedad,La-Liga
1008,Pablo Marín,es ESP,MF,21-306,10.6,21,14,5,11,5,7,15,46.7,8,12,3,9,4,25,13,0,Matches,Real-Sociedad,La-Liga
1009,Beñat Turrientes,es ESP,MF,23-094,9.1,13,5,4,8,1,4,13,30.8,9,14,2,12,5,18,12,0,Matches,Real-Sociedad,La-Liga
1010,Orri Steinn Óskarsson,is ISL,FW,20-249,10.5,6,6,2,1,3,2,8,25.0,6,10,1,9,2,8,11,0,Matches,Real-Sociedad,La-Liga
1011,Jon Pacheco,es ESP,DF,24-117,8.5,13,9,10,3,0,8,10,80.0,2,8,6,2,8,21,45,2,Matches,Real-Sociedad,La-Liga
1012,Olasagasti,es ESP,MF,24-262,8.8,19,9,5,9,5,7,17,41.2,10,8,2,6,13,32,10,0,Matches,Real-Sociedad,La-Liga
1013,Hamari Traoré,ml MLI,DF,33-098,6.4,18,11,9,7,2,14,19,73.7,5,4,1,3,8,26,18,0,Matches,Real-Sociedad,La-Liga
1014,Jon Martin,es ESP,DF,19-124,8.0,9,7,6,2,1,6,9,66.7,3,11,7,4,7,16,56,0,Matches,Real-Sociedad,La-Liga
1015,Umar Sadiq,ng NGA,FW,28-092,2.5,2,1,1,1,0,1,2,50.0,1,3,1,2,1,3,2,0,Matches,Real-Sociedad,La-Liga
1016,Unai Marrero,es ESP,GK,23-208,1.0,0,0,0,0,0,0,0,,0,0,0,0,0,0,1,0,Matches,Real-Sociedad,La-Liga
1017,Arsen Zakharyan,ru RUS,"MF,FW",21-344,0.8,1,1,1,0,0,1,1,100.0,0,1,1,0,1,2,0,0,Matches,Real-Sociedad,La-Liga
1018,Urko González,es ESP,MF,24-046,0.5,0,0,0,0,0,0,0,,0,1,1,0,0,0,0,0,Matches,Real-Sociedad,La-Liga
1019,Arkaitz Mariezkurrena,es ESP,"MF,FW",20-030,1.2,1,0,1,0,0,0,3,0.0,3,1,0,1,1,2,3,0,Matches,Real-Sociedad,La-Liga
1020,Álvaro Odriozola,es ESP,DF,29-142,0.5,1,1,1,0,0,0,0,,0,0,0,0,0,1,1,0,Matches,Real-Sociedad,La-Liga
1021,Daniel Díaz,es ESP,MF,18-317,0.1,1,1,1,0,0,0,0,,0,1,0,1,0,1,0,0,Matches,Real-Sociedad,La-Liga
1022,Luken Beitia,es ESP,DF,20-309,0.1,1,1,1,0,0,1,1,100.0,0,0,0,0,0,1,2,0,Matches,Real-Sociedad,La-Liga
1023,Jon Magunazelaia,es ESP,MF,24-296,0.1,1,1,1,0,0,0,0,,0,0,0,0,0,1,0,0,Matches,Real-Sociedad,La-Liga
1024,Dodi Lukebakio,be BEL,FW,27-223,31.4,21,13,8,8,5,14,26,53.8,12,16,0,16,5,26,16,2,Matches,Sevilla,La-Liga
1025,Carmona,es ESP,DF,23-096,30.0,77,55,48,21,8,37,70,52.9,33,32,10,22,63,140,88,3,Matches,Sevilla,La-Liga
1026,Loïc Bade,fr FRA,DF,25-024,28.2,43,25,33,10,0,21,29,72.4,8,19,11,8,28,71,153,2,Matches,Sevilla,La-Liga
1027,Ørjan Nyland,no NOR,GK,34-237,26.7,3,2,3,0,0,3,5,60.0,2,0,0,0,0,3,11,4,Matches,Sevilla,La-Liga
1028,Isaac Romero,es ESP,FW,24-352,23.4,12,6,3,4,5,2,15,13.3,13,18,1,17,7,19,26,0,Matches,Sevilla,La-Liga
1029,Adrià Pedrosa,es ESP,DF,26-357,23.5,55,32,33,16,6,30,52,57.7,22,40,9,31,20,75,81,0,Matches,Sevilla,La-Liga
1030,Nemanja Gudelj,rs SRB,"MF,DF",33-170,24.3,37,20,12,21,4,18,29,62.1,11,26,10,16,25,62,82,0,Matches,Sevilla,La-Liga
1031,Kike Salas,es ESP,DF,23-012,21.4,42,25,21,15,6,23,38,60.5,15,22,12,10,30,72,130,0,Matches,Sevilla,La-Liga
1032,Djibril Sow,ch SUI,MF,28-088,20.7,21,12,11,9,1,7,16,43.8,9,15,2,13,22,43,25,1,Matches,Sevilla,La-Liga
1033,Lucien Agoume,fr FRA,MF,23-085,19.5,56,24,17,31,8,20,28,71.4,8,25,9,16,31,87,35,0,Matches,Sevilla,La-Liga
1034,Saúl Ñíguez,es ESP,MF,30-165,16.2,44,30,15,22,7,11,29,37.9,18,25,2,23,19,63,32,0,Matches,Sevilla,La-Liga
1035,Albert Sambi Lokonga,be BEL,MF,25-195,15.6,21,15,10,9,2,10,13,76.9,3,12,1,11,9,30,24,3,Matches,Sevilla,La-Liga
1036,Juanlu Sánchez,es ESP,"MF,DF",21-263,15.5,36,26,21,12,3,25,41,61.0,16,17,0,17,12,48,15,0,Matches,Sevilla,La-Liga
1037,Peque,es ESP,"MF,FW",22-213,11.4,15,5,4,9,2,6,15,40.0,9,16,0,16,7,22,5,0,Matches,Sevilla,La-Liga
1038,Chidera Ejuke,ng NGA,FW,27-123,10.6,19,13,8,9,2,9,20,45.0,11,12,0,12,5,24,8,0,Matches,Sevilla,La-Liga
1039,Ruben Vargas,ch SUI,"FW,MF",26-273,7.5,7,4,1,5,1,3,8,37.5,5,9,0,9,3,10,10,0,Matches,Sevilla,La-Liga
1040,Álvaro Fernández,es ESP,GK,27-022,7.3,0,0,0,0,0,0,1,0.0,1,0,0,0,0,0,7,0,Matches,Sevilla,La-Liga
1041,Tanguy Nianzou,fr FRA,DF,22-332,5.8,7,5,6,0,1,5,6,83.3,1,1,0,1,8,15,27,0,Matches,Sevilla,La-Liga
1042,Marcão,br BRA,DF,28-334,5.1,9,6,6,3,0,2,3,66.7,1,9,6,3,6,15,27,1,Matches,Sevilla,La-Liga
1043,Kelechi Iheanacho,ng NGA,FW,28-214,4.4,1,0,0,1,0,1,3,33.3,2,0,0,0,0,1,1,0,Matches,Sevilla,La-Liga
1044,Jesús Navas,es ESP,"FW,MF",39-165,4.7,5,2,3,0,2,0,3,0.0,3,1,0,1,4,9,6,0,Matches,Sevilla,La-Liga
1045,Valentín Barco,ar ARG,"DF,FW",20-286,3.2,15,9,8,3,4,12,15,80.0,3,0,0,0,2,17,5,0,Matches,Sevilla,La-Liga
1046,Stanis Idumbo,be BEL,"FW,MF",19-310,3.2,9,5,3,4,2,3,5,60.0,2,3,1,2,4,13,2,0,Matches,Sevilla,La-Liga
1047,Lucas Ocampos,ar ARG,FW,30-298,1.9,3,2,2,0,1,1,2,50.0,1,2,0,2,0,3,2,0,Matches,Sevilla,La-Liga
1048,Suso,es ESP,"FW,MF",31-167,3.5,3,1,2,1,0,1,5,20.0,4,3,0,3,2,5,0,0,Matches,Sevilla,La-Liga
1049,Álvaro Pascual,es ESP,FW,23-124,2.2,1,0,0,0,1,1,2,50.0,1,0,0,0,2,3,0,0,Matches,Sevilla,La-Liga
1050,Akor Adams,ng NGA,FW,25-096,1.5,0,0,0,0,0,0,0,,0,1,0,1,0,0,1,0,Matches,Sevilla,La-Liga
1051,Manu Bueno,es ESP,"MF,FW",20-282,1.3,4,3,0,1,3,1,2,50.0,1,0,0,0,0,4,2,0,Matches,Sevilla,La-Liga
1052,Gonzalo Montiel,ar ARG,"DF,MF",28-124,1.3,4,2,3,1,0,3,4,75.0,1,0,0,0,2,6,11,0,Matches,Sevilla,La-Liga
1053,Ramón Martínez,es ESP,DF,22-195,1.1,2,1,1,1,0,0,0,,0,0,0,0,2,4,14,0,Matches,Sevilla,La-Liga
1054,Diego Iturralde,es ESP,FW,22-019,0.4,0,0,0,0,0,0,0,,0,0,0,0,1,1,1,0,Matches,Sevilla,La-Liga
1055,Israel Domínguez,es ESP,FW,21-363,0.2,0,0,0,0,0,0,0,,0,0,0,0,0,0,0,0,Matches,Sevilla,La-Liga
1056,Leandro Antonetti,pr PUR,FW,22-112,0.1,0,0,0,0,0,0,0,,0,0,0,0,0,0,0,0,Matches,Sevilla,La-Liga
1057,Mateo Mejía,es ESP,FW,22-035,0.1,0,0,0,0,0,0,0,,0,0,0,0,0,0,0,0,Matches,Sevilla,La-Liga
1058,Darío Fuentes,es ESP,DF,22-113,0.1,0,0,0,0,0,0,0,,0,0,0,0,0,0,0,0,Matches,Sevilla,La-Liga
1059,Cristhian Mosquera,es ESP,DF,20-312,32.9,43,29,33,9,1,24,33,72.7,9,32,22,10,33,76,113,4,Matches,Valencia,La-Liga
1060,Diego López,es ESP,"MF,FW",22-357,27.7,28,17,9,15,4,16,45,35.6,29,24,0,24,13,41,13,0,Matches,Valencia,La-Liga
1061,Giorgi Mamardashvili,ge GEO,GK,24-218,30.0,2,2,2,0,0,2,3,66.7,1,0,0,0,1,3,13,3,Matches,Valencia,La-Liga
1062,César Tárrega,es ESP,DF,23-068,29.6,44,33,28,13,3,18,28,64.3,10,35,18,17,20,64,205,2,Matches,Valencia,La-Liga
1063,Luis Rioja,es ESP,"MF,FW",31-201,28.6,31,20,13,12,6,13,39,33.3,26,29,1,28,22,53,41,0,Matches,Valencia,La-Liga
1064,Javier Guerra,es ESP,MF,22-124,25.9,45,23,16,18,11,22,47,46.8,25,12,1,11,19,64,40,2,Matches,Valencia,La-Liga
1065,Dimitri Foulquier,fr FRA,DF,32-043,24.9,48,31,29,13,6,24,36,66.7,12,21,5,16,16,64,84,1,Matches,Valencia,La-Liga
1066,Hugo Duro,es ESP,FW,25-176,21.8,12,7,4,7,1,4,11,36.4,7,11,2,9,10,22,10,0,Matches,Valencia,La-Liga
1067,Enzo Barrenechea,ar ARG,MF,23-348,21.2,52,29,21,25,6,30,42,71.4,12,25,7,18,25,77,45,1,Matches,Valencia,La-Liga
1068,Domingos André Ribeiro Almeida,pt POR,"MF,FW",24-340,19.5,44,28,16,19,9,14,34,41.2,20,18,2,16,8,52,14,1,Matches,Valencia,La-Liga
1069,José Luis Gayà,es ESP,DF,29-345,17.3,50,36,34,13,3,39,55,70.9,16,14,2,12,20,70,52,0,Matches,Valencia,La-Liga
1070,José Luis García Vayá,es ESP,MF,26-267,17.4,38,21,20,12,6,16,28,57.1,12,20,6,14,15,53,32,0,Matches,Valencia,La-Liga
1071,Yarek Gasiorowski,es ESP,DF,20-113,10.5,19,16,16,3,0,9,13,69.2,4,17,6,11,26,45,60,0,Matches,Valencia,La-Liga
1072,Jesus Vazquez,es ESP,DF,22-123,9.1,20,16,11,7,2,8,17,47.1,9,15,5,10,7,27,27,0,Matches,Valencia,La-Liga
1073,Thierry Correia,pt POR,DF,26-057,8.5,27,18,19,5,3,13,23,56.5,10,10,1,9,4,31,18,0,Matches,Valencia,La-Liga
1074,Umar Sadiq,ng NGA,FW,28-092,7.5,9,5,2,5,2,4,6,66.7,2,5,0,5,1,10,6,0,Matches,Valencia,La-Liga
1075,Dani Gómez,es ESP,FW,26-279,5.9,3,2,0,0,3,0,0,,0,1,0,1,2,5,4,0,Matches,Valencia,La-Liga
1076,Rafa Mir,es ESP,"FW,MF",27-321,6.6,10,6,6,4,0,2,8,25.0,6,3,0,3,4,14,8,0,Matches,Valencia,La-Liga
1077,Mouctar Diakhaby,gn GUI,DF,28-137,4.1,5,1,5,0,0,3,5,60.0,2,6,5,1,3,8,32,0,Matches,Valencia,La-Liga
1078,Hugo Guillamón,es ESP,MF,25-094,4.0,11,8,1,9,1,9,10,90.0,1,4,1,3,5,16,9,1,Matches,Valencia,La-Liga
1079,Stole Dimitrievski,mk MKD,GK,31-131,4.0,0,0,0,0,0,0,0,,0,0,0,0,0,0,3,1,Matches,Valencia,La-Liga
1080,Francisco Perez,es ESP,"MF,FW",22-238,5.1,12,11,5,6,1,9,15,60.0,6,8,1,7,3,15,6,0,Matches,Valencia,La-Liga
1081,Sergi Canós,es ESP,"MF,FW",28-092,4.0,11,7,3,4,4,4,10,40.0,6,5,1,4,5,16,4,0,Matches,Valencia,La-Liga
1082,Ivan Jaime Pajuelo,es ESP,MF,24-221,2.1,4,2,1,1,2,2,3,66.7,1,1,0,1,2,6,0,0,Matches,Valencia,La-Liga
1083,Germán Valera,es ESP,MF,23-050,1.6,1,1,1,0,0,0,1,0.0,1,2,0,2,4,5,2,1,Matches,Valencia,La-Liga
1084,Max Aarons,eng ENG,"DF,MF",25-121,1.2,3,3,2,1,0,3,3,100.0,0,1,0,1,0,3,3,0,Matches,Valencia,La-Liga
1085,Maximiliano Caufriez,be BEL,DF,28-078,1.0,1,1,1,0,0,1,1,100.0,0,2,1,1,1,2,4,0,Matches,Valencia,La-Liga
1086,Rodrigo Abajas,es ESP,DF,21-358,0.7,3,2,2,1,0,3,3,100.0,0,1,0,1,1,4,0,0,Matches,Valencia,La-Liga
1087,Martín Tejón,es ESP,"MF,DF",21-023,0.5,2,0,0,2,0,1,2,50.0,1,0,0,0,0,2,0,0,Matches,Valencia,La-Liga
1088,Iker Córdoba,es ESP,DF,19-175,0.2,0,0,0,0,0,0,0,,0,0,0,0,0,0,1,0,Matches,Valencia,La-Liga
1089,David Otorbi,es ESP,MF,17-201,0.2,0,0,0,0,0,0,0,,0,1,0,1,0,0,0,0,Matches,Valencia,La-Liga
1090,Alberto Marí,es ESP,FW,23-298,0.1,0,0,0,0,0,0,0,,0,0,0,0,0,0,0,0,Matches,Valencia,La-Liga
1091,Karl Jakob Hein,ee EST,GK,23-022,28.0,0,0,0,0,0,0,2,0.0,2,0,0,0,0,0,17,1,Matches,Valladolid,La-Liga
1092,Luis Pérez,es ESP,DF,30-090,26.9,38,27,23,10,5,24,40,60.0,16,26,9,17,28,66,76,0,Matches,Valladolid,La-Liga
1093,Javi Sánchez,es ESP,DF,28-052,22.5,26,16,19,6,1,17,26,65.4,9,39,28,11,22,48,111,3,Matches,Valladolid,La-Liga
1094,Raúl Moro,es ESP,"MF,FW",22-151,22.2,18,11,13,2,3,10,26,38.5,16,6,0,6,10,28,14,0,Matches,Valladolid,La-Liga
1095,Lucas Oliveira Rosa,br BRA,DF,25-032,21.0,53,33,40,11,2,35,51,68.6,16,24,9,15,28,81,69,2,Matches,Valladolid,La-Liga
1096,Stanko Jurić,hr CRO,MF,28-262,19.2,48,24,26,19,3,19,48,39.6,29,35,11,24,24,72,52,0,Matches,Valladolid,La-Liga
1097,Mario Martín,es ESP,MF,21-061,17.9,59,30,29,27,3,20,45,44.4,25,28,6,22,19,78,39,7,Matches,Valladolid,La-Liga
1098,Eray Cömert,ch SUI,"DF,MF",27-090,16.9,21,12,13,8,0,11,18,61.1,7,25,15,10,21,42,60,1,Matches,Valladolid,La-Liga
1099,Anuar,ma MAR,"MF,FW",30-110,16.6,34,23,20,9,5,13,26,50.0,13,22,7,15,15,49,19,1,Matches,Valladolid,La-Liga
1100,Mamadou Sylla,sn SEN,"FW,MF",31-046,16.5,6,3,2,2,2,2,8,25.0,6,6,0,6,3,9,12,1,Matches,Valladolid,La-Liga
1101,Selim Amallah,ma MAR,MF,28-171,14.0,27,15,9,17,1,9,17,52.9,8,20,1,19,14,41,4,1,Matches,Valladolid,La-Liga
1102,David Torres,es ESP,DF,22-061,15.4,13,8,12,1,0,7,11,63.6,4,19,17,2,10,23,74,0,Matches,Valladolid,La-Liga
1103,Kike Pérez,es ESP,MF,28-080,13.2,37,26,15,19,3,15,26,57.7,11,16,4,12,7,44,18,0,Matches,Valladolid,La-Liga
1104,Marcos André,br BRA,FW,28-197,13.1,10,6,3,5,2,5,13,38.5,8,18,2,16,3,13,10,0,Matches,Valladolid,La-Liga
1105,Iván Sánchez,es ESP,"MF,FW",32-224,14.0,34,19,17,9,8,11,26,42.3,15,18,3,15,13,47,10,0,Matches,Valladolid,La-Liga
1106,Juanmi Latasa,es ESP,FW,24-043,12.0,3,1,1,1,1,2,5,40.0,3,3,1,2,0,3,10,1,Matches,Valladolid,La-Liga
1107,Juma Bah,sl SLE,DF,19-024,9.6,10,7,7,3,0,3,5,60.0,2,15,8,7,12,22,60,0,Matches,Valladolid,La-Liga
1108,Antonio Candela,it ITA,DF,25-008,8.0,8,6,5,2,1,3,7,42.9,4,9,5,4,6,14,20,0,Matches,Valladolid,La-Liga
1109,Adam Aznou,ma MAR,DF,18-337,7.5,24,19,18,6,0,19,36,52.8,17,21,7,14,7,31,17,0,Matches,Valladolid,La-Liga
1110,Chuky san jose,es ESP,MF,21-006,7.2,8,2,3,3,2,2,9,22.2,7,4,1,3,0,8,2,0,Matches,Valladolid,La-Liga
1111,Darwin Machís,ve VEN,"MF,FW",32-087,6.9,5,4,3,2,0,3,9,33.3,6,3,0,3,5,10,13,0,Matches,Valladolid,La-Liga
1112,Tamás Nikitscher,hu HUN,MF,25-183,6.3,14,6,8,6,0,7,10,70.0,3,10,2,8,9,23,9,0,Matches,Valladolid,La-Liga
1113,Florian Grillitsch,at AUT,MF,29-271,5.3,8,6,5,3,0,5,13,38.5,8,10,1,9,4,12,5,1,Matches,Valladolid,La-Liga
1114,Joseph Aidoo,gh GHA,DF,29-218,6.0,5,5,3,2,0,2,3,66.7,1,6,3,3,4,9,22,1,Matches,Valladolid,La-Liga
1115,André Ferreira,pt POR,GK,28-341,5.0,0,0,0,0,0,0,0,,0,0,0,0,0,0,4,2,Matches,Valladolid,La-Liga
1116,Cenk Özkacar,tr TUR,DF,24-211,4.9,5,3,4,1,0,2,6,33.3,4,6,4,2,11,16,39,1,Matches,Valladolid,La-Liga
1117,Amath,sn SEN,"FW,DF",28-293,3.9,2,0,2,0,0,1,7,14.3,6,7,1,6,2,4,6,0,Matches,Valladolid,La-Liga
1118,Enzo Boyomo,cm CMR,DF,23-210,3.0,6,2,4,2,0,3,3,100.0,0,4,3,1,1,7,7,0,Matches,Valladolid,La-Liga
1119,Víctor Meseguer,es ESP,MF,25-330,4.6,10,6,4,4,2,2,10,20.0,8,3,0,3,2,12,4,1,Matches,Valladolid,La-Liga
1120,Henrique,br BRA,DF,31-010,2.2,3,2,2,1,0,0,3,0.0,3,5,0,5,2,5,5,0,Matches,Valladolid,La-Liga
1121,Raúl Chasco,es ESP,DF,21-234,1.4,4,1,3,1,0,2,4,50.0,2,1,0,1,2,6,2,0,Matches,Valladolid,La-Liga
1122,Arnau Rafús,es ESP,GK,22-008,1.0,0,0,0,0,0,0,0,,0,0,0,0,0,0,0,1,Matches,Valladolid,La-Liga
1123,Mario Maroto,es ESP,MF,21-158,0.2,0,0,0,0,0,0,1,0.0,1,0,0,0,2,2,1,0,Matches,Valladolid,La-Liga
1124,Adrian Baquerin,es ESP,FW,18-062,0.1,0,0,0,0,0,0,0,,0,0,0,0,0,0,1,0,Matches,Valladolid,La-Liga
1125,Kenedy,br BRA,"MF,FW",29-086,0.1,0,0,0,0,0,0,0,,0,1,0,1,0,0,0,0,Matches,Valladolid,La-Liga
1126,Sergi Cardona,es ESP,DF,25-301,30.7,66,44,40,19,7,45,73,61.6,28,48,7,41,33,99,114,1,Matches,Villarreal,La-Liga
1127,Santi Comesaña,es ESP,MF,28-212,26.1,83,47,42,32,9,40,70,57.1,30,49,17,32,17,100,47,1,Matches,Villarreal,La-Liga
1128,Kiko Femenía,es ESP,DF,34-092,24.7,50,34,34,14,2,33,57,57.9,24,21,10,11,40,90,62,3,Matches,Villarreal,La-Liga
1129,Alex Baena,es ESP,MF,23-289,25.2,26,14,6,13,7,9,33,27.3,24,28,2,26,21,47,19,2,Matches,Villarreal,La-Liga
1130,Logan Costa,cv CPV,DF,24-034,24.7,35,19,22,12,1,22,25,88.0,3,20,11,9,17,52,100,1,Matches,Villarreal,La-Liga
1131,Thierno Barry,fr FRA,FW,22-196,24.3,11,8,2,5,4,4,10,40.0,6,15,2,13,0,11,18,0,Matches,Villarreal,La-Liga
1132,Daniel Parejo,es ESP,MF,36-019,23.2,48,37,24,19,5,26,48,54.2,22,21,6,15,22,70,33,1,Matches,Villarreal,La-Liga
1133,Pape Gueye,sn SEN,MF,26-101,22.0,52,25,21,23,8,19,26,73.1,7,28,10,18,24,76,48,1,Matches,Villarreal,La-Liga
1134,Diego Conde,es ESP,GK,26-189,20.8,2,2,2,0,0,2,4,50.0,2,0,0,0,1,3,9,2,Matches,Villarreal,La-Liga
1135,Yeremi Pino,es ESP,MF,22-197,18.5,52,27,16,28,8,27,54,50.0,27,35,3,32,8,60,16,0,Matches,Villarreal,La-Liga
1136,Ayoze Pérez,es ESP,FW,31-280,19.6,23,12,5,15,3,6,22,27.3,16,16,0,16,7,30,13,0,Matches,Villarreal,La-Liga
1137,Juan Foyth,ar ARG,DF,27-113,13.9,23,14,14,5,4,10,15,66.7,5,22,13,9,17,40,97,3,Matches,Villarreal,La-Liga
1138,Raúl Albiol,es ESP,DF,39-243,13.2,10,9,9,1,0,6,10,60.0,4,10,9,1,6,16,69,1,Matches,Villarreal,La-Liga
1139,Luiz Lúcio Reis Júnior,br BRA,GK,24-111,13.2,0,0,0,0,0,0,0,,0,0,0,0,0,0,14,1,Matches,Villarreal,La-Liga
1140,Nicolas Pépé,ci CIV,"FW,MF",29-341,13.6,18,8,8,6,4,5,12,41.7,7,10,1,9,5,23,10,0,Matches,Villarreal,La-Liga
1141,Willy Kambwala,fr FRA,DF,20-253,10.4,13,8,10,2,1,6,7,85.7,1,7,5,2,8,21,44,1,Matches,Villarreal,La-Liga
1142,Eric Bailly,ci CIV,DF,31-023,6.9,12,4,6,6,0,3,4,75.0,1,12,6,6,6,18,29,0,Matches,Villarreal,La-Liga
1143,Ilias Akhomach,ma MAR,"MF,FW",21-019,6.5,12,7,4,4,4,6,12,50.0,6,8,0,8,3,15,13,0,Matches,Villarreal,La-Liga
1144,Gerard Moreno,es ESP,FW,33-028,7.2,7,4,3,2,2,3,11,27.3,8,0,0,0,2,9,6,0,Matches,Villarreal,La-Liga
1145,Denis Suárez,es ESP,MF,31-119,5.9,9,7,7,1,1,4,9,44.4,5,4,1,3,1,10,3,0,Matches,Villarreal,La-Liga
1146,Pau Navarro,es ESP,DF,20-010,7.2,19,14,11,6,2,16,28,57.1,12,11,5,6,3,22,30,0,Matches,Villarreal,La-Liga
1147,Tajon Buchanan,ca CAN,MF,26-086,3.3,7,4,5,2,0,5,8,62.5,3,4,0,4,1,8,1,0,Matches,Villarreal,La-Liga
1148,Arnaut Danjuma,nl NED,FW,28-094,2.2,2,1,0,1,1,0,1,0.0,1,1,0,1,0,2,0,0,Matches,Villarreal,La-Liga
1149,Alfonso Pedraza,es ESP,"DF,MF",29-026,3.1,3,2,2,0,1,2,4,50.0,2,2,1,1,4,7,9,0,Matches,Villarreal,La-Liga
1150,Juan Bernat,es ESP,"DF,MF",32-065,2.4,9,7,7,1,1,4,5,80.0,1,3,1,2,1,10,4,0,Matches,Villarreal,La-Liga
1151,Ramón Terrats,es ESP,"MF,FW",24-199,1.5,3,3,1,2,0,2,4,50.0,2,3,1,2,2,5,3,0,Matches,Villarreal,La-Liga
1152,Pau Cabanes,es ESP,"MF,FW",20-077,1.8,4,4,0,3,1,3,4,75.0,1,5,0,5,3,7,2,1,Matches,Villarreal,La-Liga
1153,Arnau Solà,es ESP,MF,22-031,0.1,0,0,0,0,0,0,2,0.0,2,1,1,0,0,0,0,0,Matches,Villarreal,La-Liga
1154,Thiago Ojeda,ar ARG,MF,22-113,0.1,0,0,0,0,0,0,0,,0,0,0,0,0,0,1,0,Matches,Villarreal,La-Liga
1155,Karl Etta,cm CMR,MF,21-203,0.0,0,0,0,0,0,0,0,,0,0,0,0,0,0,0,0,Matches,Villarreal,La-Liga
1156,Marco Carnesecchi,it ITA,GK,24-308,32.0,0,0,0,0,0,0,0,,0,1,0,1,0,0,23,2,Matches,Atalanta,Serie-A
1157,Marten de Roon,nl NED,"MF,DF",34-037,32.0,68,42,29,36,3,24,59,40.7,35,36,7,29,44,112,58,1,Matches,Atalanta,Serie-A
1158,Éderson,br BRA,MF,25-302,30.5,50,30,18,27,5,21,31,67.7,10,29,6,23,35,85,34,1,Matches,Atalanta,Serie-A
1159,Berat Djimsiti,al ALB,DF,32-075,27.3,49,30,26,22,1,28,38,73.7,10,31,18,13,36,85,113,2,Matches,Atalanta,Serie-A
1160,Mateo Retegui,it ITA,FW,26-006,23.5,14,9,0,9,5,3,15,20.0,12,6,0,6,2,16,15,0,Matches,Atalanta,Serie-A
1161,Ademola Lookman,ng NGA,"MF,FW",27-197,23.5,31,14,9,14,8,10,18,55.6,8,18,0,18,2,33,5,1,Matches,Atalanta,Serie-A
1162,Isak Hien,se SWE,DF,26-112,24.9,48,28,27,21,0,27,43,62.8,16,30,17,13,29,77,79,2,Matches,Atalanta,Serie-A
1163,Raoul Bellanova,it ITA,DF,24-353,24.6,23,13,8,12,3,12,20,60.0,8,12,3,9,18,41,42,0,Matches,Atalanta,Serie-A
1164,Davide Zappacosta,it ITA,DF,32-328,21.8,26,16,15,5,6,20,39,51.3,19,27,6,21,11,37,29,2,Matches,Atalanta,Serie-A
1165,Sead Kolašinac,ba BIH,DF,31-319,21.1,41,26,21,20,0,16,30,53.3,14,16,7,9,25,66,53,1,Matches,Atalanta,Serie-A
1166,Charles De Ketelaere,be BEL,"MF,FW",24-056,21.1,12,8,2,8,2,4,13,30.8,9,12,3,9,3,15,8,0,Matches,Atalanta,Serie-A
1167,Mario Pašalić,hr CRO,MF,30-085,20.6,24,15,10,12,2,11,25,44.0,14,19,4,15,12,36,26,1,Matches,Atalanta,Serie-A
1168,Matteo Ruggeri,it ITA,DF,22-298,17.7,38,23,15,13,10,25,35,71.4,10,27,3,24,16,54,39,1,Matches,Atalanta,Serie-A
1169,Odilon Kossounou,ci CIV,DF,24-121,9.5,12,7,7,4,1,4,9,44.4,5,12,3,9,9,21,15,0,Matches,Atalanta,Serie-A
1170,Marco Brescianini,it ITA,MF,25-105,9.6,16,10,4,8,4,7,9,77.8,2,14,1,13,2,18,5,0,Matches,Atalanta,Serie-A
1171,Juan Cuadrado,co COL,"DF,MF",36-344,9.0,19,9,9,6,4,11,23,47.8,12,14,2,12,7,26,9,0,Matches,Atalanta,Serie-A
1172,Lazar Samardzic,rs SRB,"MF,FW",23-070,11.7,18,12,4,6,8,10,21,47.6,11,8,1,7,2,20,6,0,Matches,Atalanta,Serie-A
1173,Stefan Posch,at AUT,DF,27-356,3.8,14,10,5,6,3,7,8,87.5,1,5,1,4,4,18,13,0,Matches,Atalanta,Serie-A
1174,Giorgio Scalvini,it ITA,DF,21-145,3.0,8,4,5,3,0,5,9,55.6,4,0,0,0,4,12,7,0,Matches,Atalanta,Serie-A
1175,Rafael Tolói,it ITA,DF,34-207,5.2,10,5,3,5,2,4,11,36.4,7,8,2,6,8,18,11,0,Matches,Atalanta,Serie-A
1176,Rui Patrício,pt POR,GK,37-079,2.0,0,0,0,0,0,0,0,,0,0,0,0,0,0,3,0,Matches,Atalanta,Serie-A
1177,Ibrahim Sulemana,gh GHA,MF,21-348,1.4,5,2,2,3,0,1,3,33.3,2,1,0,1,0,5,1,0,Matches,Atalanta,Serie-A
1178,Juan Musso,ar ARG,GK,30-364,1.0,0,0,0,0,0,0,0,,0,0,0,0,0,0,0,0,Matches,Atalanta,Serie-A
1179,Nicolò Zaniolo,it ITA,"FW,MF",25-307,4.0,0,0,0,0,0,0,2,0.0,2,0,0,0,1,1,0,0,Matches,Atalanta,Serie-A
1180,Daniel Maldini,it ITA,"FW,MF",23-206,1.5,1,1,0,0,1,1,2,50.0,1,1,0,1,0,1,0,0,Matches,Atalanta,Serie-A
1181,Marco Palestra,it ITA,DF,20-063,1.2,5,4,3,2,0,3,3,100.0,0,2,0,2,0,5,3,0,Matches,Atalanta,Serie-A
1182,Vanja Vlahović,rs SRB,"FW,MF",21-043,0.7,1,1,0,0,1,0,0,,0,0,0,0,0,1,0,0,Matches,Atalanta,Serie-A
1183,Ben Godfrey,eng ENG,DF,27-110,0.3,0,0,0,0,0,0,1,0.0,1,1,1,0,0,0,0,0,Matches,Atalanta,Serie-A
1184,Mitchel Bakker,nl NED,MF,24-319,0.2,1,0,1,0,0,1,1,100.0,0,0,0,0,0,1,0,0,Matches,Atalanta,Serie-A
1185,Federico Cassa,it ITA,"MF,FW",19-093,0.2,0,0,0,0,0,0,0,,0,1,0,1,0,0,0,0,Matches,Atalanta,Serie-A
1186,Alberto Manzoni,it ITA,MF,19-314,0.1,0,0,0,0,0,0,0,,0,0,0,0,0,0,0,0,Matches,Atalanta,Serie-A
1187,Gianluca Scamacca,it ITA,FW,26-124,0.1,0,0,0,0,0,0,0,,0,0,0,0,0,0,0,0,Matches,Atalanta,Serie-A
1188,Remo Freuler,ch SUI,MF,33-021,32.8,73,36,27,37,9,33,77,42.9,44,37,4,33,35,108,54,1,Matches,Bologna,Serie-A
1189,Sam Beukema,nl NED,DF,26-170,32.5,54,29,27,24,3,22,41,53.7,19,34,19,15,28,82,109,0,Matches,Bologna,Serie-A
1190,Jhon Lucumí,co COL,DF,26-314,26.4,48,28,22,26,0,27,38,71.1,11,32,14,18,24,72,84,6,Matches,Bologna,Serie-A
1191,Łukasz Skorupski,pl POL,GK,34-001,24.3,1,0,1,0,0,1,3,33.3,2,0,0,0,0,1,11,2,Matches,Bologna,Serie-A
1192,Santiago Castro,ar ARG,FW,20-219,24.0,17,9,4,9,4,5,15,33.3,10,13,2,11,3,20,19,0,Matches,Bologna,Serie-A
1193,Juan Miranda,es ESP,DF,25-107,24.3,32,18,11,14,7,14,30,46.7,16,21,3,18,21,53,47,1,Matches,Bologna,Serie-A
1194,Dan Ndoye,ch SUI,FW,24-193,21.8,22,16,8,6,8,13,23,56.5,10,19,0,19,8,30,4,0,Matches,Bologna,Serie-A
1195,Jens Odgaard,dk DEN,"MF,FW",26-036,21.7,20,14,3,12,5,6,21,28.6,15,19,2,17,9,29,12,1,Matches,Bologna,Serie-A
1196,Riccardo Orsolini,it ITA,FW,28-102,18.8,14,12,5,5,4,4,10,40.0,6,24,0,24,8,22,10,1,Matches,Bologna,Serie-A
1197,Benjamín Domínguez,ar ARG,FW,21-229,12.8,18,7,2,11,5,6,20,30.0,14,14,1,13,4,22,7,0,Matches,Bologna,Serie-A
1198,Nikola Moro,hr CRO,MF,27-055,12.4,34,26,6,21,7,21,32,65.6,11,18,7,11,13,47,17,0,Matches,Bologna,Serie-A
1199,Tommaso Pobega,it ITA,MF,25-295,11.9,31,18,12,13,6,21,28,75.0,7,14,4,10,13,44,15,0,Matches,Bologna,Serie-A
1200,Lorenzo De Silvestri,it ITA,DF,36-348,10.3,11,6,7,1,3,7,15,46.7,8,11,3,8,10,21,29,0,Matches,Bologna,Serie-A
1201,Emil Holm,se SWE,DF,24-358,12.0,34,21,17,14,3,20,30,66.7,10,19,4,15,10,44,50,1,Matches,Bologna,Serie-A
1202,Thijs Dallinga,nl NED,FW,24-276,11.7,10,5,0,4,6,3,3,100.0,0,10,1,9,1,11,12,1,Matches,Bologna,Serie-A
1203,Federico Ravaglia,it ITA,GK,25-176,10.7,0,0,0,0,0,0,0,,0,0,0,0,0,0,7,0,Matches,Bologna,Serie-A
1204,Charalambos Lykogiannis,gr GRE,DF,31-196,9.8,18,10,12,5,1,7,14,50.0,7,7,4,3,10,28,31,1,Matches,Bologna,Serie-A
1205,Giovanni Fabbian,it ITA,MF,22-112,10.6,10,6,1,3,6,7,13,53.8,6,7,2,5,2,12,4,0,Matches,Bologna,Serie-A
1206,Lewis Ferguson,sct SCO,MF,25-255,8.9,20,10,3,12,5,7,13,53.8,6,7,2,5,4,24,9,0,Matches,Bologna,Serie-A
1207,Michel Aebischer,ch SUI,MF,28-120,7.2,16,11,6,7,3,9,13,69.2,4,4,1,3,6,22,6,0,Matches,Bologna,Serie-A
1208,Nicolò Casale,it ITA,DF,27-081,8.0,7,4,4,3,0,3,7,42.9,4,11,7,4,13,20,40,2,Matches,Bologna,Serie-A
1209,Stefan Posch,at AUT,DF,27-357,7.9,26,15,12,9,5,15,25,60.0,10,19,4,15,5,31,22,0,Matches,Bologna,Serie-A
1210,Davide Calabria,it ITA,DF,28-151,6.0,12,8,5,5,2,5,11,45.5,6,3,0,3,1,13,19,1,Matches,Bologna,Serie-A
1211,Martin Erlic,hr CRO,DF,27-102,3.4,2,0,0,2,0,1,2,50.0,1,5,4,1,2,4,9,0,Matches,Bologna,Serie-A
1212,Nicolò Cambiaghi,it ITA,FW,24-129,5.6,12,8,5,5,2,4,9,44.4,5,8,0,8,2,14,2,0,Matches,Bologna,Serie-A
1213,Jesper Karlsson,se SWE,FW,26-285,3.3,1,0,0,0,1,0,2,0.0,2,4,0,4,0,1,3,0,Matches,Bologna,Serie-A
1214,Kacper Urbanski,pl POL,MF,20-241,2.7,5,2,4,0,1,4,6,66.7,2,5,1,4,2,7,5,0,Matches,Bologna,Serie-A
1215,Samuel Iling-Junior,eng ENG,"FW,MF",21-214,1.3,3,2,1,1,1,0,1,0.0,1,1,0,1,2,5,2,0,Matches,Bologna,Serie-A
1216,Estanis,es ESP,FW,21-255,0.1,0,0,0,0,0,0,0,,0,0,0,0,0,0,0,0,Matches,Bologna,Serie-A
1217,Oussama El Azzouzi,ma MAR,MF,23-342,0.1,0,0,0,0,0,0,0,,0,0,0,0,2,2,0,0,Matches,Bologna,Serie-A
1218,Sebastiano Luperto,it ITA,DF,28-241,34.0,45,24,29,15,1,16,26,61.5,10,27,13,14,31,76,152,1,Matches,Cagliari,Serie-A
1219,Roberto Piccoli,it ITA,FW,24-098,31.7,13,9,2,6,5,3,9,33.3,6,12,4,8,3,16,29,0,Matches,Cagliari,Serie-A
1220,Gabriele Zappa,it ITA,DF,25-134,31.3,36,20,18,16,2,16,30,53.3,14,39,21,18,23,59,85,1,Matches,Cagliari,Serie-A
1221,Nadir Zortea,it ITA,"DF,FW",25-320,27.6,28,12,15,11,2,13,32,40.6,19,8,0,8,16,44,43,2,Matches,Cagliari,Serie-A
1222,Yerry Mina,co COL,DF,30-224,26.5,59,27,38,19,2,36,47,76.6,11,54,31,23,33,92,155,3,Matches,Cagliari,Serie-A
1223,Tommaso Augello,it ITA,DF,30-248,27.3,47,26,27,16,4,28,39,71.8,11,21,6,15,16,63,97,1,Matches,Cagliari,Serie-A
1224,Michel Ndary Adopo,fr FRA,MF,24-290,24.0,52,31,15,29,8,14,26,53.8,12,18,5,13,25,77,22,0,Matches,Cagliari,Serie-A
1225,Antoine Makoumbou,cg CGO,MF,26-291,21.6,39,23,27,9,3,18,23,78.3,5,25,4,21,14,53,24,0,Matches,Cagliari,Serie-A
1226,Zito Luvumbo,ao ANG,"FW,MF",23-057,16.4,9,5,3,3,3,5,17,29.4,12,5,0,5,3,12,4,0,Matches,Cagliari,Serie-A
1227,Elia Caprile,it ITA,GK,23-253,16.0,0,0,0,0,0,0,2,0.0,2,0,0,0,0,0,8,1,Matches,Cagliari,Serie-A
1228,Nicolas Viola,it ITA,"MF,FW",35-205,12.7,14,7,6,7,1,1,10,10.0,9,4,0,4,2,16,5,0,Matches,Cagliari,Serie-A
1229,Alessandro Deiola,it ITA,MF,29-277,13.8,27,17,7,17,3,9,28,32.1,19,24,11,13,12,39,34,0,Matches,Cagliari,Serie-A
1230,Răzvan Marin,ro ROU,MF,28-347,14.9,21,12,8,11,2,13,25,52.0,12,6,0,6,2,23,20,2,Matches,Cagliari,Serie-A
1231,Simone Scuffet,it ITA,GK,28-339,13.0,0,0,0,0,0,0,1,0.0,1,0,0,0,0,0,8,2,Matches,Cagliari,Serie-A
1232,Adam Obert,sk SVK,DF,22-255,10.8,30,17,12,17,1,15,26,57.7,11,18,7,11,19,49,46,2,Matches,Cagliari,Serie-A
1233,José Luis Palomino,ar ARG,DF,35-120,10.6,23,13,14,7,2,14,19,73.7,5,15,7,8,19,42,44,0,Matches,Cagliari,Serie-A
1234,Mattia Felici,it ITA,"MF,FW",24-018,9.9,17,12,8,7,2,4,11,36.4,7,10,0,10,7,24,7,0,Matches,Cagliari,Serie-A
1235,Gianluca Gaetano,it ITA,"MF,FW",25-000,10.7,9,6,3,5,1,4,14,28.6,10,8,0,8,5,14,8,0,Matches,Cagliari,Serie-A
1236,Matteo Prati,it ITA,MF,21-128,6.1,10,4,2,7,1,3,11,27.3,8,5,2,3,7,17,10,1,Matches,Cagliari,Serie-A
1237,Alen Sherri,al ALB,GK,27-141,6.0,1,0,1,0,0,1,2,50.0,1,0,0,0,0,1,1,0,Matches,Cagliari,Serie-A
1238,Paulo Azzi,br BRA,DF,30-294,4.7,11,9,3,6,2,5,9,55.6,4,5,2,3,5,16,11,0,Matches,Cagliari,Serie-A
1239,Florinel Coman,ro ROU,"FW,MF",27-025,2.9,5,3,3,1,1,2,2,100.0,0,2,0,2,1,6,3,0,Matches,Cagliari,Serie-A
1240,Leonardo Pavoletti,it ITA,"FW,MF",36-160,4.7,1,0,0,1,0,0,0,,0,4,1,3,0,1,3,0,Matches,Cagliari,Serie-A
1241,Gianluca Lapadula,pe PER,"FW,MF",35-087,3.4,2,0,1,0,1,0,1,0.0,1,0,0,0,0,2,1,0,Matches,Cagliari,Serie-A
1242,Mateusz Wieteska,pl POL,DF,28-083,2.0,1,0,0,1,0,1,1,100.0,0,3,2,1,7,8,6,0,Matches,Cagliari,Serie-A
1243,Kingstone Mutandwa,zm ZAM,"MF,FW",22-120,1.0,0,0,0,0,0,0,0,,0,0,0,0,0,0,0,0,Matches,Cagliari,Serie-A
1244,Gabriel Strefezza,br BRA,"FW,MF",28-017,26.1,52,38,19,18,15,20,51,39.2,31,23,2,21,12,64,23,0,Matches,Como,Serie-A
1245,Marc-Oliver Kempf,de GER,DF,30-097,27.1,30,20,15,14,1,13,24,54.2,11,30,22,8,31,61,126,3,Matches,Como,Serie-A
1246,Nicolás Paz,ar ARG,"MF,FW",20-239,27.0,48,31,16,25,7,23,45,51.1,22,45,3,42,19,67,15,0,Matches,Como,Serie-A
1247,Lucas Da Cunha,fr FRA,MF,23-330,26.2,39,20,14,16,9,18,34,52.9,16,15,3,12,14,53,29,1,Matches,Como,Serie-A
1248,Edoardo Goldaniga,it ITA,DF,31-184,26.1,31,19,18,8,5,11,16,68.8,5,18,9,9,27,58,91,3,Matches,Como,Serie-A
1249,Patrick Cutrone,it ITA,FW,27-122,21.7,15,11,0,9,6,6,13,46.2,7,11,0,11,4,19,7,0,Matches,Como,Serie-A
1250,Alberto Dossena,it ITA,DF,26-204,20.3,33,20,23,8,2,16,28,57.1,12,22,11,11,22,55,89,1,Matches,Como,Serie-A
1251,Alberto Moreno,es ESP,DF,32-304,18.2,24,11,16,8,0,12,24,50.0,12,12,3,9,14,38,35,2,Matches,Como,Serie-A
1252,Alieu Fadera,gm GAM,"FW,DF",23-183,18.1,64,47,25,27,12,20,45,44.4,25,17,1,16,11,75,10,0,Matches,Como,Serie-A
1253,Máximo Perrone,ar ARG,MF,22-118,18.1,34,24,16,13,5,11,36,30.6,25,13,1,12,17,51,36,0,Matches,Como,Serie-A
1254,Jean Butez,fr FRA,GK,29-331,17.0,0,0,0,0,0,0,2,0.0,2,0,0,0,0,0,16,1,Matches,Como,Serie-A
1255,Assane Diao,sn SEN,"FW,MF",19-240,13.9,25,14,9,10,6,12,28,42.9,16,8,1,7,3,28,19,0,Matches,Como,Serie-A
1256,Ignace Van Der Brempt,be BEL,DF,23-034,12.1,39,31,27,10,2,23,31,74.2,8,11,5,6,13,52,31,0,Matches,Como,Serie-A
1257,Maxence Caqueret,fr FRA,MF,25-079,10.2,31,17,13,16,2,18,34,52.9,16,13,1,12,6,37,4,1,Matches,Como,Serie-A
1258,Yannik Engelhardt,de GER,"MF,DF",24-087,12.2,28,11,12,13,3,15,26,57.7,11,10,5,5,10,38,26,0,Matches,Como,Serie-A
1259,Pepe Reina,es ESP,GK,42-247,10.0,0,0,0,0,0,0,1,0.0,1,0,0,0,0,0,3,1,Matches,Como,Serie-A
1260,Álex Valle,es ESP,DF,21-010,9.4,23,11,9,12,2,13,17,76.5,4,10,2,8,6,29,36,0,Matches,Como,Serie-A
1261,Emil Audero,id IDN,GK,28-107,8.0,0,0,0,0,0,0,1,0.0,1,0,0,0,0,0,4,1,Matches,Como,Serie-A
1262,Sergi Roberto,es ESP,MF,33-087,7.7,14,8,5,5,4,5,7,71.4,2,7,1,6,9,23,14,0,Matches,Como,Serie-A
1263,Andrea Belotti,it ITA,FW,31-136,6.6,7,5,1,4,2,1,4,25.0,3,4,0,4,1,8,8,0,Matches,Como,Serie-A
1264,Ivan Smolčić,hr CRO,DF,24-261,6.0,15,9,8,6,1,9,12,75.0,3,8,2,6,10,25,22,0,Matches,Como,Serie-A
1265,Mërgim Vojvoda,xk KVX,DF,30-093,6.0,6,4,3,3,0,5,5,100.0,0,6,4,2,2,8,15,0,Matches,Como,Serie-A
1266,Jonathan Ikone,fr FRA,FW,27-003,5.6,15,9,4,3,8,6,11,54.5,5,5,1,4,0,15,1,1,Matches,Como,Serie-A
1267,Federico Barba,it ITA,DF,31-246,4.8,2,2,1,1,0,1,4,25.0,3,2,2,0,4,6,15,0,Matches,Como,Serie-A
1268,Anastasios Douvikas,gr GRE,FW,25-276,4.5,3,2,0,3,0,1,3,33.3,2,3,0,3,1,4,2,0,Matches,Como,Serie-A
1269,Alessio Iovine,it ITA,"DF,FW",34-093,4.2,5,2,2,3,0,4,10,40.0,6,7,1,6,3,8,21,1,Matches,Como,Serie-A
1270,Luca Mazzitelli,it ITA,MF,29-171,3.7,9,6,4,5,0,5,7,71.4,2,5,2,3,3,12,10,0,Matches,Como,Serie-A
1271,Matthias Braunöder,at AUT,MF,23-039,3.0,10,4,6,3,1,7,11,63.6,4,3,0,3,2,12,4,1,Matches,Como,Serie-A
1272,Marco Sala,it ITA,DF,25-335,2.9,9,6,5,3,1,5,8,62.5,3,2,0,2,1,10,9,0,Matches,Como,Serie-A
1273,Fellipe Jack,br BRA,DF,19-113,1.9,9,4,8,1,0,3,5,60.0,2,2,2,0,4,13,5,0,Matches,Como,Serie-A
1274,Daniele Baselli,it ITA,MF,33-054,0.2,0,0,0,0,0,0,0,,0,0,0,0,1,1,1,0,Matches,Como,Serie-A
1275,Alessandro Gabrielloni,it ITA,"FW,MF",30-299,1.6,0,0,0,0,0,0,3,0.0,3,0,0,0,0,0,1,0,Matches,Como,Serie-A
1276,Simone Verdi,it ITA,"MF,FW",32-297,1.3,2,2,0,1,1,0,2,0.0,2,2,0,2,0,2,2,0,Matches,Como,Serie-A
1277,Alberto Cerri,it ITA,FW,29-019,1.0,0,0,0,0,0,0,0,,0,2,0,2,0,0,1,0,Matches,Como,Serie-A
1278,Ben Lhassine Kone,ci CIV,MF,25-052,0.6,2,2,1,0,1,2,3,66.7,1,0,0,0,1,3,1,0,Matches,Como,Serie-A
1279,Ali Jasim,iq IRQ,"FW,DF",21-105,0.1,1,0,1,0,0,1,1,100.0,0,0,0,0,0,1,0,0,Matches,Como,Serie-A
1280,Dele Alli,eng ENG,MF,29-024,0.1,0,0,0,0,0,0,0,,0,0,0,0,0,0,0,0,Matches,Como,Serie-A
1281,Oliver Abildgaard,dk DEN,MF,28-329,0.1,0,0,0,0,0,0,0,,0,1,0,1,0,0,0,0,Matches,Como,Serie-A
1282,Emmanuel Gyasi,gh GHA,"DF,FW",31-115,32.9,51,28,31,14,6,24,36,66.7,12,23,8,15,11,62,76,0,Matches,Empoli,Serie-A
1283,Giuseppe Pezzella,it ITA,"DF,FW",27-158,29.0,52,29,27,17,8,28,55,50.9,27,31,8,23,14,66,99,1,Matches,Empoli,Serie-A
1284,Devis Vásquez,co COL,GK,26-359,29.0,0,0,0,0,0,0,0,,0,0,0,0,0,0,20,4,Matches,Empoli,Serie-A
1285,Saba Goglichidze,ge GEO,DF,20-315,26.8,63,37,35,25,3,25,50,50.0,25,34,16,18,33,96,92,3,Matches,Empoli,Serie-A
1286,Mattia Viti,it ITA,DF,23-102,25.6,62,43,41,18,3,33,49,67.3,16,38,17,21,45,107,108,4,Matches,Empoli,Serie-A
1287,Ardian Ismajli,al ALB,DF,28-218,24.9,25,19,18,7,0,13,16,81.3,3,31,22,9,49,74,223,3,Matches,Empoli,Serie-A
1288,Lorenzo Colombo,it ITA,"FW,MF",23-059,24.0,29,13,7,15,7,6,20,30.0,14,32,2,30,2,31,16,1,Matches,Empoli,Serie-A
1289,Liam Henderson,sct SCO,MF,29-011,23.9,40,20,16,21,3,21,50,42.0,29,18,5,13,15,55,40,0,Matches,Empoli,Serie-A
1290,Sebastiano Esposito,it ITA,"FW,MF",22-308,23.3,50,26,14,27,9,15,31,48.4,16,20,2,18,12,62,13,0,Matches,Empoli,Serie-A
1291,Alberto Grassi,it ITA,MF,30-060,21.7,36,18,13,18,5,12,18,66.7,6,22,12,10,30,66,39,1,Matches,Empoli,Serie-A
1292,Liberato Cacace,nz NZL,"DF,MF",24-221,22.3,35,24,20,12,3,21,30,70.0,9,24,8,16,21,56,56,0,Matches,Empoli,Serie-A
1293,Youssef Maleh,ma MAR,MF,26-257,16.8,45,23,17,23,5,17,34,50.0,17,25,6,19,16,61,25,0,Matches,Empoli,Serie-A
1294,Faustino Anjorin,eng ENG,MF,23-164,11.6,27,12,7,14,6,9,18,50.0,9,16,3,13,11,38,19,0,Matches,Empoli,Serie-A
1295,Jacopo Fazzini,it ITA,MF,22-051,12.5,30,18,11,15,4,12,20,60.0,8,10,1,9,6,36,23,0,Matches,Empoli,Serie-A
1296,Luca Marianucci,it ITA,DF,20-287,10.4,27,11,17,10,0,10,18,55.6,8,14,8,6,18,45,58,1,Matches,Empoli,Serie-A
1297,Ola Solbakken,no NOR,"MF,FW",26-241,8.2,7,4,0,6,1,3,6,50.0,3,0,0,0,2,9,8,0,Matches,Empoli,Serie-A
1298,Mattia De Sciglio,it ITA,DF,32-198,8.5,18,13,10,8,0,14,17,82.4,3,10,3,7,8,26,35,1,Matches,Empoli,Serie-A
1299,Christian Kouamé,ci CIV,"FW,MF",27-151,5.6,5,4,0,3,2,2,4,50.0,2,4,2,2,0,5,4,0,Matches,Empoli,Serie-A
1300,Marco Silvestri,it ITA,GK,34-065,5.0,0,0,0,0,0,0,2,0.0,2,0,0,0,0,0,3,1,Matches,Empoli,Serie-A
1301,Pietro Pellegri,it ITA,FW,24-050,4.6,7,2,0,6,1,2,4,50.0,2,2,0,2,0,7,3,0,Matches,Empoli,Serie-A
1302,Junior Sambia,fr FRA,"DF,FW",28-241,4.0,13,9,3,5,5,10,10,100.0,0,3,0,3,2,15,4,0,Matches,Empoli,Serie-A
1303,Nicolas Haas,ch SUI,MF,29-103,3.2,11,8,4,5,2,5,9,55.6,4,2,1,1,4,15,6,0,Matches,Empoli,Serie-A
1304,Sebastian Walukiewicz,pl POL,DF,25-031,2.0,1,0,1,0,0,0,1,0.0,1,3,3,0,1,2,15,0,Matches,Empoli,Serie-A
1305,Jacopo Seghetti,it ITA,GK,20-078,1.0,0,0,0,0,0,0,0,,0,0,0,0,0,0,0,0,Matches,Empoli,Serie-A
1306,Emmanuel Ekong,se SWE,"MF,FW",22-315,2.1,4,3,0,2,2,3,3,100.0,0,2,1,1,1,5,1,0,Matches,Empoli,Serie-A
1307,Szymon Żurkowski,pl POL,MF,27-223,1.2,6,4,2,4,0,4,4,100.0,0,3,0,3,1,7,2,0,Matches,Empoli,Serie-A
1308,Ismael Konate,ci CIV,"FW,MF",19-038,1.1,4,2,4,0,0,2,3,66.7,1,3,2,1,0,4,1,0,Matches,Empoli,Serie-A
1309,Viktor Kovalenko,ua UKR,MF,29-081,0.9,2,1,0,2,0,0,1,0.0,1,0,0,0,0,2,0,0,Matches,Empoli,Serie-A
1310,Tyronne Ebuehi,ng NGA,"DF,MF",29-141,0.7,2,1,0,2,0,1,1,100.0,0,1,0,1,2,4,0,0,Matches,Empoli,Serie-A
1311,Jacopo Bacci,it ITA,MF,19-321,0.3,1,0,1,0,0,1,1,100.0,0,0,0,0,1,2,1,0,Matches,Empoli,Serie-A
1312,Thomas Campaniello,it ITA,FW,17-066,0.3,0,0,0,0,0,0,2,0.0,2,0,0,0,0,0,0,0,Matches,Empoli,Serie-A
1313,Francesco Caputo,it ITA,FW,37-273,0.1,0,0,0,0,0,0,0,,0,0,0,0,0,0,0,0,Matches,Empoli,Serie-A
1314,Petar Stojanović,si SVN,MF,29-211,0.0,0,0,0,0,0,0,0,,0,0,0,0,0,0,0,0,Matches,Empoli,Serie-A
1315,Lorenzo Tosto,it ITA,DF,19-097,0.0,0,0,0,0,0,0,0,,0,0,0,0,0,0,0,0,Matches,Empoli,Serie-A
1316,David de Gea,es ESP,GK,34-179,32.0,1,0,1,0,0,1,1,100.0,0,0,0,0,0,1,12,0,Matches,Fiorentina,Serie-A
1317,Dodô,br BRA,DF,26-169,31.6,41,28,23,10,8,23,45,51.1,22,21,5,16,33,74,56,2,Matches,Fiorentina,Serie-A
1318,Luca Ranieri,it ITA,DF,26-012,31.1,37,21,26,9,2,18,22,81.8,4,43,31,12,25,62,142,1,Matches,Fiorentina,Serie-A
1319,Moise Kean,it ITA,FW,25-066,28.0,7,5,1,2,4,3,4,75.0,1,12,0,12,5,12,24,1,Matches,Fiorentina,Serie-A
1320,Robin Gosens,de GER,DF,30-304,25.1,53,31,30,15,8,25,42,59.5,17,29,9,20,16,69,88,0,Matches,Fiorentina,Serie-A
1321,Danilo Cataldi,it ITA,MF,30-272,19.2,25,16,13,10,2,14,27,51.9,13,17,8,9,22,47,35,0,Matches,Fiorentina,Serie-A
1322,Pietro Comuzzo,it ITA,DF,20-074,23.2,41,20,27,11,3,21,27,77.8,6,33,20,13,27,68,107,4,Matches,Fiorentina,Serie-A
1323,Lucas Beltrán,ar ARG,"MF,FW",24-037,19.8,20,10,8,7,5,6,19,31.6,13,15,2,13,4,24,14,0,Matches,Fiorentina,Serie-A
1324,Rolando Mandragora,it ITA,MF,27-310,18.5,20,11,9,9,2,12,28,42.9,16,22,7,15,13,33,53,1,Matches,Fiorentina,Serie-A
1325,Andrea Colpani,it ITA,"FW,MF",25-359,15.9,15,9,5,7,3,4,12,33.3,8,6,0,6,9,24,10,0,Matches,Fiorentina,Serie-A
1326,Albert Guðmundsson,is ISL,"FW,MF",27-324,13.9,9,5,2,4,3,7,17,41.2,10,5,0,5,6,15,9,1,Matches,Fiorentina,Serie-A
1327,Yacine Adli,fr FRA,MF,24-280,13.4,32,19,11,16,5,17,38,44.7,21,12,1,11,6,38,19,0,Matches,Fiorentina,Serie-A
1328,Marin Pongračić,hr CRO,DF,27-236,13.7,17,12,13,3,1,7,10,70.0,3,14,6,8,11,28,65,2,Matches,Fiorentina,Serie-A
1329,Edoardo Bove,it ITA,"MF,FW",22-354,9.5,24,17,7,14,3,14,28,50.0,14,12,0,12,6,30,8,0,Matches,Fiorentina,Serie-A
1330,Fabiano Parisi,it ITA,"DF,MF",24-177,11.4,26,16,11,11,4,11,19,57.9,8,14,2,12,15,41,15,0,Matches,Fiorentina,Serie-A
1331,Pablo Marí,es ESP,DF,31-247,9.2,9,4,8,1,0,4,9,44.4,5,13,9,4,19,28,78,0,Matches,Fiorentina,Serie-A
1332,Riccardo Sottil,it ITA,"FW,MF",25-336,9.3,5,4,3,1,1,3,4,75.0,1,1,0,1,4,9,3,0,Matches,Fiorentina,Serie-A
1333,Amir Richardson,ma MAR,MF,23-101,9.7,24,11,12,10,2,9,19,47.4,10,11,1,10,5,29,27,1,Matches,Fiorentina,Serie-A
1334,Nicolò Fagioli,it ITA,MF,24-082,7.7,16,9,8,7,1,8,21,38.1,13,7,1,6,4,20,9,2,Matches,Fiorentina,Serie-A
1335,Michael Folorunsho,it ITA,"FW,MF",27-087,6.9,19,12,9,6,4,8,20,40.0,12,9,1,8,4,23,10,0,Matches,Fiorentina,Serie-A
1336,Christian Kouamé,ci CIV,"FW,MF",27-150,6.9,13,8,4,4,5,0,3,0.0,3,3,1,2,2,15,10,0,Matches,Fiorentina,Serie-A
1337,Cristiano Biraghi,it ITA,DF,32-246,4.8,4,4,1,3,0,2,7,28.6,5,2,0,2,4,8,11,0,Matches,Fiorentina,Serie-A
1338,Lucas Martínez Quarta,ar ARG,DF,28-360,3.9,12,7,9,3,0,8,13,61.5,5,5,2,3,3,15,25,1,Matches,Fiorentina,Serie-A
1339,Nicolò Zaniolo,it ITA,FW,25-307,3.8,3,1,1,2,0,0,4,0.0,4,2,1,1,0,3,2,0,Matches,Fiorentina,Serie-A
1340,Cher Ndour,it ITA,"MF,DF",20-282,3.7,3,0,2,1,0,1,8,12.5,7,4,1,3,2,5,7,1,Matches,Fiorentina,Serie-A
1341,Pietro Terracciano,it ITA,GK,35-058,3.0,0,0,0,0,0,0,0,,0,0,0,0,0,0,0,0,Matches,Fiorentina,Serie-A
1342,Sofyan Amrabat,ma MAR,MF,28-257,2.0,3,2,1,2,0,2,2,100.0,0,1,1,0,0,3,2,0,Matches,Fiorentina,Serie-A
1343,Matias Moreno,ar ARG,DF,21-223,1.6,8,8,5,3,0,4,4,100.0,0,5,1,4,1,9,9,0,Matches,Fiorentina,Serie-A
1344,Jonathan Ikone,fr FRA,"FW,MF",27-003,3.7,5,2,3,2,0,2,4,50.0,2,3,0,3,1,6,1,0,Matches,Fiorentina,Serie-A
1345,Michael Kayode,it ITA,"DF,FW",20-299,1.4,1,1,1,0,0,0,0,,0,3,1,2,2,3,7,0,Matches,Fiorentina,Serie-A
1346,Antonín Barák,cz CZE,MF,30-153,0.6,2,0,0,2,0,0,2,0.0,2,1,1,0,0,2,0,0,Matches,Fiorentina,Serie-A
1347,Alessandro Bianco,it ITA,MF,22-216,0.2,0,0,0,0,0,0,1,0.0,1,0,0,0,0,0,0,0,Matches,Fiorentina,Serie-A
1348,Maat Daniel Caprini,it ITA,FW,19-083,0.1,0,0,0,0,0,0,0,,0,0,0,0,0,0,0,0,Matches,Fiorentina,Serie-A
1349,Tommaso Rubino,it ITA,MF,18-176,0.1,0,0,0,0,0,0,1,0.0,1,0,0,0,0,0,0,0,Matches,Fiorentina,Serie-A
1350,Morten Frendrup,dk DEN,MF,24-029,31.5,99,59,22,50,27,33,72,45.8,39,57,15,42,44,143,53,0,Matches,Genoa,Serie-A
1351,Aarón Martín,es ESP,DF,28-014,30.9,68,45,40,24,4,31,47,66.0,16,31,10,21,18,86,65,1,Matches,Genoa,Serie-A
1352,Johan Vásquez,mx MEX,DF,26-196,31.4,49,26,22,23,4,21,37,56.8,16,55,27,28,44,93,142,1,Matches,Genoa,Serie-A
1353,Andrea Pinamonti,it ITA,FW,25-352,28.8,9,5,0,7,2,1,6,16.7,5,14,4,10,1,10,26,2,Matches,Genoa,Serie-A
1354,Nicola Leali,it ITA,GK,32-078,27.0,0,0,0,0,0,0,0,,0,0,0,0,0,0,14,1,Matches,Genoa,Serie-A
1355,Fabio Miretti,it ITA,"MF,FW",21-276,18.6,28,15,6,14,8,18,33,54.5,15,20,1,19,7,35,13,2,Matches,Genoa,Serie-A
1356,Koni De Winter,be BEL,DF,22-328,21.1,30,18,19,8,3,15,22,68.2,7,10,6,4,21,51,105,3,Matches,Genoa,Serie-A
1357,Morten Thorsby,no NOR,MF,29-001,20.1,45,30,18,17,10,14,26,53.8,12,21,1,20,5,50,28,0,Matches,Genoa,Serie-A
1358,Stefano Sabelli,it ITA,DF,32-113,20.5,55,29,26,24,5,19,46,41.3,27,28,7,21,20,75,59,0,Matches,Genoa,Serie-A
1359,Milan Badelj,hr CRO,MF,36-070,15.6,28,15,14,9,5,15,35,42.9,20,18,6,12,18,46,42,0,Matches,Genoa,Serie-A
1360,Alessandro Zanoli,it ITA,"FW,DF",24-215,18.1,26,18,11,12,3,9,20,45.0,11,18,3,15,12,38,39,0,Matches,Genoa,Serie-A
1361,Mattia Bani,it ITA,DF,31-147,14.8,18,9,11,5,2,7,11,63.6,4,9,5,4,19,37,77,2,Matches,Genoa,Serie-A
1362,Vitinha,pt POR,"FW,MF",25-052,12.1,20,5,11,4,5,10,26,38.5,16,12,1,11,11,31,17,0,Matches,Genoa,Serie-A
1363,Patrizio Masini,it ITA,MF,24-099,13.1,43,23,16,19,8,13,27,48.1,14,21,7,14,12,55,34,0,Matches,Genoa,Serie-A
1364,Alan Matturro,uy URU,DF,20-207,10.0,11,6,6,5,0,3,14,21.4,11,10,3,7,14,25,38,0,Matches,Genoa,Serie-A
1365,Alessandro Vogliacco,it ITA,DF,26-234,7.9,15,3,7,7,1,10,12,83.3,2,11,7,4,9,24,20,0,Matches,Genoa,Serie-A
1366,Pierluigi Gollini,it ITA,GK,30-049,7.0,0,0,0,0,0,0,0,,0,1,0,1,0,0,2,1,Matches,Genoa,Serie-A
1367,Jeff Ekhator,it ITA,"FW,MF",18-176,8.2,6,3,3,1,2,4,8,50.0,4,10,1,9,2,8,5,0,Matches,Genoa,Serie-A
1368,Junior Messias,br BRA,"MF,FW",33-358,7.1,10,7,6,4,0,3,8,37.5,5,4,2,2,6,16,13,0,Matches,Genoa,Serie-A
1369,Ruslan Malinovskyi,ua UKR,"MF,FW",32-002,4.3,12,8,4,7,1,3,6,50.0,3,2,0,2,1,13,4,0,Matches,Genoa,Serie-A
1370,Brooke Norton-Cuffy,eng ENG,"DF,MF",21-114,4.1,9,6,6,3,0,6,7,85.7,1,4,0,4,3,12,9,0,Matches,Genoa,Serie-A
1371,Caleb Ekuban,gh GHA,FW,31-044,5.7,3,3,1,1,1,1,1,100.0,0,4,1,3,1,4,5,0,Matches,Genoa,Serie-A
1372,Maxwel Cornet,ci CIV,"FW,MF",28-221,2.6,2,1,1,0,1,0,1,0.0,1,1,1,0,2,4,1,0,Matches,Genoa,Serie-A
1373,Lior Kasa,il ISR,"MF,FW",19-221,2.3,4,4,2,2,0,2,5,40.0,3,4,1,3,2,6,2,0,Matches,Genoa,Serie-A
1374,Honest Ahanor,it ITA,"DF,MF",17-072,1.9,4,3,0,2,2,4,6,66.7,2,1,0,1,0,4,3,0,Matches,Genoa,Serie-A
1375,Jean Onana,cm CMR,MF,25-118,2.1,9,6,2,7,0,4,7,57.1,3,3,0,3,2,11,8,1,Matches,Genoa,Serie-A
1376,Emil Bohinen,no NOR,MF,26-055,1.8,4,4,3,0,1,2,5,40.0,3,2,0,2,1,5,6,0,Matches,Genoa,Serie-A
1377,Filippo Melegoni,it ITA,"MF,FW",26-077,1.0,1,1,1,0,0,0,4,0.0,4,0,0,0,0,1,2,0,Matches,Genoa,Serie-A
1378,Alessandro Marcandalli,it ITA,DF,22-223,0.5,1,0,1,0,0,0,0,,0,0,0,0,0,1,2,0,Matches,Genoa,Serie-A
1379,Sebastian Otoa,dk DEN,DF,20-358,0.2,0,0,0,0,0,0,1,0.0,1,0,0,0,0,0,0,0,Matches,Genoa,Serie-A
1380,Lorenzo Venturino,it ITA,"FW,MF",18-318,1.0,2,1,1,0,1,1,2,50.0,1,1,0,1,0,2,3,0,Matches,Genoa,Serie-A
1381,Mario Balotelli,it ITA,"FW,MF",34-267,0.7,0,0,0,0,0,0,0,,0,0,0,0,0,0,1,0,Matches,Genoa,Serie-A
1382,David Akpan Ankeye,ng NGA,"FW,MF",23-081,0.5,0,0,0,0,0,0,1,0.0,1,0,0,0,0,0,1,0,Matches,Genoa,Serie-A
1383,Gastón Pereiro,uy URU,MF,29-329,0.3,1,0,0,1,0,1,1,100.0,0,0,0,0,0,1,1,0,Matches,Genoa,Serie-A
1384,Federico Accornero,it ITA,MF,21-090,0.1,0,0,0,0,0,0,0,,0,0,0,0,0,0,0,0,Matches,Genoa,Serie-A
1385,Lorenzo Montipò,it ITA,GK,29-075,34.0,1,0,1,0,0,1,4,25.0,3,0,0,0,0,1,20,4,Matches,Hellas-Verona,Serie-A
1386,Jackson Tchatchoua,cm CMR,"DF,MF",23-234,32.2,47,29,34,10,3,27,41,65.9,14,20,9,11,12,59,65,2,Matches,Hellas-Verona,Serie-A
1387,Diego Coppola,it ITA,DF,21-129,29.5,64,34,46,14,4,26,37,70.3,11,41,24,17,66,130,160,2,Matches,Hellas-Verona,Serie-A
1388,Ondrej Duda,sk SVK,MF,30-152,24.6,43,26,20,20,3,29,61,47.5,32,24,7,17,31,74,30,4,Matches,Hellas-Verona,Serie-A
1389,Tomáš Suslov,sk SVK,"MF,FW",22-333,22.0,52,36,21,24,7,21,68,30.9,47,29,2,27,18,70,15,1,Matches,Hellas-Verona,Serie-A
1390,Domagoj Bradarić,hr CRO,DF,25-147,19.6,32,24,20,8,4,16,26,61.5,10,17,4,13,14,46,46,1,Matches,Hellas-Verona,Serie-A
1391,Amin Sarr,se SWE,FW,24-056,18.7,21,12,3,8,10,5,9,55.6,4,17,3,14,2,23,14,0,Matches,Hellas-Verona,Serie-A
1392,Paweł Dawidowicz,pl POL,"DF,MF",29-351,18.7,42,22,19,20,3,18,27,66.7,9,15,5,10,20,62,62,2,Matches,Hellas-Verona,Serie-A
1393,Daniele Ghilardi,it ITA,DF,22-120,19.5,38,23,24,14,0,22,37,59.5,15,25,12,13,23,61,88,0,Matches,Hellas-Verona,Serie-A
1394,Casper Tengstedt,dk DEN,"FW,MF",24-339,15.5,7,5,0,5,2,4,8,50.0,4,5,1,4,3,10,27,0,Matches,Hellas-Verona,Serie-A
1395,Reda Belahyane,ma MAR,MF,20-339,18.4,36,26,16,13,7,13,17,76.5,4,20,9,11,10,46,22,1,Matches,Hellas-Verona,Serie-A
1396,Darko Lazović,rs SRB,"DF,FW",34-233,15.9,20,10,5,13,2,11,28,39.3,17,19,3,16,11,31,39,0,Matches,Hellas-Verona,Serie-A
1397,Suat Serdar,de GER,MF,28-025,12.9,29,18,9,17,3,8,21,38.1,13,15,4,11,8,37,18,0,Matches,Hellas-Verona,Serie-A
1398,Daniel Mosquera,co COL,FW,25-198,14.3,10,7,3,4,3,1,13,7.7,12,11,1,10,2,12,9,0,Matches,Hellas-Verona,Serie-A
1399,Giangiacomo Magnani,it ITA,DF,29-214,11.8,20,15,14,6,0,7,7,100.0,0,16,9,7,17,37,73,1,Matches,Hellas-Verona,Serie-A
1400,Nicolás Valentini,ar ARG,DF,24-030,9.7,26,17,15,10,1,15,22,68.2,7,12,6,6,10,36,65,0,Matches,Hellas-Verona,Serie-A
1401,Flavius Daniliuc,at AUT,DF,24-009,11.0,24,19,13,8,3,14,23,60.9,9,10,3,7,7,31,26,0,Matches,Hellas-Verona,Serie-A
1402,Dailon Livramento,cv CPV,"FW,MF",24-002,9.9,12,8,1,5,6,6,12,50.0,6,9,2,7,3,15,8,0,Matches,Hellas-Verona,Serie-A
1403,Grigoris Kastanos,cy CYP,"MF,FW",27-096,9.6,23,16,8,7,8,9,21,42.9,12,16,2,14,7,30,8,0,Matches,Hellas-Verona,Serie-A
1404,Cheikh Tidiane Niasse,sn SEN,MF,25-107,7.4,14,11,4,10,0,8,15,53.3,7,17,4,13,17,31,16,2,Matches,Hellas-Verona,Serie-A
1405,Antoine Bernede,fr FRA,MF,25-345,5.6,14,7,4,8,2,9,15,60.0,6,6,1,5,5,19,3,0,Matches,Hellas-Verona,Serie-A
1406,Abdou Harroui,nl NED,"MF,FW",27-113,5.1,9,6,6,3,0,4,4,100.0,0,5,0,5,2,11,5,0,Matches,Hellas-Verona,Serie-A
1407,Martin Frese,dk DEN,DF,27-122,5.0,14,8,6,8,0,5,9,55.6,4,4,1,3,8,22,15,1,Matches,Hellas-Verona,Serie-A
1408,Daniel Bandeira,pt POR,MF,25-025,4.5,4,0,1,3,0,3,6,50.0,3,2,1,1,6,10,8,0,Matches,Hellas-Verona,Serie-A
1409,Davide Faraoni,it ITA,DF,33-193,2.9,10,9,5,5,0,3,9,33.3,6,7,3,4,2,12,12,1,Matches,Hellas-Verona,Serie-A
1410,Simone Perilli,it ITA,GK,30-119,1.0,0,0,0,0,0,0,0,,0,0,0,0,0,0,1,0,Matches,Hellas-Verona,Serie-A
1411,Daniel Oyegoke,eng ENG,DF,22-123,1.1,2,2,1,0,1,1,1,100.0,0,1,0,1,1,3,7,0,Matches,Hellas-Verona,Serie-A
1412,Mathis Lambourde,fr FRA,"FW,MF",19-117,1.0,3,1,2,1,0,1,3,33.3,2,3,0,3,0,3,1,0,Matches,Hellas-Verona,Serie-A
1413,Faride Alidou,de GER,"FW,MF",23-292,0.8,0,0,0,0,0,0,0,,0,1,0,1,1,1,3,1,Matches,Hellas-Verona,Serie-A
1414,Junior Ajayi,ci CIV,FW,20-207,0.1,0,0,0,0,0,0,0,,0,0,0,0,0,0,0,0,Matches,Hellas-Verona,Serie-A
1415,Alphadjo Cissè,it ITA,"FW,MF",18-196,0.1,0,0,0,0,0,0,0,,0,0,0,0,0,0,0,0,Matches,Hellas-Verona,Serie-A
1416,Yllan Okou,fr FRA,DF,22-134,0.0,0,0,0,0,0,0,0,,0,1,0,1,0,0,0,0,Matches,Hellas-Verona,Serie-A
1417,Yann Sommer,ch SUI,GK,36-139,31.0,0,0,0,0,0,0,0,,0,0,0,0,0,0,11,1,Matches,Internazionale,Serie-A
1418,Lautaro Martínez,ar ARG,FW,27-256,28.5,30,16,10,12,8,13,25,52.0,12,21,3,18,10,40,15,0,Matches,Internazionale,Serie-A
1419,Henrikh Mkhitaryan,am ARM,MF,36-104,25.6,40,23,16,16,8,19,44,43.2,25,29,5,24,17,57,41,0,Matches,Internazionale,Serie-A
1420,Alessandro Bastoni,it ITA,DF,26-022,24.8,40,20,20,14,6,18,27,66.7,9,22,10,12,21,61,48,1,Matches,Internazionale,Serie-A
1421,Nicolò Barella,it ITA,MF,28-087,26.0,47,30,17,19,11,25,56,44.6,31,24,3,21,10,57,14,1,Matches,Internazionale,Serie-A
1422,Federico Dimarco,it ITA,"DF,FW",27-176,22.3,23,13,9,11,3,8,17,47.1,9,21,3,18,12,35,31,2,Matches,Internazionale,Serie-A
1423,Marcus Thuram,fr FRA,FW,27-272,24.4,18,10,7,5,6,3,14,21.4,11,15,3,12,3,21,15,0,Matches,Internazionale,Serie-A
1424,Hakan Çalhanoğlu,tr TUR,MF,31-086,19.7,39,21,6,22,11,18,33,54.5,15,13,6,7,17,56,21,0,Matches,Internazionale,Serie-A
1425,Denzel Dumfries,nl NED,"DF,FW",29-017,19.9,25,18,12,9,4,14,24,58.3,10,25,5,20,6,31,21,1,Matches,Internazionale,Serie-A
1426,Francesco Acerbi,it ITA,DF,37-084,17.5,23,19,16,7,0,11,17,64.7,6,21,15,6,26,49,75,0,Matches,Internazionale,Serie-A
1427,Matteo Darmian,it ITA,DF,35-154,17.8,25,15,11,11,3,13,24,54.2,11,12,5,7,7,32,35,0,Matches,Internazionale,Serie-A
1428,Benjamin Pavard,fr FRA,DF,29-038,17.6,29,16,12,12,5,18,25,72.0,7,16,12,4,16,45,52,0,Matches,Internazionale,Serie-A
1429,Stefan de Vrij,nl NED,DF,33-089,17.2,16,10,11,4,1,8,11,72.7,3,18,10,8,21,37,74,0,Matches,Internazionale,Serie-A
1430,Yann Aurel Bisseck,de GER,DF,24-157,16.1,15,11,9,4,2,10,13,76.9,3,16,8,8,15,30,59,1,Matches,Internazionale,Serie-A
1431,Carlos Augusto,br BRA,DF,26-118,17.0,27,12,12,10,5,12,18,66.7,6,20,9,11,8,35,44,0,Matches,Internazionale,Serie-A
1432,Davide Frattesi,it ITA,MF,25-195,13.6,17,8,6,10,1,10,18,55.6,8,12,4,8,5,22,14,1,Matches,Internazionale,Serie-A
1433,Kristjan Asllani,al ALB,MF,23-057,9.0,13,2,8,4,1,7,19,36.8,12,8,1,7,7,20,12,1,Matches,Internazionale,Serie-A
1434,Piotr Zieliński,pl POL,MF,30-350,10.2,13,9,5,7,1,6,13,46.2,7,9,4,5,6,19,11,1,Matches,Internazionale,Serie-A
1435,Marko Arnautović,at AUT,FW,36-016,5.9,7,6,1,3,3,3,5,60.0,2,3,0,3,1,8,1,0,Matches,Internazionale,Serie-A
1436,Mehdi Taremi,ir IRN,FW,32-291,6.7,4,1,1,1,2,0,2,0.0,2,8,1,7,0,4,10,0,Matches,Internazionale,Serie-A
1437,Joaquín Correa,ar ARG,"FW,MF",30-265,5.7,8,3,3,5,0,2,9,22.2,7,2,0,2,0,8,4,0,Matches,Internazionale,Serie-A
1438,Josep Martinez,es ESP,GK,26-343,4.0,0,0,0,0,0,0,0,,0,0,0,0,0,0,0,0,Matches,Internazionale,Serie-A
1439,Nicola Zalewski,pl POL,DF,23-102,3.3,4,2,3,1,0,2,4,50.0,2,3,1,2,2,6,3,1,Matches,Internazionale,Serie-A
1440,Tajon Buchanan,ca CAN,"DF,FW",26-086,1.1,3,0,2,0,1,1,2,50.0,1,0,0,0,0,3,3,0,Matches,Internazionale,Serie-A
1441,Tomás Palacios,ar ARG,DF,22-007,0.1,0,0,0,0,0,0,0,,0,0,0,0,1,1,0,0,Matches,Internazionale,Serie-A
1442,Manuel Locatelli,it ITA,MF,27-118,28.4,68,47,27,34,7,30,49,61.2,19,49,17,32,22,90,68,0,Matches,Juventus,Serie-A
1443,Michele Di Gregorio,it ITA,GK,27-283,30.0,0,0,0,0,0,0,0,,0,0,0,0,0,0,12,0,Matches,Juventus,Serie-A
1444,Kenan Yıldız,tr TUR,"FW,MF",20-002,24.7,51,28,11,25,15,16,28,57.1,12,24,0,24,5,56,11,3,Matches,Juventus,Serie-A
1445,Federico Gatti,it ITA,DF,26-316,24.3,28,23,18,8,2,14,24,58.3,10,27,18,9,18,46,73,2,Matches,Juventus,Serie-A
1446,Weston McKennie,us USA,"MF,DF",26-251,23.6,32,12,17,11,4,13,22,59.1,9,28,8,20,12,44,33,0,Matches,Juventus,Serie-A
1447,Pierre Kalulu,fr FRA,DF,24-335,25.3,40,24,29,9,2,18,24,75.0,6,27,15,12,17,57,66,1,Matches,Juventus,Serie-A
1448,Khéphren Thuram,fr FRA,MF,24-041,23.8,39,18,13,22,4,18,30,60.0,12,31,9,22,11,50,37,1,Matches,Juventus,Serie-A
1449,Andrea Cambiaso,it ITA,"DF,FW",25-075,23.1,41,26,24,11,6,25,41,61.0,16,23,4,19,14,55,30,5,Matches,Juventus,Serie-A
1450,Teun Koopmeiners,nl NED,"MF,FW",27-067,22.2,32,16,6,19,7,10,30,33.3,20,36,14,22,8,40,26,2,Matches,Juventus,Serie-A
1451,Dušan Vlahović,rs SRB,FW,25-098,19.4,3,1,0,1,2,1,5,20.0,4,7,3,4,1,4,8,3,Matches,Juventus,Serie-A
1452,Nicolás González,ar ARG,"FW,MF",27-030,17.1,22,12,10,8,4,9,23,39.1,14,15,4,11,7,29,26,2,Matches,Juventus,Serie-A
1453,Nicolò Savona,it ITA,DF,22-048,17.2,29,13,19,9,1,13,24,54.2,11,7,1,6,10,39,28,0,Matches,Juventus,Serie-A
1454,Timothy Weah,us USA,"DF,FW",25-073,16.9,33,18,14,12,7,13,22,59.1,9,25,4,21,12,45,24,2,Matches,Juventus,Serie-A
1455,Francisco Conceição,pt POR,"FW,MF",22-143,12.5,17,9,4,7,6,9,25,36.0,16,6,0,6,4,21,5,0,Matches,Juventus,Serie-A
1456,Randal Kolo Muani,fr FRA,FW,26-152,10.4,10,6,3,4,3,3,4,75.0,1,5,0,5,1,11,2,0,Matches,Juventus,Serie-A
1457,Renato Veiga,pt POR,DF,21-281,9.6,16,11,6,9,1,9,13,69.2,4,13,10,3,13,29,65,0,Matches,Juventus,Serie-A
1458,Lloyd Kelly,eng ENG,DF,26-212,9.3,10,8,3,6,1,7,9,77.8,2,10,6,4,1,11,41,3,Matches,Juventus,Serie-A
1459,Samuel Mbangula,be BEL,FW,21-110,7.9,15,10,7,6,2,7,13,53.8,6,7,0,7,3,18,4,0,Matches,Juventus,Serie-A
1460,Danilo,br BRA,DF,33-295,6.5,10,4,7,2,1,5,10,50.0,5,4,3,1,9,19,21,1,Matches,Juventus,Serie-A
1461,Gleison Bremer,br BRA,DF,28-049,6.0,15,7,9,5,1,4,5,80.0,1,15,11,4,6,21,16,0,Matches,Juventus,Serie-A
1462,Juan David Cabal,co COL,DF,24-118,5.1,10,4,7,3,0,8,12,66.7,4,2,0,2,2,12,14,1,Matches,Juventus,Serie-A
1463,Nicolò Fagioli,it ITA,MF,24-083,6.3,14,10,7,6,1,6,9,66.7,3,4,0,4,2,16,5,0,Matches,Juventus,Serie-A
1464,Mattia Perin,it ITA,GK,32-177,5.0,0,0,0,0,0,0,0,,0,0,0,0,0,0,2,0,Matches,Juventus,Serie-A
1465,Douglas Luiz,br BRA,MF,26-362,5.6,12,8,7,4,1,6,9,66.7,3,4,1,3,2,14,4,0,Matches,Juventus,Serie-A
1466,Jonas Rouhi,se SWE,DF,21-119,2.3,4,1,1,3,0,0,1,0.0,1,2,0,2,3,7,2,0,Matches,Juventus,Serie-A
1467,Alberto costa,pt POR,"DF,MF",21-219,1.6,7,5,5,2,0,2,4,50.0,2,4,0,4,1,8,5,0,Matches,Juventus,Serie-A
1468,Vasilije Adžić,me MNE,"MF,FW",18-359,0.3,2,2,0,1,1,0,1,0.0,1,0,0,0,0,2,0,0,Matches,Juventus,Serie-A
1469,Diego Pugno,it ITA,FW,18-303,0.1,0,0,0,0,0,0,0,,0,0,0,0,0,0,0,0,Matches,Juventus,Serie-A
1470,Lorenzo Anghelè,it ITA,FW,20-069,0.1,0,0,0,0,0,0,0,,0,0,0,0,0,0,0,0,Matches,Juventus,Serie-A
1471,Mattéo Guendouzi,fr FRA,MF,26-021,33.3,34,19,10,19,5,19,43,44.2,24,33,9,24,29,63,47,2,Matches,Lazio,Serie-A
1472,Mattia Zaccagni,it ITA,FW,29-323,28.0,35,25,13,18,4,14,29,48.3,15,16,1,15,28,63,20,2,Matches,Lazio,Serie-A
1473,Ivan Provedel,it ITA,GK,31-049,29.0,0,0,0,0,0,0,0,,0,1,0,1,1,1,12,3,Matches,Lazio,Serie-A
1474,Nicolò Rovella,it ITA,MF,23-152,27.7,77,43,35,35,7,37,70,52.9,33,19,4,15,44,121,43,3,Matches,Lazio,Serie-A
1475,Mario Gila,es ESP,DF,24-249,27.5,51,36,32,17,2,34,49,69.4,15,19,13,6,25,76,106,3,Matches,Lazio,Serie-A
1476,Alessio Romagnoli,it ITA,DF,30-113,26.7,44,28,17,25,2,21,26,80.8,5,28,13,15,23,67,109,1,Matches,Lazio,Serie-A
1477,Gustav Isaksen,dk DEN,FW,24-016,22.9,15,8,6,8,1,6,27,22.2,21,20,2,18,9,24,19,1,Matches,Lazio,Serie-A
1478,Valentín Castellanos,ar ARG,FW,26-214,23.5,13,6,2,4,7,1,10,10.0,9,16,2,14,5,18,21,0,Matches,Lazio,Serie-A
1479,Boulaye Dia,sn SEN,"MF,FW",28-170,21.8,21,9,5,11,5,7,16,43.8,9,12,1,11,5,26,13,1,Matches,Lazio,Serie-A
1480,Adam Marušić,me MNE,DF,32-200,23.8,29,19,16,11,2,16,28,57.1,12,17,7,10,14,43,56,0,Matches,Lazio,Serie-A
1481,Nuno Tavares,pt POR,DF,25-099,17.2,28,21,15,8,5,14,32,43.8,18,18,2,16,19,47,39,1,Matches,Lazio,Serie-A
1482,Manuel Lazzari,it ITA,DF,31-157,15.3,26,16,13,11,2,14,24,58.3,10,9,5,4,10,36,19,0,Matches,Lazio,Serie-A
1483,Fisayo Dele-Bashiru,ng NGA,"MF,FW",24-088,9.9,9,5,3,2,4,2,6,33.3,4,10,2,8,4,13,5,0,Matches,Lazio,Serie-A
1484,Luca Pellegrini,it ITA,DF,26-059,10.7,21,11,10,10,1,16,28,57.1,12,9,2,7,16,37,31,0,Matches,Lazio,Serie-A
1485,Tijjani Noslin,nl NED,"FW,MF",25-302,9.4,6,5,2,1,3,1,8,12.5,7,15,1,14,1,7,7,0,Matches,Lazio,Serie-A
1486,Samuel Gigot,fr FRA,DF,31-205,7.6,4,3,1,3,0,0,1,0.0,1,8,6,2,13,17,36,0,Matches,Lazio,Serie-A
1487,Pedro,es ESP,"FW,MF",37-281,10.9,17,12,4,8,5,9,20,45.0,11,7,0,7,3,20,3,1,Matches,Lazio,Serie-A
1488,Matías Vecino,uy URU,MF,33-254,8.3,12,6,3,8,1,4,18,22.2,14,7,3,4,5,17,11,0,Matches,Lazio,Serie-A
1489,Loum Tchaouna,fr FRA,"FW,MF",21-239,7.3,8,4,2,2,4,3,9,33.3,6,5,1,4,4,12,14,2,Matches,Lazio,Serie-A
1490,Christos Mandas,gr GRE,GK,23-230,6.0,0,0,0,0,0,0,0,,0,0,0,0,0,0,3,0,Matches,Lazio,Serie-A
1491,Patric,es ESP,DF,32-018,6.7,9,6,6,3,0,6,10,60.0,4,3,2,1,3,12,22,1,Matches,Lazio,Serie-A
1492,Elseid Hysaj,al ALB,DF,31-074,3.9,11,6,6,5,0,3,3,100.0,0,3,2,1,4,15,19,0,Matches,Lazio,Serie-A
1493,Nicolò Casale,it ITA,DF,27-080,1.5,5,3,4,1,0,0,0,,0,4,3,1,1,6,2,0,Matches,Lazio,Serie-A
1494,Reda Belahyane,ma MAR,MF,20-338,2.2,8,6,8,0,0,6,6,100.0,0,3,2,1,1,9,5,0,Matches,Lazio,Serie-A
1495,Gaetano Castrovilli,it ITA,"MF,FW",28-077,1.6,5,2,3,1,1,2,4,50.0,2,3,0,3,3,8,1,0,Matches,Lazio,Serie-A
1496,Oliver Nielsen,dk DEN,DF,21-335,0.4,0,0,0,0,0,0,0,,0,1,0,1,1,1,2,0,Matches,Lazio,Serie-A
1497,Arijon Ibrahimović,de GER,MF,19-145,0.1,0,0,0,0,0,0,0,,0,0,0,0,0,0,0,0,Matches,Lazio,Serie-A
1498,Federico Baschirotto,it ITA,DF,28-228,35.0,36,24,29,5,2,21,27,77.8,6,44,32,12,23,59,208,2,Matches,Lecce,Serie-A
1499,Wladimiro Falcone,it ITA,GK,30-024,35.0,0,0,0,0,0,0,0,,0,0,0,0,0,0,28,3,Matches,Lecce,Serie-A
1500,Nikola Krstović,me MNE,FW,25-031,31.4,17,8,4,6,7,6,14,42.9,8,10,6,4,7,24,22,0,Matches,Lecce,Serie-A
1501,Antonino Gallo,it ITA,DF,25-121,26.0,63,41,44,15,4,32,59,54.2,27,29,3,26,20,83,112,0,Matches,Lecce,Serie-A
1502,Frederic Guilbert,fr FRA,DF,30-133,24.6,64,35,29,29,6,35,54,64.8,19,25,8,17,43,107,101,3,Matches,Lecce,Serie-A
1503,Lassana Coulibaly,ml MLI,MF,29-026,26.6,44,26,16,25,3,22,57,38.6,35,40,12,28,16,60,41,1,Matches,Lecce,Serie-A
1504,Kialonda,ao ANG,DF,27-221,21.0,33,12,24,9,0,11,15,73.3,4,41,26,15,26,59,102,1,Matches,Lecce,Serie-A
1505,Tete Morente,es ESP,"FW,MF",28-153,20.9,26,16,10,10,6,10,35,28.6,25,16,1,15,12,38,30,1,Matches,Lecce,Serie-A
1506,Patrick Dorgu,dk DEN,"DF,FW",20-192,20.4,45,27,21,19,5,23,45,51.1,22,24,6,18,18,63,42,2,Matches,Lecce,Serie-A
1507,Santiago Pierotti,ar ARG,FW,24-033,20.1,45,24,21,18,6,22,46,47.8,24,24,5,19,13,58,28,0,Matches,Lecce,Serie-A
1508,Ylber Ramadani,al ALB,MF,29-024,18.8,51,28,24,27,0,33,50,66.0,17,26,9,17,24,75,23,3,Matches,Lecce,Serie-A
1509,Balthazar Pierret,fr FRA,MF,24-356,17.9,47,29,23,21,3,12,28,42.9,16,18,4,14,18,65,31,1,Matches,Lecce,Serie-A
1510,Gaby Jean,fr FRA,DF,25-076,15.4,14,7,8,5,1,6,11,54.5,5,13,10,3,9,23,71,1,Matches,Lecce,Serie-A
1511,Hamza Rafia,tn TUN,MF,26-034,11.8,44,27,14,25,5,15,32,46.9,17,7,2,5,4,48,18,1,Matches,Lecce,Serie-A
1512,Þórir Jóhann Helgason,is ISL,MF,24-220,11.0,10,7,3,6,1,7,11,63.6,4,7,2,5,5,15,10,2,Matches,Lecce,Serie-A
1513,Ante Rebić,hr CRO,"FW,MF",31-227,8.3,10,8,5,3,2,2,8,25.0,6,6,1,5,2,12,4,1,Matches,Lecce,Serie-A
1514,Medon Berisha,al ALB,MF,21-197,7.0,12,8,7,3,2,4,8,50.0,4,5,0,5,10,22,4,2,Matches,Lecce,Serie-A
1515,Lameck Banda,zm ZAM,"FW,MF",24-097,6.4,8,5,4,2,2,3,11,27.3,8,6,0,6,2,10,6,1,Matches,Lecce,Serie-A
1516,Jesper Karlsson,se SWE,FW,26-285,4.9,3,2,3,0,0,2,8,25.0,6,1,0,1,0,3,3,0,Matches,Lecce,Serie-A
1517,Remi Oudin,fr FRA,"MF,FW",28-169,3.3,3,1,1,1,1,2,4,50.0,2,6,2,4,2,5,1,0,Matches,Lecce,Serie-A
1518,Mohamed Kaba,fr FRA,MF,23-191,4.3,12,7,6,5,1,7,8,87.5,1,10,3,7,4,16,9,1,Matches,Lecce,Serie-A
1519,Danilo Veiga,pt POR,DF,22-223,3.4,7,6,4,3,0,5,10,50.0,5,5,0,5,4,11,7,0,Matches,Lecce,Serie-A
1520,Valentin Gendrey,fr FRA,DF,24-319,2.0,2,2,1,0,1,1,1,100.0,0,3,1,2,2,4,1,0,Matches,Lecce,Serie-A
1521,Andy Pelmard,fr FRA,DF,25-055,1.4,6,6,5,1,0,4,4,100.0,0,1,0,1,0,6,5,0,Matches,Lecce,Serie-A
1522,Konan N'dri,ci CIV,"FW,MF",24-191,2.3,2,2,0,0,2,2,3,66.7,1,2,0,2,1,3,0,0,Matches,Lecce,Serie-A
1523,Tiago Gabriel,pt POR,DF,20-131,0.9,0,0,0,0,0,0,0,,0,3,2,1,0,0,5,0,Matches,Lecce,Serie-A
1524,Marco Sala,it ITA,DF,25-336,0.8,1,0,0,1,0,0,1,0.0,1,1,0,1,0,1,0,0,Matches,Lecce,Serie-A
1525,Kevin Bonifazi,it ITA,DF,28-352,0.7,1,1,1,0,0,1,1,100.0,0,1,1,0,2,3,3,0,Matches,Lecce,Serie-A
1526,Nicola Sansone,it ITA,"MF,FW",33-238,0.7,0,0,0,0,0,0,0,,0,0,0,0,0,0,0,0,Matches,Lecce,Serie-A
1527,Rareș-Cătălin Burnete,ro ROU,FW,21-095,0.3,0,0,0,0,0,0,1,0.0,1,0,0,0,0,0,0,0,Matches,Lecce,Serie-A
1528,Filip Marchwiński,pl POL,MF,23-116,0.2,0,0,0,0,0,0,0,,0,0,0,0,0,0,0,0,Matches,Lecce,Serie-A
1529,Mike Maignan,fr FRA,GK,29-307,32.6,0,0,0,0,0,0,1,0.0,1,1,0,1,0,0,17,3,Matches,Milan,Serie-A
1530,Tijjani Reijnders,nl NED,MF,26-281,30.8,23,13,6,12,5,9,24,37.5,15,19,4,15,33,56,25,2,Matches,Milan,Serie-A
1531,Theo Hernández,fr FRA,DF,27-212,28.0,31,24,22,6,3,19,36,52.8,17,25,10,15,15,46,71,3,Matches,Milan,Serie-A
1532,Youssouf Fofana,fr FRA,MF,26-116,27.1,56,34,20,31,5,26,51,51.0,25,30,8,22,19,75,22,3,Matches,Milan,Serie-A
1533,Rafael Leão,pt POR,FW,25-330,24.8,14,9,2,8,4,9,26,34.6,17,13,1,12,6,20,3,0,Matches,Milan,Serie-A
1534,Christian Pulisic,us USA,"FW,MF",26-230,23.7,38,24,14,12,12,13,34,38.2,21,21,2,19,3,41,12,2,Matches,Milan,Serie-A
1535,Matteo Gabbia,it ITA,DF,25-197,20.0,19,13,11,7,1,7,9,77.8,2,22,17,5,13,32,82,1,Matches,Milan,Serie-A
1536,Malick Thiaw,de GER,DF,23-271,19.2,24,17,15,6,3,6,10,60.0,4,14,12,2,15,39,73,1,Matches,Milan,Serie-A
1537,Strahinja Pavlović,rs SRB,DF,23-347,17.0,45,28,26,19,0,24,43,55.8,19,11,5,6,14,59,66,0,Matches,Milan,Serie-A
1538,Yunus Musah,us USA,"MF,FW",22-158,15.7,24,17,10,9,5,9,14,64.3,5,8,1,7,7,31,8,3,Matches,Milan,Serie-A
1539,Emerson,br BRA,DF,26-112,15.3,45,28,24,16,5,16,34,47.1,18,13,2,11,14,59,56,0,Matches,Milan,Serie-A
1540,Fikayo Tomori,eng ENG,DF,27-138,14.7,32,19,17,13,2,12,20,60.0,8,14,10,4,16,48,53,1,Matches,Milan,Serie-A
1541,Álvaro Morata,es ESP,"FW,MF",32-195,12.2,16,10,5,8,3,5,8,62.5,3,7,2,5,5,21,5,0,Matches,Milan,Serie-A
1542,Tammy Abraham,eng ENG,FW,27-216,13.1,17,11,2,10,5,6,8,75.0,2,13,0,13,2,19,16,0,Matches,Milan,Serie-A
1543,Alejandro Jiménez,es ESP,"DF,FW",19-363,11.5,22,13,8,13,1,10,22,45.5,12,19,3,16,12,34,19,0,Matches,Milan,Serie-A
1544,Samuel Chukwueze,ng NGA,"FW,MF",25-349,9.5,14,9,6,4,4,5,17,29.4,12,3,0,3,2,16,8,0,Matches,Milan,Serie-A
1545,Kyle Walker,eng ENG,DF,34-343,6.9,16,8,11,4,1,13,16,81.3,3,9,5,4,8,24,14,1,Matches,Milan,Serie-A
1546,Ruben Loftus-Cheek,eng ENG,MF,29-103,8.0,16,7,4,8,4,5,9,55.6,4,1,0,1,2,18,11,0,Matches,Milan,Serie-A
1547,Santiago Giménez,mx MEX,FW,24-018,6.7,5,3,0,4,1,3,4,75.0,1,3,1,2,1,6,11,0,Matches,Milan,Serie-A
1548,Filippo Terracciano,it ITA,"DF,MF",22-087,6.0,9,6,1,6,2,5,10,50.0,5,1,0,1,6,15,11,0,Matches,Milan,Serie-A
1549,João Félix,pt POR,"MF,FW",25-177,5.6,4,4,1,2,1,3,10,30.0,7,1,0,1,0,4,8,0,Matches,Milan,Serie-A
1550,Noah Okafor,ch SUI,FW,24-347,4.6,2,1,0,0,2,0,1,0.0,1,1,0,1,2,4,1,0,Matches,Milan,Serie-A
1551,Davide Calabria,it ITA,DF,28-151,3.5,10,7,10,0,0,4,7,57.1,3,1,0,1,8,18,8,0,Matches,Milan,Serie-A
1552,Ismaël Bennacer,dz ALG,MF,27-156,3.3,5,4,1,3,1,1,7,14.3,6,5,3,2,3,8,1,0,Matches,Milan,Serie-A
1553,Luka Jović,rs SRB,"FW,MF",27-134,3.9,0,0,0,0,0,0,0,,0,2,1,1,1,1,2,0,Matches,Milan,Serie-A
1554,Warren Bondo,fr FRA,MF,21-233,1.8,5,3,4,1,0,3,3,100.0,0,1,0,1,0,5,2,0,Matches,Milan,Serie-A
1555,Francesco Camarda,it ITA,"FW,MF",17-057,1.8,5,2,0,2,3,2,6,33.3,4,1,1,0,0,5,3,0,Matches,Milan,Serie-A
1556,Marco Sportiello,it ITA,GK,32-361,1.4,0,0,0,0,0,0,0,,0,0,0,0,0,0,1,0,Matches,Milan,Serie-A
1557,Riccardo Sottil,it ITA,"FW,MF",25-337,1.3,1,1,1,0,0,0,0,,0,0,0,0,0,1,0,0,Matches,Milan,Serie-A
1558,Alexis Saelemaekers,be BEL,"DF,FW",25-313,1.0,1,1,0,0,1,1,1,100.0,0,0,0,0,1,2,0,0,Matches,Milan,Serie-A
1559,Mattia Liberali,it ITA,MF,18-030,0.7,2,1,0,1,1,2,2,100.0,0,0,0,0,0,2,0,0,Matches,Milan,Serie-A
1560,Davide Bartesaghi,it ITA,"DF,MF",19-128,0.6,2,1,1,1,0,2,2,100.0,0,1,1,0,2,4,1,0,Matches,Milan,Serie-A
1561,Kevin Zeroli,it ITA,MF,20-115,0.1,1,1,0,1,0,0,0,,0,0,0,0,0,1,0,0,Matches,Milan,Serie-A
1562,Bob Murphy Omoregbe,it ITA,MF,21-182,0.0,0,0,0,0,0,0,0,,0,0,0,0,0,0,0,0,Matches,Milan,Serie-A
1563,Stefano Turati,it ITA,GK,23-243,29.7,0,0,0,0,0,0,1,0.0,1,0,0,0,0,0,21,2,Matches,Monza,Serie-A
1564,Giorgos Kyriakopoulos,gr GRE,DF,29-090,28.7,39,25,18,17,4,27,57,47.4,30,28,10,18,22,61,70,0,Matches,Monza,Serie-A
1565,Pedro Pereira,pt POR,DF,27-104,27.6,50,31,28,17,5,33,53,62.3,20,23,10,13,18,68,75,4,Matches,Monza,Serie-A
1566,Armando Izzo,it ITA,DF,33-065,26.9,40,15,30,9,1,18,36,50.0,18,38,28,10,45,85,100,0,Matches,Monza,Serie-A
1567,Alessandro Bianco,it ITA,MF,22-217,26.2,47,26,23,16,8,25,37,67.6,12,39,14,25,19,66,50,4,Matches,Monza,Serie-A
1568,Dany Mota,pt POR,"FW,MF",27-004,23.0,13,3,2,3,8,4,8,50.0,4,18,1,17,9,22,26,3,Matches,Monza,Serie-A
1569,Andrea Carboni,it ITA,DF,24-091,21.3,54,30,34,16,4,30,48,62.5,18,26,14,12,24,78,93,3,Matches,Monza,Serie-A
1570,Pablo Marí,es ESP,DF,31-248,18.1,26,15,14,12,0,11,21,52.4,10,24,21,3,37,63,85,2,Matches,Monza,Serie-A
1571,Warren Bondo,fr FRA,MF,21-233,18.0,35,24,19,12,4,13,19,68.4,6,16,6,10,5,40,8,4,Matches,Monza,Serie-A
1572,Daniel Maldini,it ITA,"MF,FW",23-207,14.5,14,6,5,9,0,6,13,46.2,7,8,2,6,4,18,12,2,Matches,Monza,Serie-A
1573,Gianluca Caprari,it ITA,"MF,FW",31-280,15.9,19,11,8,8,3,7,13,53.8,6,13,0,13,6,25,2,1,Matches,Monza,Serie-A
1574,Samuele Birindelli,it ITA,"DF,MF",25-291,13.3,17,13,8,4,5,5,12,41.7,7,13,2,11,8,25,25,1,Matches,Monza,Serie-A
1575,Milan Đurić,ba BIH,FW,34-349,14.1,1,1,0,1,0,0,3,0.0,3,6,0,6,2,3,17,0,Matches,Monza,Serie-A
1576,Danilo D'Ambrosio,it ITA,DF,36-239,12.2,28,15,17,10,1,14,23,60.9,9,12,8,4,15,43,36,2,Matches,Monza,Serie-A
1577,Patrick Ciurria,it ITA,"MF,DF",30-086,11.3,22,14,11,7,4,4,11,36.4,7,13,3,10,6,28,19,0,Matches,Monza,Serie-A
1578,Matteo Pessina,it ITA,MF,28-015,9.5,15,4,3,11,1,9,14,64.3,5,6,0,6,12,27,7,0,Matches,Monza,Serie-A
1579,Luca Caldirola,it ITA,DF,34-094,8.5,9,5,7,2,0,3,6,50.0,3,8,6,2,10,19,39,0,Matches,Monza,Serie-A
1580,Jean-Daniel Akpa-Akpro,ci CIV,"MF,DF",32-207,7.7,22,13,11,10,1,7,15,46.7,8,17,4,13,11,33,10,1,Matches,Monza,Serie-A
1581,Gaetano Castrovilli,it ITA,MF,28-078,5.7,12,7,10,2,0,4,10,40.0,6,7,2,5,2,14,9,0,Matches,Monza,Serie-A
1582,Kacper Urbanski,pl POL,MF,20-241,5.6,5,3,1,2,2,4,7,57.1,3,7,2,5,2,7,9,0,Matches,Monza,Serie-A
1583,Keita Baldé,sn SEN,FW,30-059,5.2,1,1,0,1,0,1,2,50.0,1,3,0,3,1,2,0,0,Matches,Monza,Serie-A
1584,Semuel Pizzignacco,it ITA,GK,23-247,5.3,0,0,0,0,0,0,1,0.0,1,0,0,0,0,0,5,0,Matches,Monza,Serie-A
1585,Tomás Palacios,ar ARG,DF,22-008,4.4,11,5,9,2,0,9,13,69.2,4,6,2,4,7,18,12,2,Matches,Monza,Serie-A
1586,Silvère Ganvoula M'Boussy,cg CGO,FW,28-318,3.6,0,0,0,0,0,0,1,0.0,1,1,0,1,1,1,5,0,Matches,Monza,Serie-A
1587,Samuele Vignato,it ITA,MF,21-071,5.2,6,3,0,4,2,3,7,42.9,4,1,0,1,0,6,6,0,Matches,Monza,Serie-A
1588,Stefan Lekovic,rs SRB,DF,21-117,4.1,9,4,6,2,1,5,13,38.5,8,4,4,0,7,16,5,0,Matches,Monza,Serie-A
1589,Kevin Zeroli,it ITA,MF,20-115,3.5,5,1,2,3,0,0,1,0.0,1,6,1,5,2,7,7,0,Matches,Monza,Serie-A
1590,Andrea Petagna,it ITA,FW,29-310,3.3,1,0,0,1,0,1,2,50.0,1,0,0,0,1,2,2,0,Matches,Monza,Serie-A
1591,Stefano Sensi,it ITA,MF,29-274,2.5,8,5,4,4,0,5,6,83.3,1,3,2,1,3,11,2,1,Matches,Monza,Serie-A
1592,Kevin Martins,it ITA,"MF,DF",20-095,2.0,5,4,3,2,0,3,6,50.0,3,1,0,1,1,6,4,1,Matches,Monza,Serie-A
1593,Arvid Brorsson,se SWE,DF,25-363,2.0,4,3,2,2,0,2,2,100.0,0,6,5,1,1,5,18,1,Matches,Monza,Serie-A
1594,Mirko Marić,hr CRO,"FW,MF",29-355,1.2,1,0,1,0,0,1,2,50.0,1,1,1,0,1,2,1,0,Matches,Monza,Serie-A
1595,Roberto Gagliardini,it ITA,"MF,DF",31-029,2.0,3,2,1,2,0,1,4,25.0,3,1,0,1,2,5,4,0,Matches,Monza,Serie-A
1596,Omari Forson,eng ENG,"MF,DF",20-290,1.8,2,2,1,1,0,1,2,50.0,1,3,0,3,0,2,0,0,Matches,Monza,Serie-A
1597,Mattia Valoti,it ITA,MF,31-242,0.4,3,3,3,0,0,0,2,0.0,2,2,0,2,0,3,2,0,Matches,Monza,Serie-A
1598,Amir Rrahmani,xk KVX,DF,31-070,34.8,36,28,18,17,1,15,24,62.5,9,41,24,17,25,61,164,2,Matches,Napoli,Serie-A
1599,Giovanni Di Lorenzo,it ITA,DF,31-274,34.0,65,43,34,25,6,41,63,65.1,22,18,6,12,29,94,76,1,Matches,Napoli,Serie-A
1600,Romelu Lukaku,be BEL,FW,31-357,28.9,4,2,0,2,2,1,4,25.0,3,7,2,5,1,5,15,0,Matches,Napoli,Serie-A
1601,Alex Meret,it ITA,GK,28-044,30.4,0,0,0,0,0,0,0,,0,1,0,1,0,0,16,0,Matches,Napoli,Serie-A
1602,Matteo Politano,it ITA,"FW,MF",31-275,28.6,28,15,17,10,1,14,42,33.3,28,19,1,18,12,40,48,1,Matches,Napoli,Serie-A
1603,Scott McTominay,sct SCO,MF,28-148,29.6,40,23,12,25,3,18,36,50.0,18,19,4,15,23,63,47,0,Matches,Napoli,Serie-A
1604,Stanislav Lobotka,sk SVK,MF,30-161,29.2,46,30,16,20,10,18,29,62.1,11,29,11,18,21,67,57,1,Matches,Napoli,Serie-A
1605,Andre-Frank Zambo Anguissa,cm CMR,MF,29-170,28.8,40,25,7,28,5,14,33,42.4,19,19,6,13,32,72,36,1,Matches,Napoli,Serie-A
1606,Mathías Olivera,uy URU,DF,27-186,23.3,60,33,31,23,6,30,48,62.5,18,32,9,23,28,88,63,0,Matches,Napoli,Serie-A
1607,Alessandro Buongiorno,it ITA,DF,25-333,21.4,39,23,26,12,1,24,32,75.0,8,30,18,12,35,74,73,2,Matches,Napoli,Serie-A
1608,Khvicha Kvaratskhelia,ge GEO,"FW,MF",24-082,13.1,15,9,4,10,1,4,15,26.7,11,13,0,13,4,19,7,0,Matches,Napoli,Serie-A
1609,Leonardo Spinazzola,it ITA,"DF,FW",32-041,14.0,13,10,6,5,2,8,19,42.1,11,10,1,9,8,21,27,1,Matches,Napoli,Serie-A
1610,David Neres,br BRA,FW,28-063,13.6,18,10,7,4,7,8,13,61.5,5,6,0,6,7,25,4,0,Matches,Napoli,Serie-A
1611,Juan Jesus,br BRA,DF,33-329,11.9,25,14,16,9,0,12,20,60.0,8,15,3,12,9,34,42,0,Matches,Napoli,Serie-A
1612,Billy Gilmour,sct SCO,MF,23-328,10.5,19,11,8,6,5,8,16,50.0,8,6,1,5,6,25,18,0,Matches,Napoli,Serie-A
1613,Giacomo Raspadori,it ITA,"FW,MF",25-076,9.7,15,7,6,9,0,8,12,66.7,4,10,2,8,2,17,10,0,Matches,Napoli,Serie-A
1614,Pasquale Mazzocchi,it ITA,"DF,FW",29-282,7.7,15,7,7,5,3,8,15,53.3,7,5,2,3,5,20,24,0,Matches,Napoli,Serie-A
1615,Elia Caprile,it ITA,GK,23-253,3.6,0,0,0,0,0,0,0,,0,0,0,0,0,0,2,0,Matches,Napoli,Serie-A
1616,Giovanni Simeone,ar ARG,FW,29-304,4.4,2,0,0,1,1,1,6,16.7,5,9,2,7,1,3,6,0,Matches,Napoli,Serie-A
1617,Cyril Ngonge,be BEL,FW,24-344,2.2,8,5,4,4,0,4,6,66.7,2,3,0,3,1,9,4,0,Matches,Napoli,Serie-A
1618,Philip Billing,dk DEN,MF,28-328,1.8,9,6,4,4,1,1,2,50.0,1,4,1,3,4,13,5,0,Matches,Napoli,Serie-A
1619,Rafa Marín,es ESP,DF,22-351,1.6,1,0,1,0,0,1,2,50.0,1,1,1,0,1,2,4,0,Matches,Napoli,Serie-A
1620,Simone Scuffet,it ITA,GK,28-339,1.0,0,0,0,0,0,0,0,,0,0,0,0,0,0,2,0,Matches,Napoli,Serie-A
1621,Noah Okafor,ch SUI,"FW,MF",24-346,0.4,3,2,3,0,0,2,2,100.0,0,0,0,0,0,3,1,0,Matches,Napoli,Serie-A
1622,Michael Folorunsho,it ITA,"FW,MF",27-087,0.4,3,2,0,3,0,2,4,50.0,2,0,0,0,1,4,1,1,Matches,Napoli,Serie-A
1623,Walid Cheddira,ma MAR,FW,27-103,0.1,0,0,0,0,0,0,0,,0,0,0,0,0,0,0,0,Matches,Napoli,Serie-A
1624,Alessio Zerbin,it ITA,"FW,DF",26-063,0.0,2,1,2,0,0,1,1,100.0,0,0,0,0,0,2,0,0,Matches,Napoli,Serie-A
1625,Zion Suzuki,jp JPN,GK,22-258,33.8,1,0,1,0,0,1,2,50.0,1,0,0,0,0,1,29,4,Matches,Parma,Serie-A
1626,Simon Sohm,ch SUI,MF,24-025,30.6,27,16,10,13,4,15,33,45.5,18,7,1,6,24,51,33,0,Matches,Parma,Serie-A
1627,Emanuele Valeri,it ITA,DF,26-150,29.5,49,30,32,14,3,29,59,49.2,30,27,9,18,27,76,98,4,Matches,Parma,Serie-A
1628,Enrico Del Prato,it ITA,DF,25-177,29.7,31,17,22,8,1,19,24,79.2,5,67,34,33,18,49,125,2,Matches,Parma,Serie-A
1629,Ange-Yoan Bonny,fr FRA,FW,21-193,25.3,29,13,3,21,5,8,14,57.1,6,17,2,15,3,32,16,0,Matches,Parma,Serie-A
1630,Dennis Man,ro ROU,"FW,MF",26-253,22.2,13,6,7,3,3,6,24,25.0,18,15,3,12,8,21,11,0,Matches,Parma,Serie-A
1631,Botond Balogh,hu HUN,DF,22-334,20.7,28,11,18,10,0,16,22,72.7,6,32,24,8,24,52,130,2,Matches,Parma,Serie-A
1632,Mandela Keita,be BEL,MF,22-361,18.2,39,21,10,23,6,17,31,54.8,14,14,5,9,19,58,24,2,Matches,Parma,Serie-A
1633,Matteo Cancellieri,it ITA,"FW,MF",23-083,15.8,26,16,15,9,2,11,32,34.4,21,15,1,14,13,39,30,0,Matches,Parma,Serie-A
1634,Adrian Bernabe,es ESP,MF,23-345,15.1,28,18,16,8,4,14,30,46.7,16,22,9,13,6,34,24,1,Matches,Parma,Serie-A
1635,Lautaro Valenti,ar ARG,DF,26-112,16.0,16,12,12,3,1,6,6,100.0,0,24,12,12,11,27,90,1,Matches,Parma,Serie-A
1636,Valentin Mihaila,ro ROU,"FW,MF",25-093,14.3,29,15,8,13,8,9,22,40.9,13,18,0,18,8,37,6,0,Matches,Parma,Serie-A
1637,Hernani,br BRA,MF,31-040,13.1,40,22,22,14,4,22,42,52.4,20,24,5,19,18,58,11,1,Matches,Parma,Serie-A
1638,Woyo Coulibaly,fr FRA,DF,25-351,12.0,13,10,9,2,2,5,11,45.5,6,19,2,17,8,21,25,0,Matches,Parma,Serie-A
1639,Giovanni Leoni,it ITA,DF,18-136,11.6,12,5,8,4,0,3,4,75.0,1,17,8,9,15,27,50,1,Matches,Parma,Serie-A
1640,Pontus Almqvist,se SWE,"FW,MF",25-300,12.4,17,13,7,7,3,8,17,47.1,9,13,0,13,19,36,8,0,Matches,Parma,Serie-A
1641,Alessandro Vogliacco,it ITA,DF,26-234,8.6,5,2,5,0,0,3,5,60.0,2,15,10,5,3,8,37,0,Matches,Parma,Serie-A
1642,Antoine Hainaut,fr FRA,"DF,MF",23-077,11.6,25,14,14,8,3,9,13,69.2,4,13,3,10,12,37,52,0,Matches,Parma,Serie-A
1643,Nahuel Estévez,ar ARG,MF,29-173,7.2,14,5,6,7,1,5,14,35.7,9,9,2,7,3,17,25,0,Matches,Parma,Serie-A
1644,Mateo Pellegrino,ar ARG,FW,24-066,5.5,2,1,1,1,0,1,3,33.3,2,4,1,3,0,2,6,0,Matches,Parma,Serie-A
1645,Alessandro Circati,au AUS,DF,21-208,4.0,4,2,3,1,0,1,1,100.0,0,5,4,1,2,6,29,1,Matches,Parma,Serie-A
1646,Mohamed Haj,tn TUN,MF,20-041,5.0,3,1,2,1,0,1,2,50.0,1,3,1,2,4,7,5,0,Matches,Parma,Serie-A
1647,Milan Đurić,ba BIH,FW,34-349,2.6,0,0,0,0,0,0,2,0.0,2,3,0,3,0,0,1,0,Matches,Parma,Serie-A
1648,Jacob Ondrejka,se SWE,"MF,FW",22-246,3.5,7,3,3,4,0,6,8,75.0,2,2,0,2,7,14,2,0,Matches,Parma,Serie-A
1649,Adrian Benedyczak,pl POL,"FW,MF",24-163,2.4,0,0,0,0,0,0,1,0.0,1,3,1,2,0,0,8,0,Matches,Parma,Serie-A
1650,Yordan Osorio,ve VEN,DF,30-361,1.9,5,3,4,1,0,2,2,100.0,0,3,1,2,4,9,6,1,Matches,Parma,Serie-A
1651,Drissa Camara,ci CIV,"MF,FW",23-077,4.6,9,7,2,6,1,1,9,11.1,8,7,0,7,3,12,1,0,Matches,Parma,Serie-A
1652,Leandro Chichizola,ar ARG,GK,35-040,1.0,0,0,0,0,0,0,0,,0,0,0,0,0,0,2,0,Matches,Parma,Serie-A
1653,Mateusz Kowalski,pl POL,MF,19-289,0.6,0,0,0,0,0,0,0,,0,1,0,1,0,0,1,0,Matches,Parma,Serie-A
1654,Gabriel Charpentier,cg CGO,FW,25-354,3.0,4,3,2,1,1,3,4,75.0,1,3,0,3,0,4,9,0,Matches,Parma,Serie-A
1655,Mathias Løvik,no NOR,"DF,FW",21-151,1.0,1,0,0,1,0,1,2,50.0,1,1,1,0,2,3,3,0,Matches,Parma,Serie-A
1656,Wylan Cyprien,fr FRA,MF,30-098,0.3,0,0,0,0,0,0,1,0.0,1,1,0,1,1,1,0,0,Matches,Parma,Serie-A
1657,Obite N'Dicka,ci CIV,DF,25-259,35.0,30,24,15,15,0,12,18,66.7,6,42,27,15,32,62,140,1,Matches,Roma,Serie-A
1658,Mile Svilar,rs SRB,GK,25-252,35.0,0,0,0,0,0,0,0,,0,0,0,0,0,0,11,2,Matches,Roma,Serie-A
1659,Angeliño,es ESP,DF,28-122,32.3,45,23,19,24,2,17,34,50.0,17,32,9,23,26,71,92,0,Matches,Roma,Serie-A
1660,Gianluca Mancini,it ITA,DF,29-019,31.9,39,23,22,15,2,19,32,59.4,13,19,13,6,34,73,89,0,Matches,Roma,Serie-A
1661,Manu Koné,fr FRA,MF,23-354,25.6,36,22,15,15,6,17,38,44.7,21,24,4,20,19,55,23,0,Matches,Roma,Serie-A
1662,Artem Dovbyk,ua UKR,FW,27-319,25.9,4,2,0,1,3,0,4,0.0,4,9,3,6,2,6,12,0,Matches,Roma,Serie-A
1663,Zeki Çelik,tr TUR,DF,28-078,22.1,56,34,20,28,8,21,38,55.3,17,24,6,18,12,68,77,2,Matches,Roma,Serie-A
1664,Bryan Cristante,it ITA,MF,30-064,19.7,43,26,15,22,6,14,25,56.0,11,17,9,8,16,59,31,1,Matches,Roma,Serie-A
1665,Lorenzo Pellegrini,it ITA,MF,28-321,18.1,24,16,5,13,6,8,19,42.1,11,8,1,7,6,30,22,0,Matches,Roma,Serie-A
1666,Matìas Soulé,ar ARG,"MF,FW",22-021,16.9,23,15,10,6,7,9,21,42.9,12,24,3,21,8,31,22,0,Matches,Roma,Serie-A
1667,Paulo Dybala,ar ARG,"FW,MF",31-172,15.7,17,7,3,9,5,8,19,42.1,11,12,1,11,2,19,2,0,Matches,Roma,Serie-A
1668,Alexis Saelemaekers,be BEL,"DF,FW",25-313,13.5,30,17,21,6,3,16,30,53.3,14,12,1,11,7,37,8,1,Matches,Roma,Serie-A
1669,Leandro Paredes,ar ARG,MF,30-311,13.4,25,14,9,11,5,15,29,51.7,14,13,4,9,19,44,29,1,Matches,Roma,Serie-A
1670,Stephan El Shaarawy,it ITA,"DF,MF",32-191,11.8,16,12,4,6,6,6,12,50.0,6,4,0,4,10,26,13,0,Matches,Roma,Serie-A
1671,Niccolò Pisilli,it ITA,MF,20-225,13.5,23,10,10,8,5,12,22,54.5,10,14,3,11,11,34,16,0,Matches,Roma,Serie-A
1672,Mats Hummels,de GER,DF,36-141,10.2,30,15,16,14,0,11,18,61.1,7,12,4,8,26,56,43,0,Matches,Roma,Serie-A
1673,Eldor Shomurodov,uz UZB,"FW,MF",29-311,9.5,11,4,2,6,3,3,5,60.0,2,8,0,8,2,13,2,0,Matches,Roma,Serie-A
1674,Tommaso Baldanzi,it ITA,"MF,FW",22-044,9.1,12,4,5,4,3,4,12,33.3,8,4,0,4,6,18,8,0,Matches,Roma,Serie-A
1675,Nicola Zalewski,pl POL,"DF,FW",23-103,5.9,8,6,3,2,3,2,7,28.6,5,7,2,5,4,12,8,2,Matches,Roma,Serie-A
1676,Devyne Rensch,nl NED,DF,22-108,4.2,15,11,7,7,1,9,10,90.0,1,4,2,2,5,20,10,1,Matches,Roma,Serie-A
1677,Enzo Le Fée,fr FRA,MF,25-092,3.5,7,4,5,2,0,2,6,33.3,4,9,3,6,5,12,2,0,Matches,Roma,Serie-A
1678,Mario Hermoso,es ESP,DF,29-322,2.8,2,1,2,0,0,0,1,0.0,1,1,1,0,4,6,13,0,Matches,Roma,Serie-A
1679,Lucas Gourna-Douath,fr FRA,MF,21-274,2.4,9,4,5,4,0,2,6,33.3,4,1,1,0,0,9,2,0,Matches,Roma,Serie-A
1680,Saud Abdulhamid,sa KSA,DF,25-292,2.3,3,2,2,0,1,1,1,100.0,0,2,0,2,2,5,0,0,Matches,Roma,Serie-A
1681,Anass Salah-Eddine,nl NED,DF,23-108,1.7,1,1,1,0,0,0,0,,0,0,0,0,1,2,2,2,Matches,Roma,Serie-A
1682,Victor Nelsson,dk DEN,DF,26-204,2.1,5,4,3,1,1,3,5,60.0,2,1,0,1,2,7,9,0,Matches,Roma,Serie-A
1683,Samuel Dahl,se SWE,"DF,MF",25-063,0.5,2,2,0,2,0,1,2,50.0,1,2,0,2,0,2,0,0,Matches,Roma,Serie-A
1684,Tammy Abraham,eng ENG,FW,27-216,0.0,0,0,0,0,0,0,1,0.0,1,0,0,0,0,0,0,0,Matches,Roma,Serie-A
1685,Vanja Milinković-Savić,rs SRB,GK,28-074,34.0,1,0,1,0,0,1,3,33.3,2,0,0,0,0,1,17,4,Matches,Torino,Serie-A
1686,Saúl Coco,gq EQG,DF,26-085,31.6,46,26,31,14,1,19,30,63.3,11,49,31,18,38,84,157,4,Matches,Torino,Serie-A
1687,Samuele Ricci,it ITA,MF,23-257,29.0,32,18,15,12,5,18,26,69.2,8,21,9,12,25,57,49,2,Matches,Torino,Serie-A
1688,Che Adams,sct SCO,FW,28-296,26.5,10,5,1,4,5,0,4,0.0,4,10,5,5,2,12,17,0,Matches,Torino,Serie-A
1689,Guillermo Maripán,cl CHI,DF,30-364,23.0,35,20,21,13,1,19,31,61.3,12,25,12,13,38,73,130,1,Matches,Torino,Serie-A
1690,Valentino Lazaro,at AUT,"DF,FW",29-042,23.0,25,11,10,12,3,15,28,53.6,13,28,5,23,10,35,38,1,Matches,Torino,Serie-A
1691,Nikola Vlašić,hr CRO,"MF,FW",27-213,20.7,34,17,10,16,8,11,29,37.9,18,13,3,10,9,43,13,0,Matches,Torino,Serie-A
1692,Sebastian Walukiewicz,pl POL,DF,25-030,18.2,38,20,18,16,4,23,31,74.2,8,21,8,13,18,56,58,0,Matches,Torino,Serie-A
1693,Karol Linetty,pl POL,MF,30-092,16.9,39,23,17,19,3,20,41,48.8,21,14,5,9,12,51,31,1,Matches,Torino,Serie-A
1694,Adam Masina,ma MAR,DF,31-123,18.5,32,15,22,9,1,22,37,59.5,15,25,15,10,24,56,83,2,Matches,Torino,Serie-A
1695,Antonio Sanabria,py PAR,FW,29-062,14.4,3,3,1,1,1,1,4,25.0,3,6,1,5,1,4,13,0,Matches,Torino,Serie-A
1696,Marcus Pedersen,no NOR,DF,24-293,15.1,12,8,6,5,1,9,15,60.0,6,11,2,9,13,25,34,1,Matches,Torino,Serie-A
1697,Borna Sosa,hr CRO,DF,27-104,13.1,26,19,14,7,5,16,25,64.0,9,13,6,7,14,40,33,0,Matches,Torino,Serie-A
1698,Gvidas Gineitis,lt LTU,MF,21-020,14.2,24,14,8,10,6,13,25,52.0,12,16,6,10,14,38,29,0,Matches,Torino,Serie-A
1699,Mërgim Vojvoda,xk KVX,DF,30-093,12.3,18,10,5,9,4,7,14,50.0,7,13,3,10,7,25,24,1,Matches,Torino,Serie-A
1700,Cesare Casadei,it ITA,"MF,FW",22-115,9.3,10,4,4,6,0,5,9,55.6,4,3,2,1,5,15,20,0,Matches,Torino,Serie-A
1701,Yann Karamoh,fr FRA,"MF,FW",26-301,11.6,5,2,2,1,2,4,9,44.4,5,10,2,8,3,8,5,0,Matches,Torino,Serie-A
1702,Cristiano Biraghi,it ITA,DF,32-246,9.9,12,9,8,2,2,7,12,58.3,5,10,3,7,8,20,36,0,Matches,Torino,Serie-A
1703,Elif Elmas,mk MKD,"FW,MF",25-223,9.5,8,5,3,5,0,4,7,57.1,3,7,2,5,6,14,5,2,Matches,Torino,Serie-A
1704,Ivan Ilić,rs SRB,MF,24-049,9.9,5,2,0,4,1,2,6,33.3,4,0,0,0,5,10,9,0,Matches,Torino,Serie-A
1705,Adrien Tameze,cm CMR,"MF,DF",31-090,7.2,5,2,2,3,0,1,10,10.0,9,8,5,3,10,15,8,1,Matches,Torino,Serie-A
1706,Duván Zapata,co COL,FW,34-034,6.5,7,5,2,0,5,0,3,0.0,3,2,1,1,2,9,7,0,Matches,Torino,Serie-A
1707,Ali Dembélé,fr FRA,DF,21-120,2.0,6,4,3,3,0,4,4,100.0,0,1,1,0,0,6,6,1,Matches,Torino,Serie-A
1708,Alberto Paleari,it ITA,GK,32-249,1.0,0,0,0,0,0,0,0,,0,0,0,0,0,0,2,0,Matches,Torino,Serie-A
1709,Raoul Bellanova,it ITA,DF,24-353,1.0,0,0,0,0,0,0,1,0.0,1,0,0,0,0,0,4,0,Matches,Torino,Serie-A
1710,Eybi Nije,se SWE,"FW,MF",19-356,4.4,5,1,3,1,1,0,3,0.0,3,5,1,4,0,5,1,0,Matches,Torino,Serie-A
1711,Sergiu Perciun,md MDA,"FW,MF",19-012,0.7,0,0,0,0,0,0,0,,0,2,0,2,0,0,1,0,Matches,Torino,Serie-A
1712,Saba Sazonov,ge GEO,DF,23-093,0.0,0,0,0,0,0,0,0,,0,1,1,0,0,0,0,0,Matches,Torino,Serie-A
1713,Aaron Ciammaglichella,it ITA,MF,20-099,0.0,0,0,0,0,0,0,0,,0,0,0,0,0,0,0,0,Matches,Torino,Serie-A
1714,Jesper Karlström,se SWE,MF,29-319,32.4,57,31,30,19,8,25,50,50.0,25,27,11,16,34,91,78,4,Matches,Udinese,Serie-A
1715,Jaka Bijol,si SVN,DF,26-090,32.0,43,25,32,10,1,21,38,55.3,17,37,18,19,37,80,178,1,Matches,Udinese,Serie-A
1716,Sandi Lovrić,si SVN,MF,27-039,24.5,45,29,24,17,4,22,43,51.2,21,33,5,28,22,67,25,1,Matches,Udinese,Serie-A
1717,Kingsley Ehizibue,nl NED,DF,29-346,25.8,52,33,30,18,4,25,39,64.1,14,36,11,25,21,73,62,5,Matches,Udinese,Serie-A
1718,Lorenzo Lucca,it ITA,FW,24-238,24.8,9,6,2,2,5,4,10,40.0,6,18,1,17,6,15,24,0,Matches,Udinese,Serie-A
1719,Florian Thauvin,fr FRA,"FW,MF",32-100,21.7,20,14,9,8,3,10,25,40.0,15,6,0,6,7,27,10,0,Matches,Udinese,Serie-A
1720,Hassane Kamara,ci CIV,DF,31-062,20.9,33,24,19,11,3,14,26,53.8,12,22,5,17,26,59,45,1,Matches,Udinese,Serie-A
1721,Maduka Okoye,ng NGA,GK,25-251,22.0,0,0,0,0,0,0,0,,0,0,0,0,0,0,11,1,Matches,Udinese,Serie-A
1722,Jurgen Ekkelenkamp,nl NED,MF,25-031,18.9,35,24,10,21,4,17,32,53.1,15,25,4,21,12,47,22,0,Matches,Udinese,Serie-A
1723,Thomas Kristensen,dk DEN,DF,23-109,17.5,29,19,14,11,4,19,26,73.1,7,17,13,4,18,47,68,2,Matches,Udinese,Serie-A
1724,Oumar Solet,fr FRA,DF,25-088,15.6,31,18,17,12,2,19,26,73.1,7,27,15,12,15,46,66,3,Matches,Udinese,Serie-A
1725,Martín Payero,ar ARG,MF,26-237,14.7,23,15,4,13,6,8,16,50.0,8,13,2,11,11,34,13,0,Matches,Udinese,Serie-A
1726,Jordan Zemura,zw ZIM,DF,25-173,14.0,25,13,13,9,3,13,24,54.2,11,16,3,13,15,40,37,0,Matches,Udinese,Serie-A
1727,Razvan Sava,ro ROU,GK,22-319,12.0,0,0,0,0,0,0,0,,0,0,0,0,0,0,6,2,Matches,Udinese,Serie-A
1728,Lautaro Gianetti,ar ARG,DF,31-174,9.6,22,10,16,5,1,14,20,70.0,6,20,10,10,15,37,46,1,Matches,Udinese,Serie-A
1729,Souleymane Touré,fr FRA,DF,22-039,8.1,7,6,4,3,0,4,5,80.0,1,15,6,9,9,16,17,1,Matches,Udinese,Serie-A
1730,Arthur Atta,fr FRA,"MF,FW",22-112,12.2,19,11,9,9,1,10,15,66.7,5,6,4,2,7,26,15,1,Matches,Udinese,Serie-A
1731,Christian Kabasele,be BEL,DF,34-071,11.1,13,8,6,7,0,7,9,77.8,2,10,4,6,11,24,53,1,Matches,Udinese,Serie-A
1732,Keinan Davis,eng ENG,FW,27-082,9.9,8,3,1,4,3,3,5,60.0,2,2,1,1,1,9,5,0,Matches,Udinese,Serie-A
1733,Oier Zarraga,es ESP,MF,26-122,8.0,14,9,7,7,0,8,19,42.1,11,6,3,3,2,16,7,0,Matches,Udinese,Serie-A
1734,Brenner,br BRA,"MF,FW",25-110,4.3,6,4,2,3,1,3,8,37.5,5,4,0,4,1,7,6,0,Matches,Udinese,Serie-A
1735,Alexis Sánchez,cl CHI,FW,36-138,4.1,3,1,0,2,1,1,5,20.0,4,4,0,4,3,6,0,1,Matches,Udinese,Serie-A
1736,Iker Bravo,es ESP,"FW,MF",20-113,7.2,9,5,2,5,2,4,8,50.0,4,3,0,3,1,10,4,0,Matches,Udinese,Serie-A
1737,Rui Modesto,ao ANG,"DF,MF",25-211,5.4,15,11,4,8,3,7,8,87.5,1,9,0,9,8,23,11,0,Matches,Udinese,Serie-A
1738,Nehuén Pérez,ar ARG,DF,24-316,2.0,1,1,0,0,1,0,1,0.0,1,2,2,0,1,2,7,0,Matches,Udinese,Serie-A
1739,Daniele Padelli,it ITA,GK,39-193,1.0,0,0,0,0,0,0,1,0.0,1,0,0,0,0,0,0,0,Matches,Udinese,Serie-A
1740,Simone Pafundi,it ITA,"MF,DF",19-081,1.1,3,3,2,0,1,1,4,25.0,3,0,0,0,0,3,1,0,Matches,Udinese,Serie-A
1741,Enzo Ebosse,cm CMR,DF,26-056,1.0,0,0,0,0,0,0,2,0.0,2,3,3,0,1,1,1,0,Matches,Udinese,Serie-A
1742,James Abankwah,ie IRL,"DF,MF",21-110,1.0,4,2,4,0,0,2,3,66.7,1,2,1,1,1,5,3,0,Matches,Udinese,Serie-A
1743,Damián Pizarro,cl CHI,"FW,MF",20-039,0.2,0,0,0,0,0,0,0,,0,0,0,0,0,0,0,0,Matches,Udinese,Serie-A
1744,Jay Idzes,id IDN,DF,24-338,32.7,45,29,24,17,4,17,32,53.1,15,49,29,20,30,75,153,0,Matches,Venezia,Serie-A
1745,Hans Nicolussi Caviglia,it ITA,MF,24-322,28.8,43,26,14,21,8,28,62,45.2,34,37,11,26,27,70,53,2,Matches,Venezia,Serie-A
1746,Gaetano Oristanio,it ITA,"FW,MF",22-220,24.3,17,13,5,8,4,7,15,46.7,8,16,0,16,6,23,6,1,Matches,Venezia,Serie-A
1747,Gianluca Busio,us USA,MF,22-343,26.0,45,31,24,12,9,20,47,42.6,27,32,8,24,18,63,49,0,Matches,Venezia,Serie-A
1748,Mikael Ellertsson,is ISL,"DF,MF",23-056,24.7,51,24,33,11,7,29,54,53.7,25,39,4,35,13,64,71,0,Matches,Venezia,Serie-A
1749,Joel Pohjanpalo,fi FIN,FW,30-235,17.8,3,3,1,2,0,0,4,0.0,4,7,4,3,4,7,24,0,Matches,Venezia,Serie-A
1750,Francesco Zampano,it ITA,DF,31-218,17.9,30,20,19,9,2,14,28,50.0,14,20,0,20,6,36,28,2,Matches,Venezia,Serie-A
1751,Filip Stankovic,rs SRB,GK,23-070,15.2,0,0,0,0,0,0,0,,0,0,0,0,0,0,11,2,Matches,Venezia,Serie-A
1752,Michael Svoboda,at AUT,DF,26-203,14.6,26,14,19,6,1,8,19,42.1,11,19,11,8,22,48,66,2,Matches,Venezia,Serie-A
1753,Fali Candé,gw GNB,DF,27-102,14.0,21,17,12,8,1,13,19,68.4,6,15,10,5,12,33,72,2,Matches,Venezia,Serie-A
1754,Alessio Zerbin,it ITA,DF,26-064,14.0,49,28,28,12,9,27,49,55.1,22,26,3,23,13,62,22,0,Matches,Venezia,Serie-A
1755,Ridgeciano Haps,sr SUR,DF,31-328,14.2,26,15,18,6,2,11,18,61.1,7,16,3,13,6,32,45,0,Matches,Venezia,Serie-A
1756,Ionuț Radu,ro ROU,GK,27-343,12.0,0,0,0,0,0,0,0,,0,0,0,0,0,0,7,0,Matches,Venezia,Serie-A
1757,Antonio Candela,it ITA,DF,25-009,11.2,31,21,13,11,7,18,26,69.2,8,7,5,2,8,39,22,2,Matches,Venezia,Serie-A
1758,Alfred Duncan,gh GHA,MF,32-057,10.6,17,8,4,11,2,5,14,35.7,9,7,2,5,8,25,8,0,Matches,Venezia,Serie-A
1759,Marin Šverko,hr CRO,DF,27-091,11.6,17,6,11,6,0,8,10,80.0,2,9,4,5,16,33,42,3,Matches,Venezia,Serie-A
1760,Kike Pérez,es ESP,MF,28-081,10.4,36,21,16,10,10,17,41,41.5,24,12,1,11,8,44,12,0,Matches,Venezia,Serie-A
1761,Joël Schingtienne,be BEL,DF,22-267,9.7,20,12,15,4,1,10,16,62.5,6,15,7,8,11,31,18,3,Matches,Venezia,Serie-A
1762,Issa Doumbia,ci CIV,MF,21-202,9.3,13,8,5,7,1,7,15,46.7,8,15,4,11,7,20,13,0,Matches,Venezia,Serie-A
1763,John Yeboah,ec ECU,"FW,MF",24-317,11.0,4,3,1,2,1,0,9,0.0,9,4,0,4,4,8,2,0,Matches,Venezia,Serie-A
1764,Giorgio Altare,it ITA,DF,26-270,8.4,13,12,8,3,2,8,15,53.3,7,21,11,10,17,30,49,0,Matches,Venezia,Serie-A
1765,Jesse Joronen,fi FIN,GK,32-046,7.8,0,0,0,0,0,0,0,,0,0,0,0,0,0,4,1,Matches,Venezia,Serie-A
1766,Magnus Kofod Andersen,dk DEN,MF,25-361,7.7,13,4,3,9,1,4,10,40.0,6,7,2,5,6,19,12,0,Matches,Venezia,Serie-A
1767,Christian Gytkjær,dk DEN,FW,35-000,7.5,6,4,2,2,2,1,2,50.0,1,2,1,1,0,6,8,0,Matches,Venezia,Serie-A
1768,Daniel Fila,cz CZE,FW,22-258,4.7,2,0,0,1,1,0,2,0.0,2,5,0,5,0,2,5,0,Matches,Venezia,Serie-A
1769,Alessandro Marcandalli,it ITA,DF,22-223,3.8,7,5,5,2,0,2,5,40.0,3,6,3,3,2,9,26,0,Matches,Venezia,Serie-A
1770,Mirko Marić,hr CRO,FW,29-355,3.5,2,2,2,0,0,0,3,0.0,3,2,0,2,1,3,10,0,Matches,Venezia,Serie-A
1771,Franco Carboni,it ITA,DF,22-032,2.5,5,3,5,0,0,5,8,62.5,3,1,1,0,0,5,11,0,Matches,Venezia,Serie-A
1772,Richie Sagrado,be BEL,DF,21-096,1.6,2,2,1,1,0,1,1,100.0,0,1,0,1,3,5,4,0,Matches,Venezia,Serie-A
1773,Bjarki Bjarkason,is ISL,"DF,MF",24-360,1.8,3,2,2,1,0,1,2,50.0,1,1,0,1,2,5,4,0,Matches,Venezia,Serie-A
1774,Cheick Oumar Conde,gn GUI,MF,24-284,1.6,6,5,3,2,1,2,5,40.0,3,7,2,5,4,10,3,0,Matches,Venezia,Serie-A
1775,Domen Črnigoj,si SVN,MF,29-169,1.5,4,2,0,1,3,1,2,50.0,1,5,2,3,4,8,4,0,Matches,Venezia,Serie-A
1776,Antonio Raimondo,it ITA,"FW,DF",21-049,1.0,2,1,1,1,0,0,0,,0,0,0,0,0,2,0,1,Matches,Venezia,Serie-A
1777,Nicholas Pierini,it ITA,MF,26-273,0.9,0,0,0,0,0,0,1,0.0,1,2,0,2,0,0,0,0,Matches,Venezia,Serie-A
1778,Saad El Haddad,ma MAR,MF,19-286,0.3,0,0,0,0,0,0,0,,0,0,0,0,0,0,0,0,Matches,Venezia,Serie-A
1779,Nunzio Lella,it ITA,MF,24-282,0.1,0,0,0,0,0,0,0,,0,0,0,0,0,0,0,0,Matches,Venezia,Serie-A
1780,Yahia Fofana,ci CIV,GK,24-258,32.0,0,0,0,0,0,0,2,0.0,2,0,0,0,1,1,23,2,Matches,Angers,Ligue-1
1781,Jordan Lefort,fr FRA,DF,31-270,32.0,52,30,42,9,1,30,44,68.2,14,51,32,19,30,82,202,3,Matches,Angers,Ligue-1
1782,Himad Abdelli,dz ALG,"MF,FW",25-170,29.6,45,31,11,20,14,14,44,31.8,30,22,1,21,23,68,25,2,Matches,Angers,Ligue-1
1783,Florent Hanin,dz ALG,DF,35-091,27.7,59,43,38,14,7,30,58,51.7,28,29,10,19,47,106,92,2,Matches,Angers,Ligue-1
1784,Jean-Eudes Aholou,ci CIV,MF,31-047,21.8,56,36,26,20,10,22,48,45.8,26,34,14,20,33,89,32,0,Matches,Angers,Ligue-1
1785,Carlens Arcus,ht HAI,DF,28-312,20.7,48,33,29,14,5,31,53,58.5,22,23,4,19,25,73,74,2,Matches,Angers,Ligue-1
1786,Farid El Melali,dz ALG,FW,28-001,20.5,27,15,15,6,6,12,31,38.7,19,18,1,17,16,43,12,1,Matches,Angers,Ligue-1
1787,Jim Allevinah,ga GAB,FW,30-068,18.6,17,10,5,8,4,4,26,15.4,22,9,0,9,11,28,17,0,Matches,Angers,Ligue-1
1788,Haris Belkebla,dz ALG,MF,31-098,19.9,56,38,38,15,3,26,45,57.8,19,30,9,21,35,91,46,1,Matches,Angers,Ligue-1
1789,Abdoulaye Bamba,ci CIV,DF,35-011,16.8,22,12,17,4,1,14,19,73.7,5,14,8,6,19,41,79,0,Matches,Angers,Ligue-1
1790,Esteban Lepaul,fr FRA,FW,25-018,16.2,10,5,2,5,3,4,15,26.7,11,13,2,11,3,13,10,0,Matches,Angers,Ligue-1
1791,Yassin Belkhdim,fr FRA,MF,23-081,15.9,52,27,25,21,6,26,56,46.4,30,22,6,16,20,72,39,1,Matches,Angers,Ligue-1
1792,Emmanuel Biumla,fr FRA,DF,19-363,14.6,19,12,14,5,0,12,18,66.7,6,18,8,10,8,27,83,1,Matches,Angers,Ligue-1
1793,Lilian Raolisoa,fr FRA,"DF,FW",24-324,12.9,39,23,24,13,2,17,37,45.9,20,11,2,9,14,53,44,0,Matches,Angers,Ligue-1
1794,Ibrahima Niane,sn SEN,FW,26-056,10.5,7,3,3,2,2,3,3,100.0,0,6,1,5,2,9,6,2,Matches,Angers,Ligue-1
1795,Zinedine Ferhat,dz ALG,"FW,MF",32-066,9.4,9,7,1,5,3,4,13,30.8,9,9,0,9,10,19,12,0,Matches,Angers,Ligue-1
1796,Jacques Ekomie,ga GAB,DF,21-260,6.9,21,14,9,9,3,7,11,63.6,4,15,4,11,4,25,14,0,Matches,Angers,Ligue-1
1797,Bamba Dieng,sn SEN,FW,25-044,5.9,4,1,1,2,1,0,2,0.0,2,2,0,2,0,4,3,0,Matches,Angers,Ligue-1
1798,Pierrick Capelle,fr FRA,MF,38-021,5.4,24,17,10,9,5,9,18,50.0,9,4,1,3,11,35,5,1,Matches,Angers,Ligue-1
1799,Sidiki Cherif,fr FRA,FW,18-142,3.6,5,5,1,3,1,3,4,75.0,1,4,1,3,0,5,0,1,Matches,Angers,Ligue-1
1800,Cédric Hountondji,bj BEN,DF,31-107,3.0,6,4,4,2,0,3,7,42.9,4,3,3,0,4,10,14,0,Matches,Angers,Ligue-1
1801,Zinédine Ould Khaled,fr FRA,MF,25-112,3.0,8,6,5,2,1,2,12,16.7,10,4,0,4,2,10,8,0,Matches,Angers,Ligue-1
1802,Marius Courcoul,fr FRA,"MF,DF",18-125,1.6,3,1,2,1,0,1,3,33.3,2,2,0,2,3,6,5,0,Matches,Angers,Ligue-1
1803,Ousmane Camara,fr FRA,DF,22-061,1.0,1,0,1,0,0,1,1,100.0,0,0,0,0,0,1,7,0,Matches,Angers,Ligue-1
1804,Justin-Noël Kalumba,fr FRA,"FW,MF",20-132,0.3,0,0,0,0,0,0,0,,0,0,0,0,1,1,1,0,Matches,Angers,Ligue-1
1805,Lois Diony,fr FRA,FW,32-137,0.2,0,0,0,0,0,0,0,,0,0,0,0,0,0,0,0,Matches,Angers,Ligue-1
1806,Prosper Peter,ng NGA,MF,17-270,0.2,2,1,0,2,0,0,0,,0,0,0,0,0,2,0,0,Matches,Angers,Ligue-1
1807,Donovan Léon,gf GUF,GK,32-184,30.0,0,0,0,0,0,0,2,0.0,2,2,0,2,0,0,22,1,Matches,Auxerre,Ligue-1
1808,Jubal,br BRA,DF,31-250,28.3,58,38,46,11,1,27,39,69.2,12,60,35,25,24,82,191,1,Matches,Auxerre,Ligue-1
1809,Gaëtan Perrin,fr FRA,"MF,FW",28-333,28.0,49,26,22,12,15,21,46,45.7,25,10,0,10,12,61,4,1,Matches,Auxerre,Ligue-1
1810,Clément Akpa,ci CIV,DF,23-163,25.8,54,34,35,12,7,31,46,67.4,15,38,14,24,40,94,134,2,Matches,Auxerre,Ligue-1
1811,Elisha Owusu,gh GHA,MF,27-180,24.3,71,39,27,39,5,31,46,67.4,15,33,9,24,41,112,34,1,Matches,Auxerre,Ligue-1
1812,Ki-Jana Hoever,nl NED,DF,23-108,22.7,48,35,25,15,8,28,52,53.8,24,33,3,30,20,68,68,1,Matches,Auxerre,Ligue-1
1813,Gideon Mensah,gh GHA,DF,26-292,23.3,60,39,29,21,10,28,57,49.1,29,26,4,22,46,106,77,0,Matches,Auxerre,Ligue-1
1814,Hamed Junior Traorè,ci CIV,MF,25-079,21.7,41,20,11,17,13,16,53,30.2,37,14,0,14,6,47,11,0,Matches,Auxerre,Ligue-1
1815,Lassine Sinayoko,ml MLI,"FW,MF",25-149,23.7,32,19,10,13,9,11,22,50.0,11,16,2,14,11,43,38,0,Matches,Auxerre,Ligue-1
1816,Sinaly Diomande,ci CIV,DF,24-027,19.6,35,18,17,17,1,24,34,70.6,10,36,18,18,27,62,92,2,Matches,Auxerre,Ligue-1
1817,Gabriel Osho,ng NGA,DF,26-265,17.4,22,14,16,3,3,12,19,63.2,7,30,17,13,12,34,79,0,Matches,Auxerre,Ligue-1
1818,Kévin Danois,fr FRA,MF,20-312,16.2,49,30,20,22,7,20,46,43.5,26,17,3,14,20,69,20,0,Matches,Auxerre,Ligue-1
1819,Theo Bair,ca CAN,FW,25-252,10.4,4,3,1,2,1,0,2,0.0,2,6,2,4,3,7,10,0,Matches,Auxerre,Ligue-1
1820,Ado Onaiwu,jp JPN,"MF,FW",29-179,10.4,10,7,2,5,3,4,14,28.6,10,12,0,12,3,13,12,0,Matches,Auxerre,Ligue-1
1821,Paul Joly,fr FRA,DF,24-333,10.1,46,30,29,15,2,25,41,61.0,16,17,1,16,24,70,30,5,Matches,Auxerre,Ligue-1
1822,Han-Noah Massengo,fr FRA,MF,23-303,9.7,14,9,5,5,4,7,10,70.0,3,9,3,6,14,28,9,2,Matches,Auxerre,Ligue-1
1823,Rayan Raveloson,mg MAD,"MF,DF",28-110,8.0,6,5,2,4,0,5,15,33.3,10,8,7,1,5,11,22,0,Matches,Auxerre,Ligue-1
1824,Assane Dioussé,sn SEN,MF,27-228,7.1,14,7,8,5,1,5,14,35.7,9,6,2,4,12,26,14,0,Matches,Auxerre,Ligue-1
1825,Florian Ayé,fr FRA,FW,28-107,6.1,2,2,0,0,2,0,2,0.0,2,7,0,7,7,9,6,0,Matches,Auxerre,Ligue-1
1826,Fredrik Oppegard,no NOR,DF,22-272,2.8,6,4,4,1,1,3,7,42.9,4,2,1,1,1,7,12,1,Matches,Auxerre,Ligue-1
1827,Théo De Percin,mq MTQ,GK,24-093,2.0,0,0,0,0,0,0,1,0.0,1,0,0,0,0,0,3,0,Matches,Auxerre,Ligue-1
1828,Rudy Matondo,fr FRA,MF,17-054,0.7,1,1,1,0,0,0,1,0.0,1,0,0,0,0,1,2,0,Matches,Auxerre,Ligue-1
1829,Théo Pellenard,fr FRA,DF,31-063,0.5,3,2,2,1,0,1,3,33.3,2,1,0,1,0,3,3,0,Matches,Auxerre,Ligue-1
1830,Lasso Coulibaly,gh GHA,"FW,MF",22-199,0.4,0,0,0,0,0,0,0,,0,0,0,0,0,0,0,0,Matches,Auxerre,Ligue-1
1831,Aristide Zossou,ci CIV,MF,19-326,0.2,0,0,0,0,0,0,0,,0,0,0,0,0,0,0,0,Matches,Auxerre,Ligue-1
1832,Eros Maddy,nl NED,DF,24-090,0.2,0,0,0,0,0,0,0,,0,0,0,0,0,0,0,0,Matches,Auxerre,Ligue-1
1833,Loïc N'Gatta,fr FRA,DF,21-146,0.1,1,1,0,1,0,1,2,50.0,1,1,0,1,0,1,1,0,Matches,Auxerre,Ligue-1
1834,Yoann Cissé,fr FRA,MF,20-144,0.1,0,0,0,0,0,0,0,,0,0,0,0,1,1,0,0,Matches,Auxerre,Ligue-1
1835,Ben Viadere,fr FRA,MF,19-246,0.1,0,0,0,0,0,0,0,,0,0,0,0,0,0,0,0,Matches,Auxerre,Ligue-1
1836,Marco Bizot,nl NED,GK,34-057,30.0,2,1,2,0,0,1,1,100.0,0,0,0,0,0,2,27,0,Matches,Brest,Ligue-1
1837,Mahdi Camara,fr FRA,"MF,FW",26-310,27.5,68,37,14,37,17,23,45,51.1,22,39,4,35,32,100,28,0,Matches,Brest,Ligue-1
1838,Kenny Lala,mg MAD,DF,33-215,27.8,64,40,35,23,6,36,55,65.5,19,24,9,15,25,89,70,1,Matches,Brest,Ligue-1
1839,Brendan Chardonnet,fr FRA,DF,30-135,26.8,45,33,28,14,3,25,40,62.5,15,45,28,17,29,74,169,2,Matches,Brest,Ligue-1
1840,Ludovic Ajorque,fr FRA,FW,31-070,25.8,25,18,3,11,11,9,31,29.0,22,19,5,14,6,31,22,0,Matches,Brest,Ligue-1
1841,Hugo Magnetti,fr FRA,MF,26-341,23.8,43,26,17,22,4,20,45,44.4,25,18,3,15,15,58,34,0,Matches,Brest,Ligue-1
1842,Massadio Haïdara,ml MLI,DF,32-155,17.7,25,15,15,9,1,12,27,44.4,15,15,2,13,23,48,70,0,Matches,Brest,Ligue-1
1843,Abdoulaye Niakhate Ndiaye,sn SEN,DF,23-026,17.0,40,28,29,11,0,20,30,66.7,10,25,15,10,8,48,132,2,Matches,Brest,Ligue-1
1844,Pierre Lees-Melou,fr FRA,MF,31-346,16.1,48,33,20,19,9,25,53,47.2,28,17,3,14,10,58,23,0,Matches,Brest,Ligue-1
1845,Mathias Pereira Lage,pt POR,"FW,MF",28-157,15.8,36,24,16,13,7,17,35,48.6,18,16,2,14,18,54,17,2,Matches,Brest,Ligue-1
1846,Julien Le Cardinal,fr FRA,DF,27-276,15.3,27,15,16,8,3,11,16,68.8,5,18,14,4,33,60,75,0,Matches,Brest,Ligue-1
1847,Abdallah Sima,sn SEN,"FW,MF",23-323,13.2,14,10,2,4,8,4,10,40.0,6,8,0,8,1,15,9,0,Matches,Brest,Ligue-1
1848,Romain Del Castillo,fr FRA,FW,29-038,12.9,29,21,9,12,8,18,31,58.1,13,16,0,16,6,35,4,0,Matches,Brest,Ligue-1
1849,Mama Samba Baldé,gw GNB,FW,29-181,12.7,12,8,4,3,5,3,14,21.4,11,8,0,8,6,18,14,0,Matches,Brest,Ligue-1
1850,Kamory Doumbia,ml MLI,"MF,FW",22-077,13.1,35,23,15,16,4,12,28,42.9,16,15,1,14,25,60,13,1,Matches,Brest,Ligue-1
1851,Edimilson Fernandes,ch SUI,MF,29-021,10.3,8,6,2,6,0,6,10,60.0,4,13,5,8,17,25,27,1,Matches,Brest,Ligue-1
1852,Romain Faivre,fr FRA,"MF,FW",26-296,10.0,13,10,4,5,4,5,10,50.0,5,8,0,8,4,17,3,1,Matches,Brest,Ligue-1
1853,Jordan Amavi,fr FRA,DF,31-058,8.8,24,17,10,11,3,15,21,71.4,6,10,2,8,7,31,18,0,Matches,Brest,Ligue-1
1854,Luc Zogbé,ci CIV,DF,20-043,7.1,32,18,17,11,4,18,26,69.2,8,11,2,9,14,46,22,1,Matches,Brest,Ligue-1
1855,Jonas Martin,fr FRA,MF,35-027,5.4,12,6,9,2,1,5,10,50.0,5,4,1,3,8,20,12,1,Matches,Brest,Ligue-1
1856,Soumaïla Coulibaly,fr FRA,DF,21-204,4.9,4,2,2,2,0,1,1,100.0,0,7,2,5,5,9,26,0,Matches,Brest,Ligue-1
1857,Ibrahim Salah,ma MAR,FW,23-249,4.0,4,2,1,1,2,1,6,16.7,5,2,0,2,2,6,0,0,Matches,Brest,Ligue-1
1858,Grégoire Coudert,fr FRA,GK,26-033,2.0,0,0,0,0,0,0,0,,0,0,0,0,0,0,1,0,Matches,Brest,Ligue-1
1859,Justin Bourgault,fr FRA,DF,19-234,1.4,2,1,1,1,0,0,0,,0,0,0,0,0,2,1,0,Matches,Brest,Ligue-1
1860,Jérémy Le Douaron,fr FRA,FW,27-015,1.1,1,0,0,0,1,0,1,0.0,1,1,0,1,0,1,0,0,Matches,Brest,Ligue-1
1861,Axel Camblan,fr FRA,"MF,FW",21-249,0.3,1,1,0,0,1,1,2,50.0,1,1,0,1,0,1,0,0,Matches,Brest,Ligue-1
1862,Hianga Mananga Mbock,fr FRA,MF,25-129,0.2,0,0,0,0,0,0,0,,0,0,0,0,1,1,0,0,Matches,Brest,Ligue-1
1863,Hamidou Makalou,ml MLI,"FW,MF",18-295,0.2,0,0,0,0,0,0,0,,0,0,0,0,0,0,0,0,Matches,Brest,Ligue-1
1864,Sérigné Diop,sn SEN,FW,19-359,0.0,1,0,0,1,0,0,0,,0,1,0,1,0,1,0,0,Matches,Brest,Ligue-1
1865,Gautier Lloris,fr FRA,DF,29-292,29.8,67,43,51,16,0,38,53,71.7,15,33,21,12,31,98,186,0,Matches,Le-Havre,Ligue-1
1866,Loïc Nego,hu HUN,"DF,FW",34-111,25.3,52,30,32,15,5,36,57,63.2,21,17,3,14,28,80,81,0,Matches,Le-Havre,Ligue-1
1867,Abdoulaye Touré,gn GUI,MF,31-064,23.8,60,34,30,21,9,32,53,60.4,21,35,18,17,31,91,40,5,Matches,Le-Havre,Ligue-1
1868,Etienne Youte Kinkoue,fr FRA,DF,23-112,23.8,18,9,10,7,1,12,18,66.7,6,34,21,13,28,46,153,3,Matches,Le-Havre,Ligue-1
1869,Yassine Kechta,ma MAR,"MF,FW",23-070,21.3,53,30,29,17,7,27,65,41.5,38,24,2,22,21,74,28,2,Matches,Le-Havre,Ligue-1
1870,Josué Casimir,fr FRA,"FW,MF",23-224,20.2,35,25,15,14,6,9,17,52.9,8,18,0,18,7,42,34,1,Matches,Le-Havre,Ligue-1
1871,Issa Soumaré,sn SEN,"FW,MF",24-208,19.1,22,12,7,10,5,10,42,23.8,32,17,4,13,16,38,28,0,Matches,Le-Havre,Ligue-1
1872,Arthur Desmas,fr FRA,GK,31-029,18.0,0,0,0,0,0,0,1,0.0,1,0,0,0,0,0,9,1,Matches,Le-Havre,Ligue-1
1873,Mathieu Gorgelin,fr FRA,GK,34-274,14.0,2,2,2,0,0,2,3,66.7,1,0,0,0,0,2,8,2,Matches,Le-Havre,Ligue-1
1874,Arouna Sangante,sn SEN,DF,23-024,12.1,21,14,10,11,0,9,14,64.3,5,10,5,5,21,42,57,1,Matches,Le-Havre,Ligue-1
1875,André Ayew,gh GHA,FW,35-140,14.5,17,9,3,6,8,7,12,58.3,5,9,2,7,3,20,21,1,Matches,Le-Havre,Ligue-1
1876,Christopher Operi,ci CIV,"DF,FW",28-007,13.0,13,9,6,2,5,7,12,58.3,5,20,6,14,14,27,30,0,Matches,Le-Havre,Ligue-1
1877,Timothee Pembele,fr FRA,DF,22-239,11.8,30,22,17,9,4,14,23,60.9,9,16,5,11,11,41,41,0,Matches,Le-Havre,Ligue-1
1878,Oussama Targhalline,ma MAR,MF,22-351,11.0,19,14,12,3,4,5,12,41.7,7,14,7,7,19,38,14,2,Matches,Le-Havre,Ligue-1
1879,Rassoul Ndiaye,sn SEN,MF,23-146,11.8,35,25,19,12,4,11,25,44.0,14,15,4,11,12,47,24,0,Matches,Le-Havre,Ligue-1
1880,Junior Mwanga,fr FRA,MF,21-360,9.6,25,15,9,13,3,11,19,57.9,8,8,2,6,8,33,17,1,Matches,Le-Havre,Ligue-1
1881,Koka,eg EGY,FW,32-062,9.1,4,1,1,3,0,0,4,0.0,4,2,0,2,3,7,6,1,Matches,Le-Havre,Ligue-1
1882,Yanis Zouaoui,dz ALG,"DF,FW",30-300,10.7,18,8,9,7,2,11,15,73.3,4,15,2,13,8,26,43,0,Matches,Le-Havre,Ligue-1
1883,Antoine Joujou,fr FRA,"MF,FW",22-055,10.4,16,11,10,4,2,9,15,60.0,6,15,3,12,9,25,19,0,Matches,Le-Havre,Ligue-1
1884,Yoann Salmier,gf GUF,DF,32-166,8.9,14,7,9,4,1,10,13,76.9,3,12,8,4,10,24,59,0,Matches,Le-Havre,Ligue-1
1885,Emmanuel Sabbi,us USA,"FW,MF",27-133,7.3,14,7,7,4,3,5,8,62.5,3,2,0,2,3,17,4,0,Matches,Le-Havre,Ligue-1
1886,Fodé Ballo-Touré,sn SEN,DF,28-123,5.1,8,7,3,4,1,5,8,62.5,3,5,1,4,2,10,23,0,Matches,Le-Havre,Ligue-1
1887,Daler Kuzyaev,ru RUS,MF,32-111,6.3,13,8,7,4,2,2,9,22.2,7,7,4,3,9,22,8,0,Matches,Le-Havre,Ligue-1
1888,Mahamadou Diawara,fr FRA,MF,20-078,6.3,20,12,10,8,2,8,13,61.5,5,13,6,7,13,33,11,1,Matches,Le-Havre,Ligue-1
1889,Ilyes Housni,fr FRA,"FW,MF",19-357,2.6,7,5,2,3,2,2,4,50.0,2,2,0,2,1,8,2,0,Matches,Le-Havre,Ligue-1
1890,Steve Ngoura,fr FRA,FW,20-073,3.2,4,2,1,1,2,3,3,100.0,0,2,1,1,0,4,2,0,Matches,Le-Havre,Ligue-1
1891,Samuel Grandsir,fr FRA,"MF,FW",28-265,0.9,5,5,0,3,2,2,3,66.7,1,2,0,2,0,5,0,0,Matches,Le-Havre,Ligue-1
1892,Elysée Logbo,fr FRA,FW,21-000,0.3,0,0,0,0,0,0,0,,0,0,0,0,0,0,0,0,Matches,Le-Havre,Ligue-1
1893,Mathéo Bodmer,fr FRA,MF,21-000,0.1,0,0,0,0,0,0,0,,0,0,0,0,0,0,1,0,Matches,Le-Havre,Ligue-1
1894,Kandet Diawara,gn GUI,FW,25-085,0.0,0,0,0,0,0,0,0,,0,1,0,1,0,0,1,0,Matches,Le-Havre,Ligue-1
1895,Alois Confais,fr FRA,MF,28-241,0.0,0,0,0,0,0,0,0,,0,0,0,0,0,0,0,0,Matches,Le-Havre,Ligue-1
1896,Adrien Thomasson,fr FRA,MF,31-147,27.2,86,46,42,24,20,51,91,56.0,40,42,3,39,18,104,28,2,Matches,Lens,Ligue-1
1897,Facundo Medina,ar ARG,DF,25-343,26.3,42,27,21,17,4,23,37,62.2,14,30,10,20,31,73,64,0,Matches,Lens,Ligue-1
1898,Andy Diouf,fr FRA,MF,21-354,22.8,36,25,10,21,5,15,36,41.7,21,22,1,21,13,49,17,2,Matches,Lens,Ligue-1
1899,Jonathan Gradit,fr FRA,DF,32-163,21.5,42,22,21,18,3,21,37,56.8,16,25,11,14,24,66,107,2,Matches,Lens,Ligue-1
1900,Florian Sotoca,fr FRA,"FW,MF",34-193,19.7,22,13,3,8,11,12,22,54.5,10,12,2,10,13,35,25,0,Matches,Lens,Ligue-1
1901,Deiver Machado,co COL,"DF,MF",31-246,19.3,35,25,14,13,8,16,29,55.2,13,19,3,16,15,50,33,2,Matches,Lens,Ligue-1
1902,M'Bala Nzola,ao ANG,FW,28-261,16.2,5,4,0,1,4,3,9,33.3,6,9,1,8,5,10,7,0,Matches,Lens,Ligue-1
1903,Przemysław Frankowski,pl POL,DF,30-024,15.4,32,21,17,10,5,19,30,63.3,11,10,2,8,19,51,28,0,Matches,Lens,Ligue-1
1904,Neil El Aynaoui,fr FRA,MF,23-308,15.7,37,21,17,14,6,11,32,34.4,21,34,8,26,25,62,28,0,Matches,Lens,Ligue-1
1905,Malang Sarr,fr FRA,DF,26-103,15.4,21,13,12,6,3,16,27,59.3,11,18,9,9,22,43,63,3,Matches,Lens,Ligue-1
1906,Brice Samba,fr FRA,GK,31-011,15.0,0,0,0,0,0,0,0,,0,0,0,0,1,1,6,2,Matches,Lens,Ligue-1
1907,Anass Zaroury,ma MAR,"FW,MF",24-180,14.4,20,15,4,11,5,9,24,37.5,15,8,0,8,4,24,15,0,Matches,Lens,Ligue-1
1908,Kevin Danso,at AUT,DF,26-229,12.0,19,7,12,5,2,12,16,75.0,4,25,19,6,20,39,62,1,Matches,Lens,Ligue-1
1909,Mathew Ryan,au AUS,GK,33-028,12.0,1,0,1,0,0,1,2,50.0,1,0,0,0,1,2,1,2,Matches,Lens,Ligue-1
1910,Ruben Aguilar,fr FRA,"DF,MF",32-010,11.6,34,18,17,12,5,24,38,63.2,14,23,3,20,13,47,22,0,Matches,Lens,Ligue-1
1911,Angelo Fulgini,fr FRA,"MF,FW",28-259,11.6,14,10,6,4,4,6,16,37.5,10,11,1,10,2,16,3,0,Matches,Lens,Ligue-1
1912,Abdukodir Khusanov,uz UZB,DF,21-066,10.8,15,11,9,5,1,7,11,63.6,4,17,11,6,26,41,57,0,Matches,Lens,Ligue-1
1913,Wesley Saïd,fr FRA,FW,30-017,9.9,15,11,2,10,3,5,12,41.7,7,6,0,6,2,17,2,0,Matches,Lens,Ligue-1
1914,Goduine Koyalipou,cf CTA,FW,25-080,8.1,2,1,0,2,0,0,0,,0,3,0,3,1,3,7,0,Matches,Lens,Ligue-1
1915,Jhoanner Chávez,ec ECU,"DF,MF",23-011,6.6,9,5,4,4,1,2,7,28.6,5,10,1,9,6,15,13,0,Matches,Lens,Ligue-1
1916,Rémy Labeau Lascary,gp GLP,"FW,MF",22-064,7.1,16,10,7,6,3,5,11,45.5,6,5,0,5,1,17,7,0,Matches,Lens,Ligue-1
1917,Juma Bah,sl SLE,DF,19-025,5.6,13,9,4,9,0,5,7,71.4,2,10,7,3,15,28,39,0,Matches,Lens,Ligue-1
1918,Hervé Koffi,bf BFA,GK,28-202,5.0,1,1,1,0,0,1,1,100.0,0,0,0,0,0,1,5,0,Matches,Lens,Ligue-1
1919,Nampalys Mendy,sn SEN,MF,32-317,4.5,9,6,3,4,2,4,10,40.0,6,7,2,5,6,15,6,0,Matches,Lens,Ligue-1
1920,David Costa,pt POR,"MF,FW",24-121,3.9,2,0,1,1,0,1,4,25.0,3,5,1,4,1,3,0,0,Matches,Lens,Ligue-1
1921,Kyllian Antonio,fr FRA,"DF,MF",17-122,1.5,3,2,2,0,1,1,3,33.3,2,3,0,3,3,6,3,1,Matches,Lens,Ligue-1
1922,Hamzat Ojediran,ng NGA,"MF,FW",21-173,4.6,28,15,12,13,3,7,19,36.8,12,10,2,8,10,38,7,0,Matches,Lens,Ligue-1
1923,Jeremy Agbonifo,se SWE,"FW,MF",19-194,3.3,7,6,6,0,1,3,7,42.9,4,2,1,1,1,8,0,1,Matches,Lens,Ligue-1
1924,Tom Pouilly,fr FRA,"DF,MF",21-322,2.0,4,3,1,1,2,2,5,40.0,3,5,1,4,3,7,9,0,Matches,Lens,Ligue-1
1925,Martin Satriano,uy URU,"FW,DF",24-075,0.7,3,1,1,1,1,3,3,100.0,0,0,0,0,0,3,2,0,Matches,Lens,Ligue-1
1926,Rayan Fofana,fr FRA,"FW,MF",19-083,0.3,2,2,1,1,0,0,0,,0,0,0,0,0,2,0,0,Matches,Lens,Ligue-1
1927,Gabin Capuano,fr FRA,FW,19-010,0.1,0,0,0,0,0,0,0,,0,0,0,0,0,0,0,0,Matches,Lens,Ligue-1
1928,Kembo Diliwidi,fr FRA,DF,19-092,0.0,0,0,0,0,0,0,0,,0,0,0,0,0,0,0,0,Matches,Lens,Ligue-1
1929,Lucas Chevalier,fr FRA,GK,23-180,32.0,3,2,3,0,0,3,4,75.0,1,0,0,0,0,3,12,4,Matches,Lille,Ligue-1
1930,Bafodé Diakité,fr FRA,DF,24-119,29.7,31,18,17,11,3,18,26,69.2,8,30,17,13,27,58,96,5,Matches,Lille,Ligue-1
1931,Benjamin André,fr FRA,MF,34-275,28.9,102,57,30,60,12,53,93,57.0,40,42,6,36,48,150,54,0,Matches,Lille,Ligue-1
1932,Alexsandro Ribeiro,br BRA,DF,25-269,28.0,31,18,18,12,1,20,30,66.7,10,23,13,10,25,56,135,3,Matches,Lille,Ligue-1
1933,Jonathan David,ca CAN,FW,25-111,26.6,20,5,3,10,7,8,19,42.1,11,13,2,11,4,24,9,1,Matches,Lille,Ligue-1
1934,Thomas Meunier,be BEL,DF,33-235,19.4,51,36,31,14,6,32,47,68.1,15,19,7,12,31,82,61,0,Matches,Lille,Ligue-1
1935,Gabriel Gudmundsson,se SWE,DF,26-006,18.8,34,23,13,15,6,21,34,61.8,13,18,7,11,15,49,39,3,Matches,Lille,Ligue-1
1936,Aïssa Mandi,dz ALG,DF,33-195,18.3,31,17,12,15,4,16,22,72.7,6,23,11,12,14,45,50,0,Matches,Lille,Ligue-1
1937,Hákon Arnar Haraldsson,is ISL,"MF,FW",22-025,17.8,33,15,9,15,9,14,31,45.2,17,9,1,8,7,40,4,0,Matches,Lille,Ligue-1
1938,André Gomes,pt POR,MF,31-279,14.2,27,13,9,11,7,11,31,35.5,20,7,1,6,6,33,11,2,Matches,Lille,Ligue-1
1939,Ngal'Ayel Mukau,cd COD,MF,20-156,12.5,31,17,9,20,2,16,26,61.5,10,12,0,12,14,45,21,0,Matches,Lille,Ligue-1
1940,Mitchel Bakker,nl NED,"FW,DF",24-319,12.3,23,13,6,11,6,10,17,58.8,7,10,1,9,11,34,15,0,Matches,Lille,Ligue-1
1941,Edon Zhegrova,xk KVX,"FW,MF",26-035,10.9,5,2,3,0,2,2,7,28.6,5,8,0,8,4,9,1,0,Matches,Lille,Ligue-1
1942,Rémy Cabella,fr FRA,"FW,MF",35-058,10.0,34,18,15,10,9,18,31,58.1,13,9,1,8,8,42,4,0,Matches,Lille,Ligue-1
1943,Osame Sahraoui,ma MAR,"FW,MF",23-328,14.0,12,9,3,4,5,3,8,37.5,5,13,1,12,7,19,8,1,Matches,Lille,Ligue-1
1944,Ayyoub Bouaddi,fr FRA,MF,17-215,11.6,48,30,21,20,7,18,31,58.1,13,10,3,7,10,58,11,1,Matches,Lille,Ligue-1
1945,Matias Fernandez-Pardo,be BEL,"FW,MF",20-091,10.1,11,8,3,5,3,6,11,54.5,5,9,0,9,2,13,6,0,Matches,Lille,Ligue-1
1946,Angel Gomes,eng ENG,MF,24-247,8.2,10,6,4,4,2,2,12,16.7,10,0,0,0,0,10,2,0,Matches,Lille,Ligue-1
1947,Ismaily,br BRA,DF,35-114,9.1,31,16,17,11,3,15,23,65.2,8,15,1,14,11,42,43,0,Matches,Lille,Ligue-1
1948,Chuba Akpom,eng ENG,FW,29-208,6.3,8,5,0,4,4,2,6,33.3,4,8,0,8,0,8,3,0,Matches,Lille,Ligue-1
1949,Tiago Santos,pt POR,DF,22-286,4.5,12,7,4,5,3,6,9,66.7,3,2,0,2,2,14,4,0,Matches,Lille,Ligue-1
1950,Mohamed Lamine Bayo,gn GUI,FW,26-335,3.4,1,1,0,0,1,1,1,100.0,0,0,0,0,0,1,4,0,Matches,Lille,Ligue-1
1951,Nabil Bentaleb,dz ALG,MF,30-162,2.7,4,3,2,0,2,3,6,50.0,3,2,0,2,4,8,6,1,Matches,Lille,Ligue-1
1952,Ethan Mbappé,fr FRA,"MF,FW",18-127,2.5,6,2,3,2,1,0,4,0.0,4,6,0,6,1,7,0,0,Matches,Lille,Ligue-1
1953,Younes Lachaab,fr FRA,"MF,FW",20-119,0.1,1,1,0,0,1,1,1,100.0,0,0,0,0,1,2,0,0,Matches,Lille,Ligue-1
1954,Ousmane Toure,fr FRA,DF,20-076,0.1,0,0,0,0,0,0,0,,0,0,0,0,1,1,2,0,Matches,Lille,Ligue-1
1955,Aaron Malouda,fr FRA,FW,19-156,0.0,0,0,0,0,0,0,0,,0,0,0,0,0,0,0,0,Matches,Lille,Ligue-1
1956,Lucas Perri,br BRA,GK,27-147,31.0,1,1,1,0,0,0,4,0.0,4,1,0,1,0,1,20,1,Matches,Lyon,Ligue-1
1957,Moussa Niakhate,sn SEN,DF,29-059,28.3,44,25,35,7,2,21,28,75.0,7,22,14,8,24,68,131,3,Matches,Lyon,Ligue-1
1958,Corentin Tolisso,fr FRA,MF,30-276,25.7,57,25,21,26,10,34,65,52.3,31,52,13,39,22,79,41,1,Matches,Lyon,Ligue-1
1959,Clinton Mata,ao ANG,DF,32-180,26.1,41,29,23,14,4,28,36,77.8,8,26,17,9,46,87,72,3,Matches,Lyon,Ligue-1
1960,Nemanja Matić,rs SRB,MF,36-278,21.4,38,29,12,20,6,21,39,53.8,18,19,8,11,17,55,30,1,Matches,Lyon,Ligue-1
1961,Alexandre Lacazette,fr FRA,FW,33-343,20.9,13,6,3,7,3,5,15,33.3,10,12,2,10,8,21,6,0,Matches,Lyon,Ligue-1
1962,Rayan Cherki,fr FRA,"FW,MF",21-262,21.4,14,11,3,7,4,5,26,19.2,21,6,0,6,7,21,6,0,Matches,Lyon,Ligue-1
1963,Nicolás Tagliafico,ar ARG,DF,32-248,19.1,52,34,23,19,10,26,42,61.9,16,25,7,18,32,84,47,0,Matches,Lyon,Ligue-1
1964,Ainsley Maitland-Niles,eng ENG,DF,27-250,20.1,64,41,27,23,14,44,69,63.8,25,28,4,24,24,88,52,6,Matches,Lyon,Ligue-1
1965,Jordan Veretout,fr FRA,MF,32-066,15.4,26,13,13,11,2,16,38,42.1,22,15,2,13,5,31,23,1,Matches,Lyon,Ligue-1
1966,Duje Ćaleta-Car,hr CRO,DF,28-231,15.9,18,10,10,8,0,9,17,52.9,8,29,23,6,16,34,89,2,Matches,Lyon,Ligue-1
1967,Malick Fofana,be BEL,FW,20-036,15.7,19,9,8,9,2,7,15,46.7,8,12,0,12,8,27,6,0,Matches,Lyon,Ligue-1
1968,Georges Mikautadze,ge GEO,FW,24-187,15.8,7,6,1,3,3,3,9,33.3,6,11,0,11,4,11,5,0,Matches,Lyon,Ligue-1
1969,Ernest Nuamah,gh GHA,"FW,MF",21-186,11.7,21,11,15,4,2,12,27,44.4,15,9,1,8,8,29,8,1,Matches,Lyon,Ligue-1
1970,Abner,br BRA,DF,24-344,12.1,29,20,12,10,7,21,32,65.6,11,15,2,13,5,34,41,0,Matches,Lyon,Ligue-1
1971,Sael Kumbedi,fr FRA,DF,20-041,10.6,28,14,11,13,4,14,20,70.0,6,11,3,8,8,36,32,1,Matches,Lyon,Ligue-1
1972,Tanner Tessmann,us USA,MF,23-224,12.0,21,13,8,9,4,10,22,45.5,12,12,7,5,19,40,27,1,Matches,Lyon,Ligue-1
1973,Saïd Benrahma,dz ALG,"FW,MF",29-269,8.2,9,5,4,4,1,3,10,30.0,7,6,0,6,3,12,2,0,Matches,Lyon,Ligue-1
1974,Thiago Almada,ar ARG,"MF,FW",24-010,8.7,12,7,7,3,2,7,20,35.0,13,2,0,2,6,18,5,3,Matches,Lyon,Ligue-1
1975,Maxence Caqueret,fr FRA,MF,25-080,6.4,21,11,5,11,5,4,22,18.2,18,12,2,10,7,28,2,0,Matches,Lyon,Ligue-1
1976,Gift Orban,ng NGA,"FW,DF",22-293,2.1,0,0,0,0,0,0,1,0.0,1,0,0,0,0,0,0,0,Matches,Lyon,Ligue-1
1977,Rémy Descamps,fr FRA,GK,28-315,1.0,0,0,0,0,0,0,0,,0,0,0,0,0,0,0,0,Matches,Lyon,Ligue-1
1978,Wilfried Zaha,ci CIV,FW,32-177,0.8,1,1,1,0,0,1,2,50.0,1,3,0,3,1,2,0,0,Matches,Lyon,Ligue-1
1979,Orel Mangala,be BEL,MF,27-049,0.7,1,0,0,0,1,0,1,0.0,1,2,0,2,0,1,1,0,Matches,Lyon,Ligue-1
1980,Mama Samba Baldé,gw GNB,FW,29-181,0.4,2,2,0,2,0,0,0,,0,0,0,0,1,3,1,0,Matches,Lyon,Ligue-1
1981,Alejandro Rodriguez,pt POR,MF,17-057,0.2,0,0,0,0,0,0,0,,0,0,0,0,0,0,0,0,Matches,Lyon,Ligue-1
1982,Paul Akouokou,ci CIV,MF,27-137,0.2,1,0,0,1,0,0,0,,0,0,0,0,1,2,0,1,Matches,Lyon,Ligue-1
1983,Mahamadou Diawara,fr FRA,MF,20-078,0.2,1,0,0,1,0,1,3,33.3,2,2,0,2,0,1,0,0,Matches,Lyon,Ligue-1
1984,Warmed Omari,km COM,DF,25-013,0.1,0,0,0,0,0,0,0,,0,0,0,0,0,0,1,0,Matches,Lyon,Ligue-1
1985,Adryelson,br BRA,DF,27-044,0.0,0,0,0,0,0,0,0,,0,0,0,0,1,1,1,0,Matches,Lyon,Ligue-1
1986,Gerónimo Rulli,ar ARG,GK,32-350,32.0,3,2,3,0,0,3,7,42.9,4,1,0,1,1,4,25,3,Matches,Marseille,Ligue-1
1987,Mason Greenwood,eng ENG,"FW,MF",23-216,29.2,33,17,10,13,10,16,36,44.4,20,7,0,7,11,44,5,2,Matches,Marseille,Ligue-1
1988,Luis Henrique,br BRA,"DF,FW",23-142,28.7,16,9,7,6,3,9,10,90.0,1,15,2,13,9,25,30,0,Matches,Marseille,Ligue-1
1989,Pierre Højbjerg,dk DEN,MF,29-273,27.6,55,37,23,25,7,32,64,50.0,32,28,4,24,42,97,31,1,Matches,Marseille,Ligue-1
1990,Adrien Rabiot,fr FRA,MF,30-032,25.6,47,29,16,20,11,19,31,61.3,12,21,2,19,21,68,30,0,Matches,Marseille,Ligue-1
1991,Michael Amir Murillo,pa PAN,DF,29-083,25.1,47,30,30,11,6,30,44,68.2,14,19,7,12,18,65,66,4,Matches,Marseille,Ligue-1
1992,Leonardo Balerdi,ar ARG,DF,26-099,23.3,50,35,28,17,5,25,45,55.6,20,24,14,10,31,81,66,4,Matches,Marseille,Ligue-1
1993,Geoffrey Kondogbia,cf CTA,"DF,MF",32-079,22.4,60,38,31,26,3,27,34,79.4,7,23,6,17,22,82,64,4,Matches,Marseille,Ligue-1
1994,Quentin Merlin,fr FRA,DF,22-354,16.8,20,15,10,5,5,7,13,53.8,6,18,4,14,13,33,16,1,Matches,Marseille,Ligue-1
1995,Valentin Rongier,fr FRA,"MF,DF",30-149,16.4,47,26,14,29,4,24,40,60.0,16,29,8,21,32,79,27,5,Matches,Marseille,Ligue-1
1996,Derek Cornelius,ca CAN,DF,27-161,14.8,23,16,14,8,1,16,21,76.2,5,14,8,6,14,37,47,0,Matches,Marseille,Ligue-1
1997,Neal Maupay,fr FRA,FW,28-264,11.5,9,4,1,6,2,3,6,50.0,3,5,0,5,2,11,0,0,Matches,Marseille,Ligue-1
1998,Amine Gouiri,dz ALG,"FW,MF",25-078,9.7,5,5,0,1,4,2,3,66.7,1,7,0,7,1,6,1,0,Matches,Marseille,Ligue-1
1999,Ulisses Garcia,ch SUI,DF,29-114,9.5,14,11,7,5,2,4,13,30.8,9,5,1,4,8,22,17,0,Matches,Marseille,Ligue-1
2000,Lilian Brassier,fr FRA,DF,25-184,8.7,8,6,8,0,0,5,6,83.3,1,8,3,5,9,17,28,2,Matches,Marseille,Ligue-1
2001,Amine Harit,ma MAR,MF,27-321,5.5,8,7,0,6,2,1,2,50.0,1,6,0,6,3,11,1,1,Matches,Marseille,Ligue-1
2002,Ismaël Bennacer,dz ALG,MF,27-155,6.5,21,10,8,12,1,12,17,70.6,5,5,0,5,10,31,1,1,Matches,Marseille,Ligue-1
2003,Elye Wahi,fr FRA,FW,22-123,6.4,0,0,0,0,0,0,4,0.0,4,1,0,1,1,1,0,0,Matches,Marseille,Ligue-1
2004,Pol Lirola,es ESP,DF,27-265,7.1,13,9,5,8,0,5,13,38.5,8,7,2,5,4,17,11,0,Matches,Marseille,Ligue-1
2005,Bilal Nadir,ma MAR,MF,21-158,4.0,10,3,4,6,0,4,6,66.7,2,6,1,5,2,12,7,0,Matches,Marseille,Ligue-1
2006,Jon Rowe,eng ENG,"FW,MF",22-005,7.5,11,10,2,3,6,4,9,44.4,5,2,1,1,1,12,1,0,Matches,Marseille,Ligue-1
2007,Ismaël Koné,ca CAN,"MF,FW",22-333,4.0,8,4,3,3,2,3,4,75.0,1,4,1,3,4,12,2,1,Matches,Marseille,Ligue-1
2008,Amar Dedić,ba BIH,DF,22-260,3.2,5,4,2,2,1,3,10,30.0,7,0,0,0,3,8,10,1,Matches,Marseille,Ligue-1
2009,Valentin Carboni,ar ARG,"MF,FW",20-061,1.1,2,2,0,1,1,0,1,0.0,1,1,0,1,1,3,1,0,Matches,Marseille,Ligue-1
2010,Luiz Felipe,it ITA,DF,28-044,0.8,2,1,2,0,0,0,1,0.0,1,2,2,0,1,3,1,0,Matches,Marseille,Ligue-1
2011,Robinio Vaz,fr FRA,FW,18-077,0.8,1,1,0,0,1,0,2,0.0,2,0,0,0,0,1,2,0,Matches,Marseille,Ligue-1
2012,Bamo Meïté,ci CIV,DF,23-153,0.3,0,0,0,0,0,0,0,,0,0,0,0,0,0,1,0,Matches,Marseille,Ligue-1
2013,Enzo Sternal,fr FRA,"FW,MF",17-342,0.3,0,0,0,0,0,0,0,,0,0,0,0,0,0,0,0,Matches,Marseille,Ligue-1
2014,Darryl Bakola,fr FRA,"DF,MF",17-156,0.2,1,1,0,1,0,0,0,,0,0,0,0,0,1,0,0,Matches,Marseille,Ligue-1
2015,Emmanuel Koum Mbondo,fr FRA,DF,19-089,0.1,0,0,0,0,0,0,0,,0,0,0,0,0,0,0,0,Matches,Marseille,Ligue-1
2016,Faris Pemi Moumbagna,cm CMR,FW,24-308,0.1,0,0,0,0,0,0,0,,0,0,0,0,0,0,0,0,Matches,Marseille,Ligue-1
2017,Keyliane Abdallah,fr FRA,FW,19-030,0.0,1,1,1,0,0,1,1,100.0,0,0,0,0,0,1,0,0,Matches,Marseille,Ligue-1
2018,Maghnes Akliouche,fr FRA,"FW,MF",23-070,25.6,50,31,12,23,15,19,41,46.3,22,20,0,20,14,64,12,0,Matches,Monaco,Ligue-1
2019,Thilo Kehrer,de GER,DF,28-227,25.5,36,22,25,11,0,21,37,56.8,16,17,9,8,33,69,109,1,Matches,Monaco,Ligue-1
2020,Takumi Minamino,jp JPN,"MF,FW",30-110,22.9,31,18,7,14,10,15,41,36.6,26,23,1,22,9,40,18,0,Matches,Monaco,Ligue-1
2021,Denis Zakaria,ch SUI,MF,28-167,22.8,40,25,15,19,6,24,33,72.7,9,31,8,23,33,73,35,1,Matches,Monaco,Ligue-1
2022,Vanderson,br BRA,DF,23-319,22.3,75,47,36,30,9,44,62,71.0,18,42,6,36,39,114,64,2,Matches,Monaco,Ligue-1
2023,Lamine Camara,sn SEN,MF,21-125,21.0,63,38,21,32,10,26,46,56.5,20,27,4,23,28,91,29,1,Matches,Monaco,Ligue-1
2024,Wilfried Singo,ci CIV,DF,24-132,21.3,36,22,23,10,3,19,27,70.4,8,13,6,7,42,78,100,2,Matches,Monaco,Ligue-1
2025,Caio Henrique Oliveira Silva,br BRA,DF,27-279,19.4,36,26,15,19,2,23,42,54.8,19,22,6,16,20,56,51,0,Matches,Monaco,Ligue-1
2026,Breel Embolo,ch SUI,"FW,MF",28-081,19.5,19,14,7,4,8,5,16,31.3,11,10,0,10,3,22,9,1,Matches,Monaco,Ligue-1
2027,Eliesse Ben Seghir,ma MAR,"MF,FW",20-079,18.4,29,21,10,12,7,17,30,56.7,13,17,0,17,12,41,3,0,Matches,Monaco,Ligue-1
2028,Philipp Köhn,ch SUI,GK,27-034,17.0,0,0,0,0,0,0,1,0.0,1,0,0,0,0,0,10,2,Matches,Monaco,Ligue-1
2029,Christian Mawissa,fr FRA,DF,20-018,15.6,39,27,26,11,2,26,43,60.5,17,22,5,17,25,64,41,1,Matches,Monaco,Ligue-1
2030,Radosław Majecki,pl POL,GK,25-171,15.0,0,0,0,0,0,0,2,0.0,2,0,0,0,0,0,8,1,Matches,Monaco,Ligue-1
2031,Mika Biereth,dk DEN,FW,22-087,12.8,4,4,0,2,2,2,6,33.3,4,10,0,10,4,8,6,0,Matches,Monaco,Ligue-1
2032,Aleksandr Golovin,ru RUS,"MF,FW",28-341,12.8,38,24,9,20,9,17,39,43.6,22,16,4,12,12,50,7,0,Matches,Monaco,Ligue-1
2033,Mohammed Salisu,gh GHA,DF,26-019,11.4,28,18,16,11,1,13,16,81.3,3,10,8,2,16,44,54,2,Matches,Monaco,Ligue-1
2034,Soungoutou Magassa,fr FRA,MF,21-210,10.7,43,24,13,25,5,24,43,55.8,19,16,3,13,21,64,19,1,Matches,Monaco,Ligue-1
2035,Folarin Balogun,us USA,FW,23-307,6.8,1,1,0,0,1,0,4,0.0,4,0,0,0,1,2,0,0,Matches,Monaco,Ligue-1
2036,Jordan Teze,nl NED,DF,25-218,5.0,16,8,6,9,1,5,13,38.5,8,12,1,11,3,19,11,0,Matches,Monaco,Ligue-1
2037,George Ilenikhena,fr FRA,"FW,MF",18-263,7.2,1,1,0,1,0,0,1,0.0,1,0,0,0,2,3,0,0,Matches,Monaco,Ligue-1
2038,Kassoum Ouattara,fr FRA,"DF,FW",20-204,4.3,9,7,5,4,0,4,14,28.6,10,6,0,6,5,14,2,1,Matches,Monaco,Ligue-1
2039,Almoatasem Al Musrati,ly LBY,MF,29-030,4.3,14,11,5,8,1,7,11,63.6,4,3,1,2,5,19,9,0,Matches,Monaco,Ligue-1
2040,Krépin Diatta,sn SEN,DF,26-070,4.9,18,12,13,2,3,14,23,60.9,9,5,1,4,7,25,11,2,Matches,Monaco,Ligue-1
2041,Ismail Jakobs,sn SEN,DF,25-262,2.0,5,5,3,0,2,3,5,60.0,2,0,0,0,2,7,6,0,Matches,Monaco,Ligue-1
2042,Saïmon Bouabré,fr FRA,"MF,FW",18-339,0.8,0,0,0,0,0,0,3,0.0,3,1,0,1,0,0,0,0,Matches,Monaco,Ligue-1
2043,Eliot Matazo,be BEL,MF,23-080,0.8,3,2,0,3,0,0,0,,0,0,0,0,1,4,2,0,Matches,Monaco,Ligue-1
2044,Lucas Michal,fr FRA,"FW,MF",19-319,1.1,5,3,3,2,0,2,4,50.0,2,2,0,2,1,6,2,0,Matches,Monaco,Ligue-1
2045,Mamadou Coulibaly,fr FRA,MF,21-015,0.1,1,0,0,1,0,0,0,,0,0,0,0,0,1,0,0,Matches,Monaco,Ligue-1
2046,Benjamin Lecomte,fr FRA,GK,34-010,28.0,0,0,0,0,0,0,0,,0,0,0,0,0,0,17,2,Matches,Montpellier,Ligue-1
2047,Téji Savanier,fr FRA,MF,33-135,24.7,29,24,7,16,6,18,43,41.9,25,16,1,15,14,43,21,4,Matches,Montpellier,Ligue-1
2048,Modibo Sagnan,ml MLI,DF,26-022,22.3,56,34,37,16,3,26,44,59.1,18,24,13,11,26,82,109,5,Matches,Montpellier,Ligue-1
2049,Joris Chotard,fr FRA,MF,23-224,18.1,35,22,16,18,1,19,42,45.2,23,26,8,18,19,54,51,1,Matches,Montpellier,Ligue-1
2050,Enzo Tchato,cm CMR,DF,22-164,20.1,45,23,25,16,4,25,42,59.5,17,29,9,20,22,67,56,0,Matches,Montpellier,Ligue-1
2051,Becir Omeragic,ch SUI,"DF,MF",23-106,18.0,29,15,18,10,1,15,20,75.0,5,30,20,10,12,41,72,0,Matches,Montpellier,Ligue-1
2052,Jordan Ferri,fr FRA,MF,33-055,18.0,38,19,16,20,2,16,39,41.0,23,18,3,15,9,47,19,0,Matches,Montpellier,Ligue-1
2053,Rabby Nzingoula,cg CGO,MF,19-162,17.3,61,39,23,31,7,25,54,46.3,29,26,5,21,26,87,23,0,Matches,Montpellier,Ligue-1
2054,Issiaga Sylla,gn GUI,DF,31-125,12.3,25,9,17,7,1,15,29,51.7,14,13,4,9,10,35,34,1,Matches,Montpellier,Ligue-1
2055,Tanguy Coulibaly,fr FRA,"FW,MF",24-077,13.5,27,20,10,14,3,12,28,42.9,16,16,1,15,10,37,2,0,Matches,Montpellier,Ligue-1
2056,Arnaud Nordin,fr FRA,FW,26-323,13.0,24,15,6,16,2,11,21,52.4,10,12,0,12,5,29,7,0,Matches,Montpellier,Ligue-1
2057,Falaye Sacko,ml MLI,DF,30-005,12.7,14,8,9,4,1,9,19,47.4,10,17,7,10,12,26,21,0,Matches,Montpellier,Ligue-1
2058,Akor Adams,ng NGA,FW,25-097,11.9,4,3,1,2,1,3,4,75.0,1,2,1,1,1,5,5,1,Matches,Montpellier,Ligue-1
2059,Musa Al-Taamari,jo JOR,"FW,MF",27-330,12.4,14,10,4,5,5,8,15,53.3,7,2,0,2,3,17,3,2,Matches,Montpellier,Ligue-1
2060,Wahbi Khazri,tn TUN,"FW,MF",34-087,11.8,25,18,5,16,4,8,21,38.1,13,12,1,11,5,30,7,0,Matches,Montpellier,Ligue-1
2061,Théo Sainte-Luce,fr FRA,DF,26-198,10.8,24,11,16,4,4,16,33,48.5,17,16,4,12,11,35,33,1,Matches,Montpellier,Ligue-1
2062,Khalil Fayad,fr FRA,"MF,FW",20-331,10.4,30,15,12,16,2,14,26,53.8,12,17,1,16,9,39,15,1,Matches,Montpellier,Ligue-1
2063,Yael Mouanga,fr FRA,DF,19-287,9.0,11,6,7,2,2,5,7,71.4,2,15,8,7,8,19,45,0,Matches,Montpellier,Ligue-1
2064,Boubakar Kouyaté,ml MLI,DF,28-021,7.4,22,15,16,6,0,11,19,57.9,8,17,11,6,12,34,54,0,Matches,Montpellier,Ligue-1
2065,Nikola Maksimović,rs SRB,DF,33-162,6.5,9,5,6,3,0,6,7,85.7,1,5,4,1,6,15,30,1,Matches,Montpellier,Ligue-1
2066,Andy Delort,dz ALG,FW,33-209,5.7,4,3,1,2,1,1,2,50.0,1,3,1,2,0,4,3,0,Matches,Montpellier,Ligue-1
2067,Lucas Mincarelli,fr FRA,DF,21-121,5.9,11,8,3,6,2,4,10,40.0,6,5,3,2,7,18,22,0,Matches,Montpellier,Ligue-1
2068,Bamo Meïté,ci CIV,DF,23-154,4.7,5,3,2,1,2,1,2,50.0,1,3,3,0,4,9,14,3,Matches,Montpellier,Ligue-1
2069,Nicolas Pays,fr FRA,"FW,MF",21-272,5.0,13,6,3,4,6,4,8,50.0,4,1,0,1,4,17,2,0,Matches,Montpellier,Ligue-1
2070,Junior Ndiaye,fr FRA,FW,20-038,3.6,1,0,1,0,0,0,1,0.0,1,1,1,0,0,1,2,0,Matches,Montpellier,Ligue-1
2071,Wilfried Ndollo,cm CMR,DF,19-297,3.5,6,5,4,1,1,4,6,66.7,2,6,1,5,6,12,9,0,Matches,Montpellier,Ligue-1
2072,Dimitry Bertaud,cd COD,GK,26-334,3.0,0,0,0,0,0,0,0,,0,0,0,0,0,0,2,0,Matches,Montpellier,Ligue-1
2073,Birama Touré,ml MLI,"MF,DF",32-334,3.3,8,5,5,2,1,4,6,66.7,2,3,2,1,6,14,7,0,Matches,Montpellier,Ligue-1
2074,Stefan Džodić,rs SRB,"DF,MF",20-052,2.1,6,3,3,3,0,4,6,66.7,2,5,4,1,4,10,8,0,Matches,Montpellier,Ligue-1
2075,Othmane Maamma,ma MAR,"FW,MF",19-212,3.0,3,1,2,1,0,1,4,25.0,3,4,0,4,1,4,2,1,Matches,Montpellier,Ligue-1
2076,Yanis Issoufou,fr FRA,"MF,FW",18-190,0.9,6,4,4,1,1,3,5,60.0,2,1,0,1,0,6,1,0,Matches,Montpellier,Ligue-1
2077,Gabriel Bares,ch SUI,"MF,DF",24-250,0.6,2,2,2,0,0,1,2,50.0,1,0,0,0,1,3,3,0,Matches,Montpellier,Ligue-1
2078,Axel Gueguin,fr FRA,FW,20-043,0.3,1,1,0,1,0,1,1,100.0,0,0,0,0,0,1,0,0,Matches,Montpellier,Ligue-1
2079,Simon Cara,fr FRA,"MF,FW",19-340,0.1,0,0,0,0,0,0,0,,0,0,0,0,0,0,0,0,Matches,Montpellier,Ligue-1
2080,Théo Chennahi,fr FRA,"MF,DF",20-089,0.1,0,0,0,0,0,0,0,,0,1,0,1,0,0,0,0,Matches,Montpellier,Ligue-1
2081,Matthis Abline,fr FRA,FW,22-039,28.8,11,5,2,4,5,3,9,33.3,6,15,1,14,3,14,34,1,Matches,Nantes,Ligue-1
2082,Moses Simon,ng NGA,"FW,MF",29-298,27.0,19,13,4,7,8,7,22,31.8,15,11,0,11,11,30,13,0,Matches,Nantes,Ligue-1
2083,Jean-Charles Castelletto,cm CMR,"DF,MF",30-100,27.1,31,14,15,14,2,16,25,64.0,9,25,17,8,24,55,144,0,Matches,Nantes,Ligue-1
2084,Pedro Chirivella,es ESP,MF,27-348,24.1,37,26,18,15,4,17,38,44.7,21,23,3,20,16,53,40,0,Matches,Nantes,Ligue-1
2085,Douglas,br BRA,MF,28-113,23.6,63,37,28,27,8,25,42,59.5,17,48,11,37,29,92,43,0,Matches,Nantes,Ligue-1
2086,Nicolas Cozza,fr FRA,"DF,MF",26-118,22.8,59,41,35,18,6,31,47,66.0,16,25,10,15,25,84,69,0,Matches,Nantes,Ligue-1
2087,Johann Lepenant,fr FRA,MF,22-196,22.6,67,32,29,27,11,32,71,45.1,39,34,3,31,18,85,25,0,Matches,Nantes,Ligue-1
2088,Kelvin Amian,fr FRA,DF,27-087,23.0,54,30,39,14,1,29,35,82.9,6,16,10,6,11,65,81,0,Matches,Nantes,Ligue-1
2089,Nicolas Pallois,fr FRA,DF,37-229,20.7,60,26,43,13,4,37,60,61.7,23,45,16,29,28,88,159,3,Matches,Nantes,Ligue-1
2090,Nathan Zeze,fr FRA,DF,19-322,15.6,35,19,20,15,0,22,31,71.0,9,21,9,12,22,57,115,1,Matches,Nantes,Ligue-1
2091,Anthony Lopes,pt POR,GK,34-217,15.4,1,0,1,0,0,1,1,100.0,0,0,0,0,0,1,7,1,Matches,Nantes,Ligue-1
2092,Sorba Thomas,wls WAL,"FW,MF",25-257,12.9,12,6,6,4,2,8,16,50.0,8,10,1,9,6,18,22,1,Matches,Nantes,Ligue-1
2093,Alban Lafont,fr FRA,GK,26-103,12.0,1,1,1,0,0,1,1,100.0,0,2,0,2,0,1,8,1,Matches,Nantes,Ligue-1
2094,Mostafa Mohamed,eg EGY,FW,27-159,13.6,17,9,5,8,4,4,12,33.3,8,10,2,8,10,27,26,0,Matches,Nantes,Ligue-1
2095,Marcus Coco,fr FRA,DF,28-316,10.6,27,21,15,9,3,16,31,51.6,15,16,5,11,10,37,46,0,Matches,Nantes,Ligue-1
2096,Saidou Sow,gn GUI,DF,22-306,8.9,17,11,13,4,0,6,10,60.0,4,19,12,7,13,30,46,1,Matches,Nantes,Ligue-1
2097,Louis Leroux,fr FRA,"MF,DF",19-103,7.7,21,15,9,9,3,12,17,70.6,5,18,2,16,5,26,15,1,Matches,Nantes,Ligue-1
2098,Jean-Kevin Duverne,ht HAI,DF,27-298,6.0,21,12,13,4,4,15,27,55.6,12,10,3,7,8,29,23,0,Matches,Nantes,Ligue-1
2099,Tino Kadewere,zw ZIM,"MF,FW",29-121,5.7,14,8,5,3,6,6,13,46.2,7,3,0,3,6,20,8,0,Matches,Nantes,Ligue-1
2100,Patrik Carlgren,se SWE,GK,33-118,4.6,0,0,0,0,0,0,0,,0,0,0,0,0,0,0,0,Matches,Nantes,Ligue-1
2101,Florent Mollet,fr FRA,"MF,FW",33-168,2.7,2,2,1,1,0,1,1,100.0,0,2,0,2,1,3,4,0,Matches,Nantes,Ligue-1
2102,Bahereba Guirassy,fr FRA,"FW,MF",18-250,3.8,12,8,6,3,3,7,13,53.8,6,10,0,10,1,13,4,0,Matches,Nantes,Ligue-1
2103,Jean-Philippe Gbamin,ci CIV,MF,29-223,2.4,2,1,0,2,0,1,4,25.0,3,5,2,3,3,5,2,0,Matches,Nantes,Ligue-1
2104,Fabien Centonze,fr FRA,DF,29-110,2.1,4,2,2,1,1,2,4,50.0,2,3,1,2,2,6,13,0,Matches,Nantes,Ligue-1
2105,Ignatius Ganago,cm CMR,"FW,MF",26-079,2.7,1,1,0,1,0,1,2,50.0,1,3,1,2,4,5,2,0,Matches,Nantes,Ligue-1
2106,Meschak Elia,cd COD,FW,27-273,1.9,7,5,3,2,2,1,1,100.0,0,3,0,3,0,7,2,0,Matches,Nantes,Ligue-1
2107,Francis Coquelin,fr FRA,MF,33-358,1.0,3,1,1,2,0,0,1,0.0,1,2,1,1,3,6,2,0,Matches,Nantes,Ligue-1
2108,Dehmaine Assoumani,fr FRA,"MF,FW",20-019,1.1,6,3,0,4,2,4,5,80.0,1,1,0,1,1,7,4,0,Matches,Nantes,Ligue-1
2109,Plamedi Nsingi,,MF,24-140,0.2,1,0,1,0,0,0,1,0.0,1,0,0,0,0,1,0,0,Matches,Nantes,Ligue-1
2110,Sékou Doucoure,fr FRA,DF,20-010,0.1,0,0,0,0,0,0,0,,0,0,0,0,0,0,3,0,Matches,Nantes,Ligue-1
2111,Marcin Bułka,pl POL,GK,25-214,32.0,0,0,0,0,0,0,1,0.0,1,0,0,0,0,0,16,6,Matches,Nice,Ligue-1
2112,Evann Guessand,ci CIV,"FW,MF",23-309,27.0,41,27,12,15,14,6,13,46.2,7,25,3,22,15,56,15,0,Matches,Nice,Ligue-1
2113,Hicham Boudaoui,dz ALG,MF,25-225,25.1,72,49,27,34,11,29,49,59.2,20,38,11,27,21,93,43,1,Matches,Nice,Ligue-1
2114,Jonathan Clauss,fr FRA,"DF,MF",32-223,23.7,49,35,26,17,6,27,53,50.9,26,23,2,21,44,93,67,3,Matches,Nice,Ligue-1
2115,Moïse Bombito,ca CAN,DF,25-037,22.4,35,23,20,12,3,24,35,68.6,11,34,19,15,18,53,115,7,Matches,Nice,Ligue-1
2116,Youssouf Ndayishimiye,bi BDI,DF,26-191,21.5,40,21,25,14,1,16,27,59.3,11,35,19,16,21,61,117,4,Matches,Nice,Ligue-1
2117,Mohamed Ali Cho,fr FRA,"FW,MF",21-107,17.9,13,9,4,5,4,4,12,33.3,8,17,1,16,5,18,8,0,Matches,Nice,Ligue-1
2118,Dante,br BRA,DF,41-200,20.3,30,13,16,12,2,14,27,51.9,13,26,12,14,31,61,68,1,Matches,Nice,Ligue-1
2119,Melvin Bard,fr FRA,"DF,MF",24-181,19.5,48,34,32,12,4,24,42,57.1,18,34,13,21,27,75,56,3,Matches,Nice,Ligue-1
2120,Pablo Rosario,nl NED,"MF,DF",28-119,19.0,29,19,6,18,5,11,20,55.0,9,19,11,8,30,59,43,2,Matches,Nice,Ligue-1
2121,Gaëtan Laborde,fr FRA,FW,31-003,19.0,19,13,9,8,2,9,22,40.9,13,16,4,12,5,24,17,0,Matches,Nice,Ligue-1
2122,Ali Abdi,tn TUN,"DF,MF",31-137,14.9,43,25,18,14,11,28,43,65.1,15,20,6,14,20,63,34,0,Matches,Nice,Ligue-1
2123,Tanguy Ndombele,fr FRA,MF,28-129,12.6,35,23,10,21,4,12,20,60.0,8,9,0,9,14,49,9,0,Matches,Nice,Ligue-1
2124,Jeremie Boga,ci CIV,"MF,FW",28-123,11.3,9,5,2,5,2,4,8,50.0,4,13,0,13,3,12,2,1,Matches,Nice,Ligue-1
2125,Baptiste Santamaria,fr FRA,MF,30-058,9.5,19,9,9,7,3,13,21,61.9,8,14,3,11,16,35,19,1,Matches,Nice,Ligue-1
2126,Mohamed Abdelmoneim,eg EGY,DF,26-094,9.5,21,14,12,6,3,13,22,59.1,9,11,5,6,15,36,56,1,Matches,Nice,Ligue-1
2127,Badredine Bouanani,dz ALG,"MF,FW",20-149,10.5,11,4,4,4,3,6,17,35.3,11,14,3,11,9,20,4,0,Matches,Nice,Ligue-1
2128,Sofiane Diop,fr FRA,"MF,FW",24-331,11.3,23,16,16,3,4,9,22,40.9,13,19,2,17,16,39,7,1,Matches,Nice,Ligue-1
2129,Tom Louchet,fr FRA,"DF,MF",22-002,8.0,26,16,17,4,5,17,22,77.3,5,12,4,8,17,43,18,0,Matches,Nice,Ligue-1
2130,Antoine Mendy,sn SEN,DF,20-344,7.7,28,20,14,14,0,18,25,72.0,7,7,3,4,5,33,27,0,Matches,Nice,Ligue-1
2131,Youssoufa Moukoko,de GER,"FW,MF",20-167,2.3,3,2,2,1,0,1,2,50.0,1,2,0,2,0,3,0,0,Matches,Nice,Ligue-1
2132,Morgan Sanson,fr FRA,MF,30-261,2.0,4,2,1,3,0,0,2,0.0,2,2,0,2,4,8,2,0,Matches,Nice,Ligue-1
2133,Yael Nandjou,fr FRA,DF,19-304,1.7,4,1,2,1,1,4,8,50.0,4,4,1,3,4,8,7,0,Matches,Nice,Ligue-1
2134,Bilal Brahimi,dz ALG,MF,25-053,0.8,0,0,0,0,0,0,0,,0,1,0,1,0,0,2,0,Matches,Nice,Ligue-1
2135,Amidou Doumbouya,fr FRA,DF,17-274,0.5,1,1,0,0,1,1,1,100.0,0,3,1,2,1,2,1,0,Matches,Nice,Ligue-1
2136,Terem Moffi,ng NGA,FW,25-346,0.5,0,0,0,0,0,0,0,,0,0,0,0,0,0,0,0,Matches,Nice,Ligue-1
2137,Victor Orakpo,ng NGA,FW,18-326,0.4,0,0,0,0,0,0,0,,0,0,0,0,0,0,0,0,Matches,Nice,Ligue-1
2138,Jordan Lotomba,ch SUI,"MF,DF",26-219,0.4,0,0,0,0,0,0,0,,0,0,0,0,0,0,1,0,Matches,Nice,Ligue-1
2139,Issiaga Camara,gn GUI,MF,20-093,0.2,2,1,0,2,0,0,1,0.0,1,0,0,0,3,5,0,0,Matches,Nice,Ligue-1
2140,Rareş Ilie,ro ROU,MF,22-017,0.1,1,1,1,0,0,1,1,100.0,0,0,0,0,0,1,0,0,Matches,Nice,Ligue-1
2141,Bernard Nguene,cm CMR,FW,18-275,0.1,0,0,0,0,0,0,0,,0,0,0,0,0,0,0,0,Matches,Nice,Ligue-1
2142,Bradley Barcola,fr FRA,FW,22-246,22.8,26,16,10,7,9,8,31,25.8,23,25,2,23,19,45,9,0,Matches,Paris-Saint-Germain,Ligue-1
2143,Gianluigi Donnarumma,it ITA,GK,26-070,22.2,1,1,1,0,0,1,2,50.0,1,0,0,0,0,1,12,0,Matches,Paris-Saint-Germain,Ligue-1
2144,Achraf Hakimi,ma MAR,DF,26-183,22.0,47,35,18,19,10,27,55,49.1,28,25,2,23,29,76,18,3,Matches,Paris-Saint-Germain,Ligue-1
2145,Willian Pacho,ec ECU,DF,23-202,22.7,55,32,34,21,0,23,32,71.9,9,35,22,13,40,95,87,1,Matches,Paris-Saint-Germain,Ligue-1
2146,Warren Zaïre-Emery,fr FRA,"MF,DF",19-059,21.4,46,23,16,19,11,21,42,50.0,21,33,6,27,19,65,20,2,Matches,Paris-Saint-Germain,Ligue-1
2147,Lucas Beraldo,br BRA,DF,21-163,21.2,37,30,29,8,0,22,35,62.9,13,13,6,7,20,57,60,3,Matches,Paris-Saint-Germain,Ligue-1
2148,João Neves,pt POR,"MF,DF",20-221,19.8,61,31,19,26,16,26,42,61.9,16,29,9,20,21,82,22,1,Matches,Paris-Saint-Germain,Ligue-1
2149,Fabián Ruiz Peña,es ESP,MF,29-033,20.7,36,23,13,15,8,20,46,43.5,26,24,3,21,16,52,27,1,Matches,Paris-Saint-Germain,Ligue-1
2150,Vitinha,pt POR,MF,25-082,21.7,41,21,13,26,2,24,46,52.2,22,26,7,19,13,54,19,2,Matches,Paris-Saint-Germain,Ligue-1
2151,Ousmane Dembélé,fr FRA,FW,27-356,18.4,11,5,0,7,4,4,12,33.3,8,3,0,3,9,20,2,1,Matches,Paris-Saint-Germain,Ligue-1
2152,Marquinhos,br BRA,DF,30-357,18.4,30,19,8,16,6,25,33,75.8,8,25,13,12,10,40,62,0,Matches,Paris-Saint-Germain,Ligue-1
2153,Nuno Mendes,pt POR,DF,22-321,17.6,29,18,14,12,3,22,37,59.5,15,25,8,17,17,46,35,2,Matches,Paris-Saint-Germain,Ligue-1
2154,Lee Kang-in,kr KOR,"FW,MF",24-076,17.5,25,17,7,11,7,19,35,54.3,16,11,1,10,2,27,3,1,Matches,Paris-Saint-Germain,Ligue-1
2155,Désiré Doué,fr FRA,"FW,MF",19-337,18.2,43,26,14,19,10,21,44,47.7,23,20,0,20,13,56,7,0,Matches,Paris-Saint-Germain,Ligue-1
2156,Gonçalo Ramos,pt POR,FW,23-320,10.7,11,6,5,5,1,3,6,50.0,3,5,1,4,0,11,5,0,Matches,Paris-Saint-Germain,Ligue-1
2157,Khvicha Kvaratskhelia,ge GEO,FW,24-083,9.2,19,13,4,12,3,13,23,56.5,10,6,0,6,2,21,4,0,Matches,Paris-Saint-Germain,Ligue-1
2158,Matvei Safonov,ru RUS,GK,26-070,9.8,0,0,0,0,0,0,0,,0,1,0,1,1,1,3,0,Matches,Paris-Saint-Germain,Ligue-1
2159,Lucas Hernández,fr FRA,DF,29-081,8.7,21,16,11,8,2,13,19,68.4,6,11,5,6,5,26,34,2,Matches,Paris-Saint-Germain,Ligue-1
2160,Marco Asensio,es ESP,"FW,MF",29-105,6.9,4,3,1,3,0,0,6,0.0,6,1,0,1,0,4,1,0,Matches,Paris-Saint-Germain,Ligue-1
2161,Senny Mayulu,fr FRA,MF,18-354,7.6,23,14,8,12,3,7,12,58.3,5,8,3,5,5,28,9,0,Matches,Paris-Saint-Germain,Ligue-1
2162,Milan Škriniar,sk SVK,DF,30-084,4.2,7,5,3,4,0,3,3,100.0,0,7,6,1,3,10,16,0,Matches,Paris-Saint-Germain,Ligue-1
2163,Ibrahim Mbaye,fr FRA,FW,17-102,2.8,3,2,1,1,1,2,7,28.6,5,1,0,1,2,5,2,0,Matches,Paris-Saint-Germain,Ligue-1
2164,Randal Kolo Muani,fr FRA,FW,26-152,4.0,4,4,1,1,2,0,2,0.0,2,1,0,1,0,4,5,0,Matches,Paris-Saint-Germain,Ligue-1
2165,Yoram Zague,fr FRA,DF,18-356,1.8,4,3,2,1,1,2,3,66.7,1,2,0,2,2,6,2,0,Matches,Paris-Saint-Germain,Ligue-1
2166,Axel Tapé,fr FRA,DF,17-269,1.0,1,1,1,0,0,1,1,100.0,0,1,1,0,1,2,5,0,Matches,Paris-Saint-Germain,Ligue-1
2167,Noham Kamara,fr FRA,DF,18-104,0.5,1,1,0,1,0,0,0,,0,1,1,0,0,1,1,0,Matches,Paris-Saint-Germain,Ligue-1
2168,Presnel Kimpembe,fr FRA,DF,29-266,0.3,1,0,1,0,0,0,0,,0,2,2,0,0,1,1,0,Matches,Paris-Saint-Germain,Ligue-1
2169,Yehvann Diouf,fr FRA,GK,25-171,32.0,2,1,2,0,0,1,3,33.3,2,0,0,0,1,3,21,3,Matches,Reims,Ligue-1
2170,Valentin Atangana Edoa,fr FRA,MF,19-254,29.7,63,47,28,28,7,25,33,75.8,8,31,15,16,36,99,59,0,Matches,Reims,Ligue-1
2171,Junya Ito,jp JPN,"FW,MF",32-058,28.6,43,28,17,16,10,16,59,27.1,43,32,3,29,13,56,15,1,Matches,Reims,Ligue-1
2172,Keito Nakamura,jp JPN,"FW,MF",24-282,28.4,23,16,7,9,7,11,31,35.5,20,21,1,20,13,36,19,0,Matches,Reims,Ligue-1
2173,Sergio Akieme,es ESP,DF,27-141,26.5,31,21,28,2,1,21,34,61.8,13,26,9,17,17,48,93,4,Matches,Reims,Ligue-1
2174,Cédric Kipré,ci CIV,DF,28-148,22.3,36,25,26,9,1,26,35,74.3,9,40,27,13,31,67,149,2,Matches,Reims,Ligue-1
2175,Aurélio Buta,pt POR,DF,28-085,21.2,36,23,21,11,4,21,42,50.0,21,18,4,14,21,57,59,0,Matches,Reims,Ligue-1
2176,Oumar Diakité,ci CIV,FW,21-137,18.1,20,13,7,8,5,9,19,47.4,10,12,2,10,3,23,9,0,Matches,Reims,Ligue-1
2177,Marshall Munetsi,zw ZIM,MF,28-318,18.8,36,18,22,9,5,22,38,57.9,16,27,3,24,17,53,35,0,Matches,Reims,Ligue-1
2178,Joseph Okumu,ke KEN,DF,27-345,17.3,28,14,19,9,0,14,23,60.9,9,27,17,10,22,50,116,2,Matches,Reims,Ligue-1
2179,Amadou Koné,ml MLI,MF,19-357,12.9,45,31,30,15,0,20,32,62.5,12,14,2,12,17,62,37,2,Matches,Reims,Ligue-1
2180,Emmanuel Agbadou,ci CIV,DF,27-323,14.0,25,17,19,3,3,19,26,73.1,7,22,13,9,19,44,64,1,Matches,Reims,Ligue-1
2181,Mory Gbane,ci CIV,"DF,MF",24-132,10.5,18,10,14,4,0,11,21,52.4,10,11,9,2,17,35,78,1,Matches,Reims,Ligue-1
2182,Nhoa Sangui,fr FRA,"DF,MF",19-068,12.1,16,9,6,6,4,9,12,75.0,3,8,4,4,6,22,23,0,Matches,Reims,Ligue-1
2183,Teddy Teuma,mt MLT,MF,31-218,8.3,18,10,6,6,6,7,25,28.0,18,12,2,10,12,30,8,1,Matches,Reims,Ligue-1
2184,Yaya Kader Fofana,ml MLI,"MF,FW",20-328,7.0,17,11,8,5,4,4,12,33.3,8,11,2,9,3,20,2,0,Matches,Reims,Ligue-1
2185,Hiroki Sekine,jp JPN,DF,22-268,7.9,8,6,5,2,1,6,15,40.0,9,13,6,7,5,13,45,1,Matches,Reims,Ligue-1
2186,Mamadou Diakhon,fr FRA,"FW,MF",19-226,9.2,12,8,4,3,5,9,17,52.9,8,5,1,4,4,16,5,0,Matches,Reims,Ligue-1
2187,John Joe,ie IRL,MF,21-194,5.5,19,12,10,7,2,4,16,25.0,12,9,2,7,6,25,9,0,Matches,Reims,Ligue-1
2188,Jordan Pefok,us USA,FW,29-010,2.6,1,1,0,1,0,0,1,0.0,1,1,1,0,1,2,3,0,Matches,Reims,Ligue-1
2189,Amine Salama,fr FRA,FW,24-292,4.1,3,2,0,2,1,0,3,0.0,3,2,1,1,1,4,0,0,Matches,Reims,Ligue-1
2190,Hafiz Ibrahim,ng NGA,FW,19-137,3.9,1,1,0,1,0,0,5,0.0,5,4,2,2,2,3,6,0,Matches,Reims,Ligue-1
2191,Thibault De Smet,be BEL,DF,26-335,2.1,6,4,5,1,0,4,4,100.0,0,5,3,2,4,10,12,0,Matches,Reims,Ligue-1
2192,Malcolm Jeng,se SWE,DF,20-058,1.2,0,0,0,0,0,0,0,,0,1,0,1,3,3,10,0,Matches,Reims,Ligue-1
2193,Abdoul Koné,fr FRA,DF,20-014,1.5,5,3,4,1,0,3,5,60.0,2,2,1,1,1,6,5,0,Matches,Reims,Ligue-1
2194,Ange Martial Tia,ml MLI,MF,18-167,0.9,3,2,1,2,0,1,4,25.0,3,3,0,3,1,4,3,0,Matches,Reims,Ligue-1
2195,Gabriel Moscardo,br BRA,"MF,DF",19-220,0.9,3,1,2,1,0,1,3,33.3,2,3,1,2,0,3,1,0,Matches,Reims,Ligue-1
2196,Reda Khadra,de GER,"MF,FW",23-306,0.9,1,1,1,0,0,0,1,0.0,1,0,0,0,0,1,1,0,Matches,Reims,Ligue-1
2197,Niama Sissoko,ml MLI,"FW,MF",19-141,0.5,0,0,0,0,0,0,0,,0,1,0,1,0,0,0,0,Matches,Reims,Ligue-1
2198,Martin Adeline,fr FRA,MF,21-155,0.3,1,1,0,1,0,1,2,50.0,1,0,0,0,0,1,2,0,Matches,Reims,Ligue-1
2199,Eloge Zabi,ci CIV,"DF,MF",18-224,0.2,0,0,0,0,0,0,0,,0,0,0,0,0,0,1,0,Matches,Reims,Ligue-1
2200,Mohamed Daramy,dk DEN,FW,23-119,0.2,0,0,0,0,0,0,0,,0,0,0,0,0,0,1,0,Matches,Reims,Ligue-1
2201,Mohamed Bamba,ci CIV,MF,20-210,0.1,0,0,0,0,0,0,1,0.0,1,2,1,1,0,0,1,0,Matches,Reims,Ligue-1
2202,Ike Orazi,ie IRL,MF,17-329,0.0,0,0,0,0,0,0,0,,0,0,0,0,0,0,0,0,Matches,Reims,Ligue-1
2203,Adrien Truffert,fr FRA,"DF,MF",23-167,28.6,57,33,24,20,13,29,45,64.4,16,43,6,37,26,83,49,1,Matches,Rennes,Ligue-1
2204,Arnaud Kalimuendo,fr FRA,"FW,MF",23-106,26.7,18,11,6,8,4,6,12,50.0,6,9,2,7,4,22,12,0,Matches,Rennes,Ligue-1
2205,Lorenz Assignon,tg TOG,"DF,MF",24-318,24.9,45,24,23,20,2,16,40,40.0,24,19,3,16,24,69,71,0,Matches,Rennes,Ligue-1
2206,Ludovic Blas,fr FRA,"MF,FW",27-126,23.7,37,24,9,12,16,22,40,55.0,18,16,2,14,13,50,9,0,Matches,Rennes,Ligue-1
2207,Azor Matusiwa,nl NED,MF,27-008,21.4,63,38,31,30,2,32,42,76.2,10,25,9,16,34,97,49,0,Matches,Rennes,Ligue-1
2208,Hans Hateboer,nl NED,DF,31-117,18.7,31,16,14,12,5,18,36,50.0,18,19,6,13,29,60,64,2,Matches,Rennes,Ligue-1
2209,Steve Mandanda,fr FRA,GK,40-039,16.5,0,0,0,0,0,0,1,0.0,1,0,0,0,0,0,6,2,Matches,Rennes,Ligue-1
2210,Christopher Wooh,cm CMR,DF,23-230,16.2,36,19,21,13,2,18,27,66.7,9,22,8,14,23,59,63,0,Matches,Rennes,Ligue-1
2211,Brice Samba,fr FRA,GK,31-011,15.0,2,1,2,0,0,1,1,100.0,0,0,0,0,0,2,11,2,Matches,Rennes,Ligue-1
2212,Leo Skiri Østigård,no NOR,DF,25-159,13.6,20,18,16,4,0,15,22,68.2,7,12,10,2,15,35,81,1,Matches,Rennes,Ligue-1
2213,Jordan James,wls WAL,MF,20-308,12.7,28,18,7,17,4,16,29,55.2,13,13,1,12,13,41,16,1,Matches,Rennes,Ligue-1
2214,Lilian Brassier,fr FRA,DF,25-185,11.7,13,10,10,3,0,8,10,80.0,2,16,10,6,21,34,54,0,Matches,Rennes,Ligue-1
2215,Djaoui Cissé,fr FRA,MF,21-095,10.5,30,16,12,12,6,15,25,60.0,10,24,4,20,13,43,8,0,Matches,Rennes,Ligue-1
2216,Amine Gouiri,dz ALG,"MF,FW",25-079,11.5,9,6,4,4,1,2,8,25.0,6,8,0,8,2,11,5,0,Matches,Rennes,Ligue-1
2217,Alidu Seidu,gh GHA,DF,24-336,8.9,22,18,14,6,2,12,15,80.0,3,13,6,7,14,36,17,0,Matches,Rennes,Ligue-1
2218,Albert Grønbaek,dk DEN,"MF,FW",23-348,9.0,21,11,10,7,4,10,28,35.7,18,9,1,8,4,25,6,0,Matches,Rennes,Ligue-1
2219,Seko Fofana,ci CIV,MF,29-364,8.9,10,7,3,6,1,2,7,28.6,5,7,1,6,6,16,7,0,Matches,Rennes,Ligue-1
2220,Anthony Rouault,fr FRA,DF,23-342,8.8,9,6,7,2,0,4,4,100.0,0,12,10,2,7,16,57,0,Matches,Rennes,Ligue-1
2221,Jérémy Jacquet,fr FRA,DF,19-297,8.6,22,15,9,6,7,11,18,61.1,7,8,3,5,21,43,43,1,Matches,Rennes,Ligue-1
2222,Glen Kamara,fi FIN,MF,29-190,7.4,23,11,10,11,2,11,17,64.7,6,7,0,7,7,30,7,0,Matches,Rennes,Ligue-1
2223,Mikayil Ngor Faye,sn SEN,DF,20-296,7.6,15,12,10,3,2,7,9,77.8,2,9,4,5,12,27,30,0,Matches,Rennes,Ligue-1
2224,Musa Al-Taamari,jo JOR,"FW,MF",27-330,5.6,3,0,1,0,2,0,3,0.0,3,3,0,3,2,5,2,0,Matches,Rennes,Ligue-1
2225,Mohamed Meité,fr FRA,FW,17-207,6.0,2,0,0,2,0,1,1,100.0,0,1,0,1,0,2,5,0,Matches,Rennes,Ligue-1
2226,Baptiste Santamaria,fr FRA,MF,30-058,5.4,11,4,7,3,1,6,11,54.5,5,10,4,6,12,23,7,0,Matches,Rennes,Ligue-1
2227,Mahamadou Nagida,cm CMR,DF,19-312,4.8,8,6,4,3,1,4,5,80.0,1,3,0,3,9,17,6,0,Matches,Rennes,Ligue-1
2228,Jota,pt POR,"FW,MF",26-037,3.7,5,2,2,3,0,4,7,57.1,3,1,0,1,3,8,2,0,Matches,Rennes,Ligue-1
2229,Kazeem Olaigbe,be BEL,"MF,FW",22-124,3.1,6,4,3,3,0,3,6,50.0,3,2,0,2,0,6,0,0,Matches,Rennes,Ligue-1
2230,Carlos Gómez,co COL,"MF,DF",22-236,3.9,8,6,3,4,1,3,9,33.3,6,6,0,6,2,10,2,0,Matches,Rennes,Ligue-1
2231,Ismaël Koné,ca CAN,MF,22-334,3.7,7,4,2,4,1,4,5,80.0,1,6,1,5,3,10,4,0,Matches,Rennes,Ligue-1
2232,Kyogo Furuhashi,jp JPN,FW,30-106,1.4,2,2,1,1,0,1,1,100.0,0,0,0,0,0,2,0,0,Matches,Rennes,Ligue-1
2233,Benjamin Bourigeaud,fr FRA,MF,31-112,0.9,1,0,0,1,0,0,2,0.0,2,2,1,1,2,3,1,0,Matches,Rennes,Ligue-1
2234,Henrik Meister,dk DEN,FW,21-170,0.7,2,0,0,2,0,0,0,,0,4,0,4,1,3,0,0,Matches,Rennes,Ligue-1
2235,Naouirou Ahamada,fr FRA,"MF,FW",23-038,0.6,0,0,0,0,0,0,0,,0,0,0,0,2,2,2,0,Matches,Rennes,Ligue-1
2236,Gauthier Gallon,fr FRA,GK,32-013,0.5,0,0,0,0,0,0,0,,0,0,0,0,0,0,0,0,Matches,Rennes,Ligue-1
2237,Ayanda Sishuba,be BEL,FW,20-093,0.0,1,0,1,0,0,1,1,100.0,0,0,0,0,0,1,0,0,Matches,Rennes,Ligue-1
2238,Gautier Larsonneur,fr FRA,GK,28-072,31.0,1,0,1,0,0,0,2,0.0,2,1,0,1,0,1,24,1,Matches,Saint-Etienne,Ligue-1
2239,Zuriko Davitashvili,ge GEO,"FW,MF",24-080,27.9,21,13,8,7,6,14,46,30.4,32,20,0,20,12,33,12,0,Matches,Saint-Etienne,Ligue-1
2240,Léo Pétrot,fr FRA,DF,28-021,26.3,56,35,34,17,5,31,47,66.0,16,47,25,22,37,93,91,1,Matches,Saint-Etienne,Ligue-1
2241,Pierre Ekwah Elimby,fr FRA,MF,23-111,25.6,48,27,17,27,4,31,49,63.3,18,25,12,13,45,93,69,1,Matches,Saint-Etienne,Ligue-1
2242,Mickael Nade,fr FRA,DF,26-063,22.6,50,36,32,18,0,21,28,75.0,7,32,15,17,32,82,122,8,Matches,Saint-Etienne,Ligue-1
2243,Dylan Batubinsika,cd COD,DF,29-080,21.9,25,13,19,5,1,13,22,59.1,9,23,14,9,38,63,139,3,Matches,Saint-Etienne,Ligue-1
2244,Lucas Stassin,be BEL,FW,20-159,20.0,16,11,3,5,8,6,20,30.0,14,10,0,10,3,19,8,0,Matches,Saint-Etienne,Ligue-1
2245,Dennis Appiah,fr FRA,DF,32-331,21.6,65,38,37,21,7,37,65,56.9,28,32,7,25,23,88,80,2,Matches,Saint-Etienne,Ligue-1
2246,Benjamin Bouchouari,ma MAR,MF,23-174,18.4,31,24,14,12,5,15,42,35.7,27,18,1,17,17,48,15,2,Matches,Saint-Etienne,Ligue-1
2247,Louis Mouton,fr FRA,MF,22-337,11.5,44,24,13,21,10,19,34,55.9,15,16,3,13,10,54,19,0,Matches,Saint-Etienne,Ligue-1
2248,Yunis Abdelhamid,ma MAR,DF,37-220,10.9,17,11,15,2,0,10,16,62.5,6,26,18,8,13,30,57,1,Matches,Saint-Etienne,Ligue-1
2249,Aimen Moueffek,fr FRA,MF,24-027,10.4,19,11,3,11,5,10,22,45.5,12,17,5,12,3,22,24,1,Matches,Saint-Etienne,Ligue-1
2250,Florian Tardieu,fr FRA,MF,33-014,10.9,16,11,6,7,3,5,13,38.5,8,14,5,9,13,29,16,0,Matches,Saint-Etienne,Ligue-1
2251,Irvin Cardona,fr FRA,FW,27-271,9.1,5,4,3,2,0,2,12,16.7,10,15,3,12,2,7,5,2,Matches,Saint-Etienne,Ligue-1
2252,Mathis Amougou,fr FRA,MF,19-108,9.5,21,15,15,5,1,10,19,52.6,9,10,0,10,12,33,4,0,Matches,Saint-Etienne,Ligue-1
2253,Mathieu Cafaro,fr FRA,"MF,FW",28-042,8.1,10,7,4,4,2,4,15,26.7,11,7,1,6,7,17,3,0,Matches,Saint-Etienne,Ligue-1
2254,Yvann Macon,fr FRA,DF,26-217,7.8,19,11,9,7,3,10,21,47.6,11,14,4,10,2,21,10,1,Matches,Saint-Etienne,Ligue-1
2255,Ibrahim Sissoko,ml MLI,FW,29-160,9.0,11,9,5,3,3,2,5,40.0,3,10,2,8,2,13,13,0,Matches,Saint-Etienne,Ligue-1
2256,Augustine Boakye,gh GHA,"FW,MF",24-184,8.1,7,3,3,4,0,3,11,27.3,8,5,0,5,6,13,4,0,Matches,Saint-Etienne,Ligue-1
2257,Pierre Cornud,fr FRA,DF,28-145,6.4,12,10,6,4,2,8,17,47.1,9,9,4,5,9,21,28,1,Matches,Saint-Etienne,Ligue-1
2258,Maxime Bernauer,fr FRA,DF,26-309,6.5,8,7,5,1,2,5,7,71.4,2,6,2,4,4,12,36,1,Matches,Saint-Etienne,Ligue-1
2259,Ben Old,nz NZL,"FW,MF",22-266,5.4,6,5,3,2,1,3,11,27.3,8,8,1,7,2,8,2,0,Matches,Saint-Etienne,Ligue-1
2260,Lamine Fomba,fr FRA,MF,27-100,2.4,8,6,2,5,1,2,7,28.6,5,7,1,6,4,12,5,1,Matches,Saint-Etienne,Ligue-1
2261,Djylian N'Guessan,fr FRA,FW,16-249,1.9,5,3,4,1,0,1,4,25.0,3,1,0,1,0,5,1,0,Matches,Saint-Etienne,Ligue-1
2262,Marwann Nzuzi,fr FRA,DF,20-355,1.4,2,2,1,0,1,1,2,50.0,1,0,0,0,2,4,6,0,Matches,Saint-Etienne,Ligue-1
2263,Ayman Aiki,fr FRA,"FW,MF",19-315,1.4,3,3,1,2,0,1,1,100.0,0,1,0,1,1,4,0,0,Matches,Saint-Etienne,Ligue-1
2264,Beres Owusu,fr FRA,DF,21-229,1.0,2,2,1,1,0,2,2,100.0,0,2,2,0,0,2,5,0,Matches,Saint-Etienne,Ligue-1
2265,Ibrahima Wadji,sn SEN,"FW,MF",30-001,2.2,6,6,3,2,1,3,7,42.9,4,0,0,0,1,7,0,0,Matches,Saint-Etienne,Ligue-1
2266,Igor Miladinović,rs SRB,"FW,MF",21-332,0.3,0,0,0,0,0,0,0,,0,0,0,0,1,1,1,0,Matches,Saint-Etienne,Ligue-1
2267,Kévin Pedro,fr FRA,DF,19-074,0.1,3,0,2,1,0,3,3,100.0,0,1,0,1,2,5,1,0,Matches,Saint-Etienne,Ligue-1
2268,Jibril Othman,tn TUN,FW,21-010,0.1,0,0,0,0,0,0,0,,0,0,0,0,0,0,0,0,Matches,Saint-Etienne,Ligue-1
2269,Anthony Briançon,fr FRA,DF,30-159,0.0,0,0,0,0,0,0,0,,0,0,0,0,0,0,0,0,Matches,Saint-Etienne,Ligue-1
2270,Andrey Santos,br BRA,MF,21-003,29.7,106,71,45,49,12,48,84,57.1,36,45,14,31,28,134,67,1,Matches,Strasbourg,Ligue-1
2271,Đorđe Petrović,rs SRB,GK,25-210,29.0,1,1,1,0,0,0,0,,0,0,0,0,0,1,24,1,Matches,Strasbourg,Ligue-1
2272,Ismaël Doukouré,fr FRA,"DF,MF",21-286,27.3,37,19,18,16,3,16,24,66.7,8,31,14,17,24,61,100,3,Matches,Strasbourg,Ligue-1
2273,Guela Doué,ci CIV,DF,22-201,28.5,61,42,38,14,9,36,52,69.2,16,37,6,31,32,93,143,1,Matches,Strasbourg,Ligue-1
2274,Diego Moreira,pt POR,"DF,MF",20-273,27.0,41,26,17,17,7,23,46,50.0,23,23,4,19,34,75,63,0,Matches,Strasbourg,Ligue-1
2275,Dilane Bakwa,fr FRA,"MF,DF",22-253,25.9,26,14,11,8,7,12,23,52.2,11,20,1,19,12,38,26,0,Matches,Strasbourg,Ligue-1
2276,Emanuel Emegha,nl NED,FW,22-092,25.5,6,6,1,2,3,2,6,33.3,4,18,5,13,1,7,30,0,Matches,Strasbourg,Ligue-1
2277,Habib Diarra,sn SEN,"MF,FW",21-123,24.9,22,13,6,13,3,8,20,40.0,12,21,6,15,13,35,44,2,Matches,Strasbourg,Ligue-1
2278,Mamadou Sarr,fr FRA,DF,19-250,24.3,32,20,21,10,1,15,23,65.2,8,25,20,5,23,55,109,2,Matches,Strasbourg,Ligue-1
2279,Sebastian Nanasi,se SWE,"MF,FW",22-355,22.1,20,13,6,12,2,8,21,38.1,13,23,3,20,7,27,18,0,Matches,Strasbourg,Ligue-1
2280,Félix Lemaréchal,fr FRA,"MF,FW",21-272,17.8,33,23,13,15,5,14,29,48.3,15,35,4,31,14,47,19,0,Matches,Strasbourg,Ligue-1
2281,Valentín Barco,ar ARG,"MF,DF",20-287,11.1,29,17,22,6,1,16,24,66.7,8,7,3,4,10,39,25,1,Matches,Strasbourg,Ligue-1
2282,Saidou Sow,gn GUI,DF,22-306,11.3,9,5,6,3,0,6,12,50.0,6,15,9,6,15,24,37,2,Matches,Strasbourg,Ligue-1
2283,Abakar Sylla,ci CIV,DF,22-132,10.5,27,15,14,11,2,15,17,88.2,2,18,10,8,11,38,63,0,Matches,Strasbourg,Ligue-1
2284,Sekou Mara,fr FRA,"FW,MF",22-280,7.2,9,6,0,5,4,3,9,33.3,6,9,0,9,3,12,2,0,Matches,Strasbourg,Ligue-1
2285,Andrew Omobamidele,ie IRL,DF,22-317,6.0,7,4,4,3,0,2,5,40.0,3,12,8,4,8,15,38,0,Matches,Strasbourg,Ligue-1
2286,Guimissongui Ouattara,fr FRA,"DF,FW",19-196,5.1,6,4,3,1,2,3,5,60.0,2,9,0,9,8,14,12,2,Matches,Strasbourg,Ligue-1
2287,Karl-Johan Johnsson,se SWE,GK,35-098,3.0,0,0,0,0,0,0,1,0.0,1,0,0,0,0,0,3,0,Matches,Strasbourg,Ligue-1
2288,Caleb Wiley,us USA,"DF,MF",20-135,3.0,1,0,0,1,0,0,1,0.0,1,3,1,2,4,5,5,0,Matches,Strasbourg,Ligue-1
2289,Junior Mwanga,fr FRA,MF,21-360,3.3,17,9,9,7,1,5,9,55.6,4,2,0,2,2,19,2,0,Matches,Strasbourg,Ligue-1
2290,Samuel Amo-Ameyaw,eng ENG,"DF,FW",18-292,2.4,5,3,3,2,0,2,8,25.0,6,3,0,3,2,7,1,0,Matches,Strasbourg,Ligue-1
2291,Marvin Senaya,tg TOG,DF,24-098,2.5,8,3,5,2,1,6,12,50.0,6,6,2,4,7,15,12,0,Matches,Strasbourg,Ligue-1
2292,Jérémy Sebas,mq MTQ,"FW,MF",22-022,2.1,3,2,1,1,1,2,3,66.7,1,2,0,2,0,3,4,0,Matches,Strasbourg,Ligue-1
2293,Pape Daouda Diongue,sn SEN,"MF,FW",,0.9,2,0,1,1,0,1,2,50.0,1,0,0,0,3,5,2,0,Matches,Strasbourg,Ligue-1
2294,Eduard Sobol,ua UKR,DF,30-016,1.1,0,0,0,0,0,0,2,0.0,2,2,1,1,2,2,14,0,Matches,Strasbourg,Ligue-1
2295,Milos Lukovic,rs SRB,"FW,MF",19-169,0.1,0,0,0,0,0,0,0,,0,0,0,0,0,0,0,0,Matches,Strasbourg,Ligue-1
2296,Nordine Kandil,fr FRA,MF,23-187,0.1,0,0,0,0,0,0,0,,0,0,0,0,0,0,1,0,Matches,Strasbourg,Ligue-1
2297,Thomas Delaine,fr FRA,DF,33-043,0.1,1,1,1,0,0,1,1,100.0,0,0,0,0,1,2,1,0,Matches,Strasbourg,Ligue-1
2298,Óscar Perea,co COL,MF,19-221,0.1,0,0,0,0,0,0,0,,0,0,0,0,0,0,0,0,Matches,Strasbourg,Ligue-1
2299,Karol Fila,pl POL,MF,26-327,0.1,0,0,0,0,0,0,0,,0,0,0,0,0,0,0,0,Matches,Strasbourg,Ligue-1
2300,Aron Dønnum,no NOR,"DF,MF",27-016,28.9,55,34,24,24,7,31,55,56.4,24,29,4,25,28,83,37,1,Matches,Toulouse,Ligue-1
2301,Cristian Cásseres Jr.,ve VEN,MF,25-106,28.0,90,58,41,38,11,42,81,51.9,39,32,7,25,38,128,35,1,Matches,Toulouse,Ligue-1
2302,Charlie Cresswell,eng ENG,DF,22-262,27.8,35,23,19,15,1,28,45,62.2,17,43,27,16,28,63,180,3,Matches,Toulouse,Ligue-1
2303,Guillaume Restes,fr FRA,GK,20-056,26.3,2,1,2,0,0,2,3,66.7,1,0,0,0,1,3,13,1,Matches,Toulouse,Ligue-1
2304,Mark McKenzie,us USA,DF,26-070,25.7,48,28,29,18,1,30,42,71.4,12,26,15,11,21,69,121,1,Matches,Toulouse,Ligue-1
2305,Vincent Sierro,ch SUI,MF,29-210,24.7,44,27,15,23,6,27,54,50.0,27,32,7,25,15,59,42,1,Matches,Toulouse,Ligue-1
2306,Yann Gboho,fr FRA,"MF,FW",24-112,23.9,28,15,6,14,8,12,30,40.0,18,20,0,20,5,33,4,1,Matches,Toulouse,Ligue-1
2307,Gabriel Suazo,cl CHI,DF,27-270,23.8,59,39,25,22,12,30,72,41.7,42,27,3,24,36,95,40,1,Matches,Toulouse,Ligue-1
2308,Djibril Sidibé,fr FRA,DF,32-281,21.6,60,33,31,20,9,29,47,61.7,18,9,2,7,19,79,55,1,Matches,Toulouse,Ligue-1
2309,Zakaria Aboukhlal,ma MAR,"MF,FW",25-077,20.5,19,11,6,7,6,4,21,19.0,17,16,1,15,6,25,8,0,Matches,Toulouse,Ligue-1
2310,Joshua King,no NOR,"FW,MF",33-111,16.9,9,9,4,3,2,4,11,36.4,7,10,3,7,5,14,18,0,Matches,Toulouse,Ligue-1
2311,Frank Magri,cm CMR,"FW,MF",25-244,15.1,6,1,1,4,1,3,8,37.5,5,16,2,14,4,10,9,0,Matches,Toulouse,Ligue-1
2312,Shavy Babicka,ga GAB,"MF,FW",24-339,13.1,21,12,6,11,4,10,21,47.6,11,14,0,14,3,24,4,3,Matches,Toulouse,Ligue-1
2313,Jaydee Canvot,fr FRA,"DF,MF",18-281,10.3,20,9,13,5,2,11,17,64.7,6,9,2,7,10,30,43,1,Matches,Toulouse,Ligue-1
2314,Waren Kamanzi,no NOR,"DF,MF",24-176,9.6,26,12,11,11,4,12,24,50.0,12,4,1,3,8,34,22,0,Matches,Toulouse,Ligue-1
2315,Rasmus Nicolaisen,dk DEN,DF,28-051,6.9,6,3,4,2,0,3,5,60.0,2,10,5,5,10,16,25,0,Matches,Toulouse,Ligue-1
2316,Ümit Akdag,ro ROU,DF,21-212,5.5,8,4,3,4,1,5,12,41.7,7,10,8,2,11,19,19,0,Matches,Toulouse,Ligue-1
2317,Kjetil Haug,no NOR,GK,26-328,5.5,0,0,0,0,0,0,0,,0,0,0,0,0,0,3,0,Matches,Toulouse,Ligue-1
2318,Rafik Messali,fr FRA,DF,22-008,4.9,15,8,6,6,3,7,8,87.5,1,9,1,8,9,24,11,0,Matches,Toulouse,Ligue-1
2319,Denis Genreau,au AUS,MF,25-350,2.5,7,5,4,1,2,4,8,50.0,4,3,0,3,3,10,4,0,Matches,Toulouse,Ligue-1
2320,Niklas Schmidt,de GER,MF,27-066,2.3,6,4,1,5,0,4,7,57.1,3,0,0,0,1,7,4,0,Matches,Toulouse,Ligue-1
2321,Miha Zajc,si SVN,MF,30-309,2.9,4,4,1,2,1,3,5,60.0,2,2,1,1,3,7,7,0,Matches,Toulouse,Ligue-1
2322,Noah Edjouma,fr FRA,"MF,FW",19-214,1.9,2,2,0,1,1,1,2,50.0,1,1,1,0,2,4,2,0,Matches,Toulouse,Ligue-1
2323,Logan Costa,cv CPV,DF,24-035,1.0,2,1,0,2,0,1,1,100.0,0,2,2,0,2,4,4,0,Matches,Toulouse,Ligue-1
2324,Álex Domínguez,es ESP,GK,26-280,0.2,0,0,0,0,0,0,0,,0,0,0,0,0,0,0,0,Matches,Toulouse,Ligue-1
2325,Edhy Zuliani,it ITA,DF,20-268,0.1,0,0,0,0,0,0,0,,0,0,0,0,1,1,0,0,Matches,Toulouse,Ligue-1
2326,Naatan Skyttä,fi FIN,FW,22-364,0.1,1,0,0,0,1,0,0,,0,0,0,0,0,1,0,0,Matches,Toulouse,Ligue-1
2327,Jeffrey Gouweleeuw,nl NED,DF,33-300,30.7,47,25,24,19,4,25,37,67.6,12,30,13,17,33,80,167,0,Matches,Augsburg,Bundesliga
2328,Dimitris Giannoulis,gr GRE,DF,29-201,27.4,45,30,26,15,4,25,43,58.1,18,46,11,35,43,88,70,0,Matches,Augsburg,Bundesliga
2329,Frank Onyeka,ng NGA,MF,27-125,27.0,57,45,21,28,8,22,39,56.4,17,35,9,26,36,93,34,2,Matches,Augsburg,Bundesliga
2330,Marius Wolf,de GER,DF,29-344,23.2,26,16,12,11,3,15,41,36.6,26,27,5,22,23,49,50,1,Matches,Augsburg,Bundesliga
2331,Chrislain Matsima,fr FRA,DF,22-356,26.3,26,18,15,10,1,16,25,64.0,9,47,28,19,50,76,152,0,Matches,Augsburg,Bundesliga
2332,Kristijan Jakić,hr CRO,MF,27-357,23.6,44,21,20,17,7,21,41,51.2,20,39,7,32,28,72,47,1,Matches,Augsburg,Bundesliga
2333,Alexis Claude-Maurice,fr FRA,"MF,FW",26-334,22.0,39,24,10,15,14,17,34,50.0,17,14,0,14,15,54,8,1,Matches,Augsburg,Bundesliga
2334,Elvis Rexhbeçaj,xk KVX,MF,27-186,19.6,27,19,9,14,4,15,35,42.9,20,38,9,29,16,43,22,1,Matches,Augsburg,Bundesliga
2335,Samuel Essende,cd COD,FW,27-103,18.1,7,6,1,3,3,3,4,75.0,1,13,2,11,0,7,11,1,Matches,Augsburg,Bundesliga
2336,Phillip Tietz,de GER,FW,27-301,17.6,11,6,2,7,2,5,8,62.5,3,7,1,6,5,16,26,0,Matches,Augsburg,Bundesliga
2337,Finn Dahmen,de GER,GK,27-040,17.0,1,0,1,0,0,1,2,50.0,1,0,0,0,0,1,8,0,Matches,Augsburg,Bundesliga
2338,Nediljko Labrović,hr CRO,GK,25-208,15.0,0,0,0,0,0,0,0,,0,0,0,0,0,0,12,1,Matches,Augsburg,Bundesliga
2339,Keven Schlotterbeck,de GER,DF,28-008,14.4,19,17,9,9,1,12,16,75.0,4,13,6,7,15,34,73,1,Matches,Augsburg,Bundesliga
2340,Cedric Zesiger,ch SUI,DF,26-316,11.7,11,5,7,4,0,8,12,66.7,4,16,9,7,20,31,81,1,Matches,Augsburg,Bundesliga
2341,Fredrik Jensen,fi FIN,MF,27-239,8.3,6,6,1,3,2,3,4,75.0,1,8,1,7,4,10,16,0,Matches,Augsburg,Bundesliga
2342,Maximilian Bauer,de GER,DF,25-086,7.3,14,8,5,7,2,9,14,64.3,5,10,4,6,6,20,35,1,Matches,Augsburg,Bundesliga
2343,Arne Maier,de GER,MF,26-118,9.7,12,6,4,8,0,7,12,58.3,5,15,1,14,4,16,12,1,Matches,Augsburg,Bundesliga
2344,Henri Koudossou,de GER,DF,25-245,7.9,18,10,6,11,1,11,19,57.9,8,8,2,6,14,32,36,0,Matches,Augsburg,Bundesliga
2345,Mert Kömür,de GER,MF,19-293,5.9,3,2,2,0,1,0,3,0.0,3,9,3,6,3,6,4,1,Matches,Augsburg,Bundesliga
2346,Ruben Vargas,ch SUI,"MF,FW",26-274,3.4,2,1,1,1,0,1,4,25.0,3,1,0,1,2,4,1,1,Matches,Augsburg,Bundesliga
2347,Noahkai Banks,us USA,DF,18-156,3.1,11,5,6,4,1,3,7,42.9,4,4,1,3,5,16,28,0,Matches,Augsburg,Bundesliga
2348,Mads Pedersen,dk DEN,DF,28-247,2.6,8,7,5,2,1,4,5,80.0,1,4,0,4,2,10,6,0,Matches,Augsburg,Bundesliga
2349,Tim Breithaupt,de GER,MF,23-088,1.3,1,1,0,1,0,0,4,0.0,4,1,0,1,2,3,0,0,Matches,Augsburg,Bundesliga
2350,Steve Mounié,bj BEN,"FW,MF",30-219,3.6,4,4,0,1,3,0,1,0.0,1,1,1,0,1,5,4,1,Matches,Augsburg,Bundesliga
2351,Robert Gumny,pl POL,DF,26-336,2.0,2,2,1,1,0,1,3,33.3,2,2,0,2,1,3,5,0,Matches,Augsburg,Bundesliga
2352,Arne Engels,be BEL,"MF,FW",21-240,0.9,0,0,0,0,0,0,0,,0,1,1,0,0,0,0,0,Matches,Augsburg,Bundesliga
2353,Yusuf Kabadayı,de GER,"FW,MF",21-093,0.8,1,0,0,1,0,0,0,,0,1,0,1,0,1,0,0,Matches,Augsburg,Bundesliga
2354,Mergim Berisha,de GER,FW,26-360,0.4,1,0,0,1,0,1,1,100.0,0,2,1,1,0,1,0,0,Matches,Augsburg,Bundesliga
2355,Niklas Dorsch,de GER,MF,27-111,0.4,0,0,0,0,0,0,0,,0,1,0,1,0,0,0,0,Matches,Augsburg,Bundesliga
2356,Joshua Kimmich,de GER,MF,30-087,29.6,46,28,11,28,7,29,46,63.0,17,22,3,19,24,70,33,3,Matches,Bayern-Munich,Bundesliga
2357,Kim Min-jae,kr KOR,DF,28-172,25.4,35,20,18,13,4,11,21,52.4,10,23,10,13,37,72,91,4,Matches,Bayern-Munich,Bundesliga
2358,Harry Kane,eng ENG,FW,31-282,25.1,12,10,3,7,2,2,6,33.3,4,13,2,11,2,14,14,0,Matches,Bayern-Munich,Bundesliga
2359,Michael Olise,fr FRA,"FW,MF",23-145,23.9,34,21,10,21,3,16,34,47.1,18,23,1,22,8,42,13,2,Matches,Bayern-Munich,Bundesliga
2360,Jamal Musiala,de GER,MF,22-069,20.0,36,21,7,16,13,12,29,41.4,17,30,0,30,8,44,5,1,Matches,Bayern-Munich,Bundesliga
2361,Manuel Neuer,de GER,GK,39-040,20.0,1,0,1,0,0,1,1,100.0,0,0,0,0,0,1,8,1,Matches,Bayern-Munich,Bundesliga
2362,Dayot Upamecano,fr FRA,DF,26-191,19.5,36,22,18,16,2,16,29,55.2,13,17,7,10,34,70,45,1,Matches,Bayern-Munich,Bundesliga
2363,Leroy Sané,de GER,FW,29-115,17.5,21,14,4,8,9,11,21,52.4,10,8,0,8,7,28,3,0,Matches,Bayern-Munich,Bundesliga
2364,Alphonso Davies,ca CAN,DF,24-185,17.3,30,17,7,17,6,17,26,65.4,9,14,1,13,13,43,22,2,Matches,Bayern-Munich,Bundesliga
2365,Konrad Laimer,at AUT,DF,27-344,17.1,44,24,16,20,8,21,46,45.7,25,23,1,22,8,52,23,1,Matches,Bayern-Munich,Bundesliga
2366,Raphaël Guerreiro,pt POR,"DF,MF",31-135,15.8,18,11,9,6,3,12,16,75.0,4,8,0,8,9,27,15,1,Matches,Bayern-Munich,Bundesliga
2367,Aleksandar Pavlovic,de GER,MF,21-003,14.8,35,20,11,15,9,19,28,67.9,9,17,3,14,4,39,12,0,Matches,Bayern-Munich,Bundesliga
2368,Eric Dier,eng ENG,DF,31-111,14.3,17,10,6,9,2,11,16,68.8,5,17,7,10,18,35,69,1,Matches,Bayern-Munich,Bundesliga
2369,Leon Goretzka,de GER,MF,30-089,13.5,20,11,5,12,3,10,20,50.0,10,21,4,17,17,37,22,1,Matches,Bayern-Munich,Bundesliga
2370,Kingsley Coman,fr FRA,FW,28-327,12.9,15,10,5,5,5,6,10,60.0,4,10,0,10,8,23,15,0,Matches,Bayern-Munich,Bundesliga
2371,Serge Gnabry,de GER,"FW,MF",29-296,12.7,19,11,6,6,7,8,12,66.7,4,11,0,11,6,25,9,0,Matches,Bayern-Munich,Bundesliga
2372,Thomas Müller,de GER,"MF,FW",35-235,12.0,7,4,2,3,2,3,14,21.4,11,9,0,9,2,9,12,0,Matches,Bayern-Munich,Bundesliga
2373,Jonas Urbig,de GER,GK,21-271,8.0,0,0,0,0,0,0,0,,0,0,0,0,0,0,9,2,Matches,Bayern-Munich,Bundesliga
2374,Josip Stanišić,hr CRO,DF,25-034,8.1,11,10,5,4,2,5,11,45.5,6,9,5,4,5,16,24,1,Matches,Bayern-Munich,Bundesliga
2375,João Palhinha,pt POR,MF,29-301,7.4,20,14,6,11,3,11,15,73.3,4,12,1,11,4,24,9,1,Matches,Bayern-Munich,Bundesliga
2376,Sacha Boey,fr FRA,DF,24-235,6.3,18,5,6,4,8,11,15,73.3,4,6,0,6,2,20,13,0,Matches,Bayern-Munich,Bundesliga
2377,Daniel Peretz,il ISR,GK,24-300,3.0,0,0,0,0,0,0,1,0.0,1,0,0,0,0,0,2,0,Matches,Bayern-Munich,Bundesliga
2378,Hiroki Ito,jp JPN,DF,25-359,2.8,2,0,1,1,0,1,1,100.0,0,3,2,1,6,8,15,1,Matches,Bayern-Munich,Bundesliga
2379,Mathys Tel,fr FRA,"FW,MF",20-009,2.8,2,2,0,2,0,0,0,,0,0,0,0,1,3,1,0,Matches,Bayern-Munich,Bundesliga
2380,Sven Ulreich,de GER,GK,36-276,1.0,0,0,0,0,0,0,0,,0,0,0,0,0,0,0,0,Matches,Bayern-Munich,Bundesliga
2381,Gabriel Vidovic,hr CRO,MF,21-156,0.2,0,0,0,0,0,0,0,,0,2,0,2,0,0,0,0,Matches,Bayern-Munich,Bundesliga
2382,Adam Aznou,ma MAR,DF,18-338,0.2,0,0,0,0,0,0,0,,0,0,0,0,0,0,1,0,Matches,Bayern-Munich,Bundesliga
2383,Jonah Kusi-Asare,se SWE,FW,17-306,0.0,1,0,0,0,1,0,0,,0,0,0,0,0,1,0,0,Matches,Bayern-Munich,Bundesliga
2384,Arijon Ibrahimović,de GER,FW,19-146,0.0,0,0,0,0,0,0,0,,0,0,0,0,0,0,0,0,Matches,Bayern-Munich,Bundesliga
2385,Maximilian Wittek,de GER,DF,29-258,28.1,61,40,38,18,5,37,52,71.2,15,52,8,44,27,88,81,2,Matches,Bochum,Bundesliga
2386,Ibrahima Sissoko,ml MLI,MF,27-191,27.6,61,41,28,28,5,24,44,54.5,20,35,10,25,35,96,56,0,Matches,Bochum,Bundesliga
2387,Felix Passlack,de GER,"DF,MF",26-342,24.4,51,23,31,13,7,30,55,54.5,25,39,10,29,17,68,58,1,Matches,Bochum,Bundesliga
2388,Matúš Bero,sk SVK,MF,29-242,27.0,60,32,30,20,10,26,57,45.6,31,37,9,28,17,77,35,1,Matches,Bochum,Bundesliga
2389,Philipp Hofmann,de GER,FW,32-037,25.3,17,12,4,6,7,8,15,53.3,7,14,1,13,4,21,33,0,Matches,Bochum,Bundesliga
2390,Tim Oermann,de GER,DF,21-212,22.8,44,26,21,19,4,23,40,57.5,17,30,14,16,20,64,61,0,Matches,Bochum,Bundesliga
2391,Patrick Drewes,de GER,GK,32-091,21.0,0,0,0,0,0,0,1,0.0,1,1,0,1,0,0,11,1,Matches,Bochum,Bundesliga
2392,Ivan Ordets,ua UKR,DF,32-302,19.7,18,8,13,5,0,10,12,83.3,2,27,14,13,37,55,128,3,Matches,Bochum,Bundesliga
2393,Bernardo,br BRA,DF,29-357,17.8,44,26,31,12,1,27,35,77.1,8,33,16,17,25,69,91,4,Matches,Bochum,Bundesliga
2394,Jakov Medić,hr CRO,DF,26-241,16.9,13,11,9,3,1,8,18,44.4,10,29,19,10,21,34,102,4,Matches,Bochum,Bundesliga
2395,Moritz Broschinski,de GER,"FW,MF",24-225,15.3,18,14,6,6,6,5,14,35.7,9,18,0,18,1,19,18,0,Matches,Bochum,Bundesliga
2396,Anthony Losilla,fr FRA,MF,39-057,12.0,28,16,14,11,3,16,32,50.0,16,21,7,14,18,46,25,1,Matches,Bochum,Bundesliga
2397,Gerrit Holtmann,ph PHI,"DF,FW",30-042,12.1,24,19,14,8,2,12,23,52.2,11,16,4,12,16,40,15,0,Matches,Bochum,Bundesliga
2398,Tom Krauß,de GER,MF,23-318,11.5,33,17,19,12,2,18,36,50.0,18,25,2,23,9,42,16,1,Matches,Bochum,Bundesliga
2399,Dani de Wit,nl NED,"MF,FW",27-098,12.2,25,13,9,13,3,16,29,55.2,13,15,4,11,11,36,23,1,Matches,Bochum,Bundesliga
2400,Timo Horn,de GER,GK,31-359,11.0,0,0,0,0,0,0,0,,0,0,0,0,0,0,8,1,Matches,Bochum,Bundesliga
2401,Erhan Mašović,rs SRB,DF,26-165,10.1,14,10,10,4,0,13,28,46.4,15,17,11,6,12,26,55,0,Matches,Bochum,Bundesliga
2402,Giorgos Masouras,gr GRE,"FW,MF",31-125,9.9,16,8,5,6,5,7,14,50.0,7,9,1,8,3,19,1,1,Matches,Bochum,Bundesliga
2403,Myron Boadu,nl NED,FW,24-112,9.7,2,1,0,0,2,1,5,20.0,4,3,0,3,1,3,4,0,Matches,Bochum,Bundesliga
2404,Koji Miyoshi,jp JPN,"FW,MF",28-041,5.0,8,5,2,1,5,4,9,44.4,5,10,1,9,2,10,2,0,Matches,Bochum,Bundesliga
2405,Lukas Daschner,de GER,"MF,FW",26-217,4.6,4,2,1,2,1,2,9,22.2,7,5,0,5,0,4,5,0,Matches,Bochum,Bundesliga
2406,Cristian Gamboa,cr CRC,DF,35-194,2.3,8,3,5,3,0,3,9,33.3,6,2,0,2,2,10,6,0,Matches,Bochum,Bundesliga
2407,Mats Pannewig,de GER,MF,20-190,1.6,5,3,4,1,0,1,9,11.1,8,7,1,6,1,6,5,0,Matches,Bochum,Bundesliga
2408,Moritz-Broni Kwarteng,gh GHA,"MF,FW",27-008,1.9,4,3,1,1,2,1,2,50.0,1,0,0,0,0,4,1,0,Matches,Bochum,Bundesliga
2409,Aliou Badara Baldé,gn GUI,"MF,FW",22-145,1.0,1,1,1,0,0,0,0,,0,2,0,2,0,1,0,0,Matches,Bochum,Bundesliga
2410,Samuel Bamba,de GER,"FW,MF",21-082,0.3,1,1,1,0,0,0,0,,0,0,0,0,0,1,0,0,Matches,Bochum,Bundesliga
2411,Gregor Kobel,ch SUI,GK,27-151,30.0,0,0,0,0,0,0,0,,0,0,0,0,0,0,22,3,Matches,Dortmund,Bundesliga
2412,Serhou Guirassy,gn GUI,FW,29-055,26.9,6,5,2,1,3,2,5,40.0,3,8,3,5,4,10,33,0,Matches,Dortmund,Bundesliga
2413,Pascal Groß,de GER,"MF,DF",33-325,25.0,44,28,11,26,7,15,49,30.6,34,43,12,31,9,53,27,1,Matches,Dortmund,Bundesliga
2414,Julian Brandt,de GER,MF,29-004,23.7,22,10,11,8,3,14,36,38.9,22,17,0,17,14,36,12,1,Matches,Dortmund,Bundesliga
2415,Julian Ryerson,no NOR,DF,27-170,23.1,42,27,25,11,6,23,40,57.5,17,28,2,26,18,60,25,1,Matches,Dortmund,Bundesliga
2416,Emre Can,de GER,"DF,MF",31-114,23.1,48,28,30,15,3,17,35,48.6,18,30,17,13,20,68,89,3,Matches,Dortmund,Bundesliga
2417,Nico Schlotterbeck,de GER,DF,25-156,22.0,38,24,21,16,1,27,45,60.0,18,31,15,16,22,60,79,1,Matches,Dortmund,Bundesliga
2418,Ramy Bensebaini,dz ALG,DF,30-020,20.5,45,21,22,17,6,27,45,60.0,18,40,8,32,27,72,77,1,Matches,Dortmund,Bundesliga
2419,Jamie Gittens,eng ENG,"FW,MF",20-271,19.6,30,19,12,11,7,14,18,77.8,4,16,0,16,10,40,4,0,Matches,Dortmund,Bundesliga
2420,Waldemar Anton,de GER,DF,28-290,19.7,34,21,18,10,6,17,23,73.9,6,29,14,15,28,62,94,1,Matches,Dortmund,Bundesliga
2421,Maximilian Beier,de GER,"FW,MF",22-201,17.7,25,16,8,11,6,12,31,38.7,19,15,1,14,7,32,14,1,Matches,Dortmund,Bundesliga
2422,Marcel Sabitzer,at AUT,"MF,FW",31-050,16.5,27,17,7,14,6,15,25,60.0,10,18,6,12,10,37,29,1,Matches,Dortmund,Bundesliga
2423,Felix Nmecha,de GER,MF,24-208,15.4,34,22,6,19,9,12,22,54.5,10,20,5,15,22,56,28,1,Matches,Dortmund,Bundesliga
2424,Karim Adeyemi,de GER,"FW,MF",23-108,14.3,20,14,6,6,8,8,20,40.0,12,13,1,12,6,26,5,0,Matches,Dortmund,Bundesliga
2425,Niklas Süle,de GER,DF,29-245,9.8,11,9,6,5,0,8,12,66.7,4,8,4,4,4,15,36,1,Matches,Dortmund,Bundesliga
2426,Yan Couto,br BRA,"DF,FW",22-337,9.9,24,16,17,2,5,14,25,56.0,11,12,1,11,9,33,30,2,Matches,Dortmund,Bundesliga
2427,Donyell Malen,nl NED,"FW,MF",26-117,6.8,0,0,0,0,0,0,2,0.0,2,2,0,2,3,3,6,0,Matches,Dortmund,Bundesliga
2428,Daniel Svensson,se SWE,"DF,FW",23-083,6.7,10,7,4,4,2,4,8,50.0,4,8,3,5,4,14,22,0,Matches,Dortmund,Bundesliga
2429,Salih Özcan,tr TUR,MF,27-115,4.2,11,7,6,4,1,7,12,58.3,5,7,0,7,11,22,10,0,Matches,Dortmund,Bundesliga
2430,Gio Reyna,us USA,MF,22-174,3.8,6,0,3,0,3,3,4,75.0,1,3,1,2,0,6,9,0,Matches,Dortmund,Bundesliga
2431,Julien Duranville,be BEL,"FW,MF",19-001,3.1,3,0,0,3,0,1,1,100.0,0,1,0,1,0,3,3,0,Matches,Dortmund,Bundesliga
2432,Alexander Meyer,de GER,GK,34-023,2.0,0,0,0,0,0,0,0,,0,0,0,0,0,0,0,0,Matches,Dortmund,Bundesliga
2433,Carney Chukwuemeka,eng ENG,MF,21-198,2.6,6,5,3,1,2,1,1,100.0,0,5,0,5,1,7,1,0,Matches,Dortmund,Bundesliga
2434,Almugera Kabar,de GER,DF,18-334,1.5,5,3,2,2,1,3,3,100.0,0,1,0,1,1,6,4,0,Matches,Dortmund,Bundesliga
2435,Yannik Lührs,de GER,DF,21-239,1.4,1,1,1,0,0,0,0,,0,0,0,0,2,3,4,0,Matches,Dortmund,Bundesliga
2436,Ayman Azhil,ma MAR,MF,24-026,0.3,1,1,1,0,0,0,0,,0,0,0,0,0,1,0,0,Matches,Dortmund,Bundesliga
2437,Cole Campbell,us USA,"MF,FW",19-075,0.2,0,0,0,0,0,0,0,,0,0,0,0,0,0,1,0,Matches,Dortmund,Bundesliga
2438,Kjell-Arik Wätjen,de GER,MF,19-079,0.2,0,0,0,0,0,0,0,,0,0,0,0,0,0,2,0,Matches,Dortmund,Bundesliga
2439,Arthur Theate,be BEL,DF,24-346,28.0,34,24,17,16,1,20,41,48.8,21,42,19,23,36,70,154,3,Matches,Eintracht-Frankfurt,Bundesliga
2440,Hugo Ekitike,fr FRA,FW,22-320,26.5,16,12,3,8,5,4,11,36.4,7,13,1,12,7,23,24,0,Matches,Eintracht-Frankfurt,Bundesliga
2441,Robin Koch,de GER,DF,28-293,26.7,22,10,13,7,2,10,22,45.5,12,38,24,14,24,46,172,4,Matches,Eintracht-Frankfurt,Bundesliga
2442,Rasmus Kristensen,dk DEN,DF,27-299,25.9,57,32,37,15,5,39,66,59.1,27,47,13,34,20,77,93,1,Matches,Eintracht-Frankfurt,Bundesliga
2443,Hugo Larsson,se SWE,MF,20-313,24.6,45,26,17,23,5,20,39,51.3,19,40,10,30,28,73,32,1,Matches,Eintracht-Frankfurt,Bundesliga
2444,Tuta,br BRA,"DF,MF",25-306,24.6,44,27,25,17,2,28,40,70.0,12,41,21,20,40,84,133,1,Matches,Eintracht-Frankfurt,Bundesliga
2445,Kevin Trapp,de GER,GK,34-302,23.5,0,0,0,0,0,0,0,,0,0,0,0,0,0,12,3,Matches,Eintracht-Frankfurt,Bundesliga
2446,Ellyes Skhiri,tn TUN,MF,29-361,23.1,35,22,11,20,4,17,41,41.5,24,30,7,23,29,64,43,4,Matches,Eintracht-Frankfurt,Bundesliga
2447,Nathaniel Brown,de GER,"DF,MF",21-324,19.6,62,39,32,16,14,40,50,80.0,10,29,0,29,15,77,54,1,Matches,Eintracht-Frankfurt,Bundesliga
2448,Mario Götze,de GER,"MF,FW",32-337,17.1,41,28,18,20,3,15,36,41.7,21,15,1,14,7,48,8,0,Matches,Eintracht-Frankfurt,Bundesliga
2449,Omar Marmoush,eg EGY,FW,26-088,16.1,12,8,0,3,9,3,7,42.9,4,7,1,6,2,14,2,0,Matches,Eintracht-Frankfurt,Bundesliga
2450,Ansgar Knauff,de GER,"MF,DF",23-116,15.9,39,20,17,15,7,12,25,48.0,13,22,4,18,12,51,22,0,Matches,Eintracht-Frankfurt,Bundesliga
2451,Nnamdi Collins,de GER,DF,21-116,15.4,29,20,20,7,2,15,20,75.0,5,22,11,11,14,43,66,3,Matches,Eintracht-Frankfurt,Bundesliga
2452,Fares Chaïbi,dz ALG,"MF,FW",22-159,10.3,13,9,4,5,4,7,19,36.8,12,10,0,10,10,23,31,1,Matches,Eintracht-Frankfurt,Bundesliga
2453,Jean Mattéo Bahoya,fr FRA,"MF,FW",19-364,9.7,29,18,11,13,5,16,26,61.5,10,13,1,12,4,33,10,1,Matches,Eintracht-Frankfurt,Bundesliga
2454,Kauã Santos,br BRA,GK,22-025,8.5,0,0,0,0,0,0,0,,0,0,0,0,0,0,10,2,Matches,Eintracht-Frankfurt,Bundesliga
2455,Oscar Højlund,dk DEN,MF,20-122,7.8,21,12,8,9,4,8,16,50.0,8,15,7,8,5,26,8,1,Matches,Eintracht-Frankfurt,Bundesliga
2456,Can Uzun,tr TUR,"MF,FW",19-176,7.2,10,4,1,4,5,5,9,55.6,4,9,0,9,1,11,3,0,Matches,Eintracht-Frankfurt,Bundesliga
2457,Niels Nkounkou,fr FRA,"DF,MF",24-186,4.2,13,10,7,3,3,4,7,57.1,3,5,2,3,7,20,15,0,Matches,Eintracht-Frankfurt,Bundesliga
2458,Mahmoud Dahoud,de GER,MF,29-125,4.0,9,4,4,5,0,4,6,66.7,2,5,1,4,2,11,5,0,Matches,Eintracht-Frankfurt,Bundesliga
2459,Junior Dina Ebimbe,fr FRA,"MF,FW",24-166,3.3,3,2,1,2,0,1,3,33.3,2,4,0,4,7,10,6,0,Matches,Eintracht-Frankfurt,Bundesliga
2460,Michy Batshuayi,be BEL,FW,31-216,2.8,1,1,1,0,0,1,1,100.0,0,2,0,2,1,2,0,0,Matches,Eintracht-Frankfurt,Bundesliga
2461,Igor Matanovic,hr CRO,FW,22-036,3.5,2,0,0,2,0,0,1,0.0,1,3,0,3,1,3,9,0,Matches,Eintracht-Frankfurt,Bundesliga
2462,Elye Wahi,fr FRA,"FW,MF",22-124,2.2,0,0,0,0,0,0,1,0.0,1,1,0,1,0,0,1,0,Matches,Eintracht-Frankfurt,Bundesliga
2463,Aurele Amenda,ch SUI,DF,21-279,1.0,1,0,1,0,0,0,0,,0,2,2,0,1,2,8,0,Matches,Eintracht-Frankfurt,Bundesliga
2464,Timothy Chandler,us USA,DF,35-038,0.3,0,0,0,0,0,0,0,,0,0,0,0,3,3,2,0,Matches,Eintracht-Frankfurt,Bundesliga
2465,Ritsu Doan,jp JPN,"FW,MF",26-324,29.8,61,39,29,26,6,25,45,55.6,20,53,2,51,14,75,38,1,Matches,Freiburg,Bundesliga
2466,Maximilian Eggestein,de GER,MF,28-149,29.6,53,29,20,25,8,24,43,55.8,19,36,10,26,36,89,47,1,Matches,Freiburg,Bundesliga
2467,Philipp Lienhart,at AUT,DF,28-299,28.8,22,13,12,10,0,15,30,50.0,15,28,18,10,35,57,111,2,Matches,Freiburg,Bundesliga
2468,Vincenzo Grifo,it ITA,"FW,MF",32-029,25.2,25,19,11,12,2,12,31,38.7,19,22,2,20,8,33,20,1,Matches,Freiburg,Bundesliga
2469,Christian Günter,de GER,DF,32-067,25.4,23,21,12,8,3,16,29,55.2,13,24,10,14,8,31,46,1,Matches,Freiburg,Bundesliga
2470,Matthias Ginter,de GER,DF,31-107,26.5,29,17,14,11,4,15,28,53.6,13,34,22,12,18,47,131,5,Matches,Freiburg,Bundesliga
2471,Patrick Osterhage,de GER,MF,25-094,24.2,44,28,16,26,2,14,29,48.3,15,26,3,23,18,62,35,0,Matches,Freiburg,Bundesliga
2472,Noah Atubolu,de GER,GK,22-346,23.6,0,0,0,0,0,0,0,,0,0,0,0,0,0,13,4,Matches,Freiburg,Bundesliga
2473,Lukas Kübler,de GER,DF,32-249,20.0,40,21,17,20,3,27,48,56.3,21,31,12,19,50,90,58,3,Matches,Freiburg,Bundesliga
2474,Lucas Höler,de GER,"FW,MF",30-300,19.2,34,21,17,14,3,8,22,36.4,14,29,7,22,7,41,27,0,Matches,Freiburg,Bundesliga
2475,Junior Adamu,at AUT,FW,23-334,15.4,7,3,3,2,2,2,9,22.2,7,13,0,13,12,19,16,0,Matches,Freiburg,Bundesliga
2476,Eren Dinkçi,de GER,"MF,FW",23-144,13.3,21,13,8,8,5,7,23,30.4,16,22,2,20,7,28,7,0,Matches,Freiburg,Bundesliga
2477,Max Rosenfelder,de GER,DF,22-085,12.3,25,16,16,9,0,12,17,70.6,5,15,9,6,7,32,62,0,Matches,Freiburg,Bundesliga
2478,Merlin Röhl,de GER,"MF,FW",22-305,10.6,16,10,4,10,2,9,11,81.8,2,8,1,7,5,21,2,0,Matches,Freiburg,Bundesliga
2479,Kiliann Sildillia,fr FRA,DF,22-355,8.9,17,10,8,6,3,7,13,53.8,6,16,5,11,11,28,38,0,Matches,Freiburg,Bundesliga
2480,Florian Müller,de GER,GK,27-174,8.4,0,0,0,0,0,0,0,,0,0,0,0,0,0,3,0,Matches,Freiburg,Bundesliga
2481,Nicolas Höfler,de GER,MF,35-058,8.8,33,23,13,18,2,20,31,64.5,11,7,1,6,14,47,28,1,Matches,Freiburg,Bundesliga
2482,Michael Gregoritsch,at AUT,FW,31-018,6.9,3,2,1,0,2,0,4,0.0,4,2,1,1,0,3,10,0,Matches,Freiburg,Bundesliga
2483,Jordy Makengo,fr FRA,DF,23-276,6.5,14,8,9,4,1,9,15,60.0,6,7,3,4,6,20,23,0,Matches,Freiburg,Bundesliga
2484,Johan Manzambi,ch SUI,"FW,MF",19-204,2.3,6,2,1,2,3,1,4,25.0,3,5,0,5,2,8,4,0,Matches,Freiburg,Bundesliga
2485,Jan-Niklas Beste,de GER,"FW,MF",26-122,2.4,2,1,0,1,1,1,7,14.3,6,3,0,3,1,3,7,0,Matches,Freiburg,Bundesliga
2486,Florent Muslija,xk KVX,"FW,MF",26-304,1.9,5,4,3,1,1,2,2,100.0,0,0,0,0,1,6,1,0,Matches,Freiburg,Bundesliga
2487,Noah Weißhaupt,de GER,FW,23-228,0.9,0,0,0,0,0,0,1,0.0,1,0,0,0,0,0,1,0,Matches,Freiburg,Bundesliga
2488,Roland Sallai,hu HUN,"FW,MF",27-349,0.5,2,1,1,1,0,0,0,,0,0,0,0,1,3,0,0,Matches,Freiburg,Bundesliga
2489,Ifechukwu Ogbus,ch SUI,DF,19-140,0.2,1,1,0,0,1,0,1,0.0,1,0,0,0,1,2,2,0,Matches,Freiburg,Bundesliga
2490,Maximilian Philipp,de GER,"MF,FW",31-066,0.2,0,0,0,0,0,0,0,,0,0,0,0,0,0,0,0,Matches,Freiburg,Bundesliga
2491,Julian Weigl,de GER,MF,29-240,30.0,50,23,24,21,5,25,41,61.0,16,49,22,27,46,96,77,2,Matches,Monchengladbach,Bundesliga
2492,Ko Itakura,jp JPN,DF,28-099,30.0,40,29,23,16,1,21,34,61.8,13,40,21,19,25,65,169,0,Matches,Monchengladbach,Bundesliga
2493,Tim Kleindienst,de GER,FW,29-248,29.4,27,14,5,13,9,8,33,24.2,25,45,9,36,11,38,65,1,Matches,Monchengladbach,Bundesliga
2494,Joe Scally,us USA,DF,22-126,27.9,42,30,23,17,2,26,45,57.8,19,33,11,22,16,58,84,2,Matches,Monchengladbach,Bundesliga
2495,Robin Hack,de GER,FW,26-252,22.6,19,15,8,8,3,11,27,40.7,16,30,2,28,9,28,27,0,Matches,Monchengladbach,Bundesliga
2496,Nico Elvedi,ch SUI,DF,28-218,22.2,36,23,26,6,4,17,23,73.9,6,35,27,8,29,65,153,0,Matches,Monchengladbach,Bundesliga
2497,Alassane Pléa,fr FRA,"MF,FW",32-057,20.0,7,3,0,2,5,4,12,33.3,8,10,0,10,2,9,7,1,Matches,Monchengladbach,Bundesliga
2498,Lukas Ullrich,de GER,DF,21-051,19.1,22,13,15,6,1,12,31,38.7,19,24,9,15,19,41,69,1,Matches,Monchengladbach,Bundesliga
2499,Rocco Reitz,de GER,MF,22-342,18.5,47,21,20,23,4,20,38,52.6,18,32,13,19,45,92,52,1,Matches,Monchengladbach,Bundesliga
2500,Moritz Nicolas,de GER,GK,27-197,18.2,0,0,0,0,0,0,0,,0,1,0,1,1,1,8,1,Matches,Monchengladbach,Bundesliga
2501,Kevin Stöger,at AUT,MF,31-252,16.8,37,21,23,10,4,16,37,43.2,21,24,3,21,15,52,26,3,Matches,Monchengladbach,Bundesliga
2502,Franck Honorat,fr FRA,FW,28-268,14.2,15,6,8,4,3,1,6,16.7,5,9,1,8,4,19,27,1,Matches,Monchengladbach,Bundesliga
2503,Philipp Sander,de GER,MF,27-074,14.0,32,16,16,14,2,10,21,47.6,11,15,6,9,21,53,42,3,Matches,Monchengladbach,Bundesliga
2504,Marvin Friedrich,de GER,DF,29-144,11.0,15,9,12,3,0,9,16,56.3,7,16,12,4,5,20,57,0,Matches,Monchengladbach,Bundesliga
2505,Nathan N'Goumou,cm CMR,FW,25-053,9.2,17,11,11,4,2,6,11,54.5,5,8,2,6,4,21,16,0,Matches,Monchengladbach,Bundesliga
2506,Jonas Omlin,ch SUI,GK,31-116,8.9,0,0,0,0,0,0,1,0.0,1,0,0,0,0,0,3,1,Matches,Monchengladbach,Bundesliga
2507,Luca Netz,de GER,DF,21-356,10.8,24,14,14,8,2,13,19,68.4,6,17,4,13,10,34,36,0,Matches,Monchengladbach,Bundesliga
2508,Tomáš Čvančara,cz CZE,FW,24-266,8.8,4,1,3,1,0,2,7,28.6,5,6,3,3,5,9,17,0,Matches,Monchengladbach,Bundesliga
2509,Stefan Lainer,at AUT,DF,32-252,6.7,19,11,13,5,1,11,13,84.6,2,9,5,4,10,29,21,0,Matches,Monchengladbach,Bundesliga
2510,Tiago Cardoso,lu LUX,GK,19-029,4.2,1,0,1,0,0,1,1,100.0,0,0,0,0,0,1,2,2,Matches,Monchengladbach,Bundesliga
2511,Florian Neuhaus,de GER,MF,28-051,4.1,10,3,7,3,0,7,17,41.2,10,9,2,7,6,16,5,1,Matches,Monchengladbach,Bundesliga
2512,Fabio Chiarodia,it ITA,DF,19-335,3.2,9,3,5,4,0,4,5,80.0,1,7,2,5,7,16,49,1,Matches,Monchengladbach,Bundesliga
2513,Tobias Sippel,de GER,GK,37-045,0.7,0,0,0,0,0,0,0,,0,0,0,0,0,0,0,0,Matches,Monchengladbach,Bundesliga
2514,Shiō Fukuda,jp JPN,"FW,MF",21-028,0.6,0,0,0,0,0,0,0,,0,1,0,1,0,0,0,0,Matches,Monchengladbach,Bundesliga
2515,Grant Ranos,am ARM,FW,21-290,0.2,1,0,0,1,0,0,1,0.0,1,2,0,2,0,1,0,0,Matches,Monchengladbach,Bundesliga
2516,Noah Pesch,hr CRO,FW,19-353,0.1,1,0,0,0,1,0,0,,0,0,0,0,0,1,0,0,Matches,Monchengladbach,Bundesliga
2517,Patrick Mainka,de GER,DF,30-181,32.0,56,28,34,20,2,34,53,64.2,19,57,32,25,66,122,199,0,Matches,Heidenheim,Bundesliga
2518,Kevin Müller,de GER,GK,34-052,31.7,3,2,3,0,0,3,3,100.0,0,0,0,0,0,3,12,4,Matches,Heidenheim,Bundesliga
2519,Jan Schöppner,de GER,MF,25-328,28.3,52,29,17,26,9,19,57,33.3,38,37,6,31,43,95,89,1,Matches,Heidenheim,Bundesliga
2520,Benedikt Gimber,de GER,DF,28-076,28.2,70,45,47,22,1,37,62,59.7,25,52,19,33,31,101,129,1,Matches,Heidenheim,Bundesliga
2521,Omar Traoré,de GER,DF,27-091,27.2,46,23,30,15,1,23,39,59.0,16,34,6,28,20,66,62,0,Matches,Heidenheim,Bundesliga
2522,Marvin Pieringer,de GER,"FW,MF",25-214,22.6,22,13,5,12,5,5,8,62.5,3,21,2,19,8,30,31,0,Matches,Heidenheim,Bundesliga
2523,Jonas Föhrenbach,de GER,DF,29-100,20.2,44,23,24,15,5,22,35,62.9,13,29,3,26,16,60,57,0,Matches,Heidenheim,Bundesliga
2524,Paul Wanner,de GER,"MF,FW",19-134,17.7,33,22,15,17,1,14,30,46.7,16,13,0,13,4,37,20,0,Matches,Heidenheim,Bundesliga
2525,Niklas Dorsch,de GER,MF,27-111,13.5,25,14,11,14,0,12,20,60.0,8,14,1,13,15,40,17,2,Matches,Heidenheim,Bundesliga
2526,Adrian Beck,de GER,"MF,FW",27-331,16.4,36,17,18,12,6,12,35,34.3,23,29,2,27,9,45,16,0,Matches,Heidenheim,Bundesliga
2527,Marnon Busch,de GER,"DF,MF",30-149,15.4,26,17,19,7,0,23,32,71.9,9,23,10,13,13,39,65,5,Matches,Heidenheim,Bundesliga
2528,Frans Krätzig,de GER,"DF,MF",22-112,12.5,32,18,14,12,6,12,20,60.0,8,12,1,11,15,47,15,0,Matches,Heidenheim,Bundesliga
2529,Léo Scienza,br BRA,"FW,MF",26-235,12.3,16,11,9,5,2,6,17,35.3,11,13,1,12,5,21,9,1,Matches,Heidenheim,Bundesliga
2530,Tim Siersleben,de GER,DF,25-058,11.1,20,13,12,7,1,7,17,41.2,10,16,6,10,17,37,57,0,Matches,Heidenheim,Bundesliga
2531,Mathias Honsak,at AUT,"FW,MF",28-137,12.1,15,8,10,5,0,10,22,45.5,12,17,4,13,9,24,28,0,Matches,Heidenheim,Bundesliga
2532,Budu Zivzivadze,ge GEO,FW,31-057,10.1,16,10,1,9,6,4,8,50.0,4,9,0,9,3,19,7,0,Matches,Heidenheim,Bundesliga
2533,Lennard Maloney,us USA,MF,25-210,8.4,20,11,12,7,1,14,23,60.9,9,9,2,7,14,34,38,0,Matches,Heidenheim,Bundesliga
2534,Luca Kerber,de GER,"MF,DF",23-057,8.1,26,16,17,8,1,16,29,55.2,13,13,4,9,5,31,25,0,Matches,Heidenheim,Bundesliga
2535,Sirlord Conteh,de GER,"FW,MF",28-301,9.9,9,5,3,6,0,2,7,28.6,5,1,1,0,1,10,8,0,Matches,Heidenheim,Bundesliga
2536,Mikkel Kaufmann,dk DEN,FW,24-123,4.1,6,4,1,3,2,2,5,40.0,3,5,2,3,2,8,7,0,Matches,Heidenheim,Bundesliga
2537,Maximilian Breunig,de GER,"FW,MF",24-265,3.9,4,3,1,2,1,3,6,50.0,3,9,2,7,1,5,3,0,Matches,Heidenheim,Bundesliga
2538,Thomas Keller,de GER,"DF,MF",25-274,1.6,6,5,5,1,0,4,6,66.7,2,3,1,2,4,10,11,0,Matches,Heidenheim,Bundesliga
2539,Stefan Schimmer,de GER,"FW,MF",31-008,2.7,2,0,1,1,0,1,2,50.0,1,1,0,1,0,2,4,0,Matches,Heidenheim,Bundesliga
2540,Julian Niehues,de GER,MF,24-019,1.2,1,0,1,0,0,1,5,20.0,4,1,0,1,0,1,6,0,Matches,Heidenheim,Bundesliga
2541,Frank Feller,de GER,GK,21-119,0.3,0,0,0,0,0,0,0,,0,0,0,0,0,0,0,0,Matches,Heidenheim,Bundesliga
2542,Norman Theuerkauf,de GER,MF,38-102,0.2,0,0,0,0,0,0,0,,0,0,0,0,0,0,0,0,Matches,Heidenheim,Bundesliga
2543,Denis Thomalla,de GER,MF,32-263,0.0,0,0,0,0,0,0,0,,0,0,0,0,0,0,0,0,Matches,Heidenheim,Bundesliga
2544,Andrej Kramarić,hr CRO,"MF,FW",33-321,28.9,15,8,5,8,2,6,11,54.5,5,16,3,13,7,22,11,1,Matches,Hoffenheim,Bundesliga
2545,Tom Bischof,de GER,"MF,FW",19-312,26.7,90,49,33,44,13,37,72,51.4,35,62,11,51,29,119,49,1,Matches,Hoffenheim,Bundesliga
2546,Anton Stach,de GER,"MF,DF",26-172,26.8,62,44,25,33,4,29,42,69.0,13,42,12,30,41,103,98,2,Matches,Hoffenheim,Bundesliga
2547,Oliver Baumann,de GER,GK,34-338,26.0,2,2,2,0,0,2,4,50.0,2,0,0,0,0,2,14,2,Matches,Hoffenheim,Bundesliga
2548,Arthur Chaves,br BRA,DF,24-097,22.3,46,32,26,16,4,22,46,47.8,24,44,18,26,31,77,122,3,Matches,Hoffenheim,Bundesliga
2549,Kevin Akpoguma,ng NGA,DF,30-017,22.7,50,24,32,12,6,27,40,67.5,13,62,35,27,25,75,107,1,Matches,Hoffenheim,Bundesliga
2550,Marius Bülter,de GER,"FW,DF",32-038,17.7,11,9,3,6,2,8,15,53.3,7,9,2,7,3,14,12,0,Matches,Hoffenheim,Bundesliga
2551,Adam Hložek,cz CZE,"FW,MF",22-285,18.8,20,9,7,7,6,11,20,55.0,9,13,1,12,4,24,20,0,Matches,Hoffenheim,Bundesliga
2552,Alexander Prass,at AUT,DF,23-345,16.9,41,23,23,15,3,24,57,42.1,33,32,6,26,9,50,48,4,Matches,Hoffenheim,Bundesliga
2553,Pavel Kadeřábek,cz CZE,DF,33-011,15.5,22,11,11,4,7,13,29,44.8,16,11,3,8,18,40,49,1,Matches,Hoffenheim,Bundesliga
2554,Stanley N'Soki,fr FRA,DF,26-027,14.5,22,16,13,7,2,12,23,52.2,11,22,7,15,26,48,58,3,Matches,Hoffenheim,Bundesliga
2555,Valentin Gendrey,fr FRA,DF,24-319,15.7,30,12,19,9,2,11,18,61.1,7,19,5,14,15,45,53,0,Matches,Hoffenheim,Bundesliga
2556,Leo Skiri Østigård,no NOR,DF,25-159,8.3,7,6,4,3,0,3,5,60.0,2,14,8,6,6,13,92,0,Matches,Hoffenheim,Bundesliga
2557,Florian Grillitsch,at AUT,MF,29-272,6.7,15,9,5,9,1,8,14,57.1,6,6,2,4,8,23,18,0,Matches,Hoffenheim,Bundesliga
2558,Gift Orban,ng NGA,FW,22-293,7.6,3,1,2,1,0,1,6,16.7,5,7,0,7,0,3,3,0,Matches,Hoffenheim,Bundesliga
2559,Finn Ole Becker,de GER,MF,24-332,7.3,11,5,4,6,1,1,4,25.0,3,7,3,4,10,21,18,0,Matches,Hoffenheim,Bundesliga
2560,Haris Tabakovic,ba BIH,FW,30-320,8.9,3,1,1,0,2,0,3,0.0,3,4,2,2,1,4,16,0,Matches,Hoffenheim,Bundesliga
2561,Dennis Geiger,de GER,"MF,FW",26-330,7.3,22,10,8,12,2,11,17,64.7,6,13,2,11,5,27,6,1,Matches,Hoffenheim,Bundesliga
2562,David Jurásek,cz CZE,DF,24-272,6.9,6,3,3,2,1,2,5,40.0,3,5,0,5,6,12,17,0,Matches,Hoffenheim,Bundesliga
2563,Luca Philipp,de GER,GK,24-159,6.0,1,0,1,0,0,1,1,100.0,0,0,0,0,0,1,1,0,Matches,Hoffenheim,Bundesliga
2564,Bazoumana Touré,ci CIV,"FW,MF",19-065,5.7,11,9,2,7,2,2,8,25.0,6,3,0,3,3,14,2,0,Matches,Hoffenheim,Bundesliga
2565,Diadie Samassékou,ml MLI,MF,29-115,3.2,5,5,1,2,2,2,4,50.0,2,4,2,2,5,10,5,0,Matches,Hoffenheim,Bundesliga
2566,Max Moerstedt,de GER,FW,,5.0,5,5,1,3,1,1,2,50.0,1,4,0,4,0,5,5,0,Matches,Hoffenheim,Bundesliga
2567,Tim Drexler,de GER,DF,20-061,4.0,17,7,11,6,0,9,12,75.0,3,6,4,2,1,18,9,1,Matches,Hoffenheim,Bundesliga
2568,Jacob Bruun Larsen,dk DEN,"FW,MF",26-229,4.4,4,3,1,2,1,3,8,37.5,5,5,1,4,1,5,2,0,Matches,Hoffenheim,Bundesliga
2569,Umut Tohumcu,de GER,"MF,FW",20-268,4.0,9,5,3,5,1,5,7,71.4,2,5,0,5,3,12,6,0,Matches,Hoffenheim,Bundesliga
2570,Mergim Berisha,de GER,"FW,MF",26-360,3.7,3,3,1,2,0,0,3,0.0,3,2,1,1,0,3,3,0,Matches,Hoffenheim,Bundesliga
2571,Erencan Yardimci,tr TUR,"FW,MF",23-091,3.5,4,3,1,3,0,1,2,50.0,1,2,0,2,1,5,2,0,Matches,Hoffenheim,Bundesliga
2572,Robin Hranáč,cz CZE,DF,25-097,2.4,0,0,0,0,0,0,1,0.0,1,3,2,1,5,5,9,1,Matches,Hoffenheim,Bundesliga
2573,Grischa Prömel,de GER,MF,30-117,1.9,0,0,0,0,0,0,1,0.0,1,1,1,0,2,2,4,0,Matches,Hoffenheim,Bundesliga
2574,Florian Micheler,at AUT,MF,19-354,0.4,0,0,0,0,0,0,2,0.0,2,0,0,0,0,0,0,0,Matches,Hoffenheim,Bundesliga
2575,Hannes Behrens,de GER,DF,,0.3,1,1,0,1,0,0,0,,0,1,0,1,2,3,0,0,Matches,Hoffenheim,Bundesliga
2576,David Mokwa,fr FRA,"DF,FW",21-003,0.2,1,0,1,0,0,0,0,,0,0,0,0,0,1,0,0,Matches,Hoffenheim,Bundesliga
2577,Paul Hennrich,de GER,MF,20-061,0.1,0,0,0,0,0,0,0,,0,1,1,0,0,0,0,0,Matches,Hoffenheim,Bundesliga
2578,Timo Becker,de GER,DF,28-042,25.2,49,31,35,9,5,30,40,75.0,10,30,17,13,16,65,102,1,Matches,Holstein-Kiel,Bundesliga
2579,Nicolai Remberg,de GER,MF,24-321,25.9,44,25,23,17,4,19,38,50.0,19,45,19,26,28,72,97,0,Matches,Holstein-Kiel,Bundesliga
2580,Timon Weiner,de GER,GK,26-108,25.0,0,0,0,0,0,0,1,0.0,1,0,0,0,0,0,17,3,Matches,Holstein-Kiel,Bundesliga
2581,Armin Gigovic,ba BIH,MF,23-030,20.2,25,13,14,8,3,5,21,23.8,16,18,1,17,21,46,31,0,Matches,Holstein-Kiel,Bundesliga
2582,Shuto Machino,jp JPN,"FW,MF",25-218,19.9,8,5,4,3,1,6,15,40.0,9,11,2,9,7,15,18,0,Matches,Holstein-Kiel,Bundesliga
2583,Magnus Knudsen,no NOR,MF,23-325,19.1,46,27,20,21,5,25,44,56.8,19,18,4,14,12,58,42,0,Matches,Holstein-Kiel,Bundesliga
2584,Finn Porath,de GER,"DF,MF",28-072,21.4,44,25,23,14,7,25,52,48.1,27,27,9,18,20,64,67,0,Matches,Holstein-Kiel,Bundesliga
2585,Lasse Rosenboom,de GER,DF,23-107,17.6,41,29,20,15,6,28,41,68.3,13,27,8,19,18,59,66,2,Matches,Holstein-Kiel,Bundesliga
2586,Marko Ivezić,rs SRB,DF,23-155,18.4,29,19,20,6,3,15,42,35.7,27,25,13,12,27,56,102,2,Matches,Holstein-Kiel,Bundesliga
2587,Phil Harres,de GER,FW,23-042,16.7,10,10,3,4,3,4,8,50.0,4,16,3,13,5,15,20,0,Matches,Holstein-Kiel,Bundesliga
2588,Marco Komenda,hr CRO,DF,28-161,14.5,26,17,12,13,1,11,15,73.3,4,23,11,12,6,32,68,0,Matches,Holstein-Kiel,Bundesliga
2589,David Zec,si SVN,DF,25-121,15.1,21,9,15,6,0,12,17,70.6,5,30,17,13,16,37,82,3,Matches,Holstein-Kiel,Bundesliga
2590,Max Geschwill,de GER,DF,23-303,13.7,26,21,13,12,1,14,19,73.7,5,14,9,5,27,53,50,1,Matches,Holstein-Kiel,Bundesliga
2591,Steven Skrzybski,de GER,"FW,MF",32-169,13.2,18,5,7,6,5,7,23,30.4,16,15,0,15,11,29,11,0,Matches,Holstein-Kiel,Bundesliga
2592,Alexander Bernhardsson,se SWE,"FW,MF",26-240,12.2,25,14,6,8,11,17,27,63.0,10,14,0,14,4,29,17,0,Matches,Holstein-Kiel,Bundesliga
2593,Lewis Holtby,de GER,MF,34-230,13.1,32,20,17,10,5,10,26,38.5,16,14,2,12,21,53,26,3,Matches,Holstein-Kiel,Bundesliga
2594,Patrick Erras,de GER,DF,30-105,9.2,8,5,6,2,0,2,9,22.2,7,13,11,2,9,17,64,0,Matches,Holstein-Kiel,Bundesliga
2595,Benedikt Pichler,at AUT,FW,27-290,8.6,5,2,1,0,4,2,4,50.0,2,4,2,2,2,7,11,0,Matches,Holstein-Kiel,Bundesliga
2596,Thomas Dähne,de GER,GK,31-122,7.0,0,0,0,0,0,0,0,,0,0,0,0,0,0,7,1,Matches,Holstein-Kiel,Bundesliga
2597,John Tolkin,us USA,"DF,MF",22-279,6.4,15,9,8,7,0,10,11,90.9,1,9,2,7,7,22,36,0,Matches,Holstein-Kiel,Bundesliga
2598,Carl Johansson,se SWE,DF,30-348,5.4,4,2,4,0,0,3,7,42.9,4,11,7,4,10,14,45,1,Matches,Holstein-Kiel,Bundesliga
2599,Tymoteusz Puchacz,pl POL,DF,26-103,4.4,9,4,6,3,0,5,7,71.4,2,4,1,3,3,12,11,0,Matches,Holstein-Kiel,Bundesliga
2600,Dominik Javorček,sk SVK,"DF,MF",22-185,4.3,3,0,3,0,0,1,5,20.0,4,7,3,4,5,8,26,1,Matches,Holstein-Kiel,Bundesliga
2601,Jann-Fiete Arp,de GER,"FW,MF",25-120,7.9,13,10,5,2,6,4,13,30.8,9,6,0,6,3,16,8,1,Matches,Holstein-Kiel,Bundesliga
2602,Marvin Schulz,de GER,"MF,DF",30-111,3.4,6,5,2,2,2,2,8,25.0,6,12,8,4,0,6,17,0,Matches,Holstein-Kiel,Bundesliga
2603,Andu Kelati,de GER,"MF,DF",22-266,3.2,7,4,2,4,1,2,5,40.0,3,4,1,3,3,10,3,0,Matches,Holstein-Kiel,Bundesliga
2604,Ivan Nekić,hr CRO,DF,24-133,0.8,1,1,1,0,0,1,2,50.0,1,1,0,1,3,4,2,0,Matches,Holstein-Kiel,Bundesliga
2605,Granit Xhaka,ch SUI,MF,32-221,31.2,45,26,14,25,6,22,39,56.4,17,28,7,21,12,57,52,4,Matches,Bayer-Leverkusen,Bundesliga
2606,Jonathan Tah,de GER,DF,29-084,31.0,16,10,10,5,1,8,13,61.5,5,21,15,6,33,49,142,2,Matches,Bayer-Leverkusen,Bundesliga
2607,Álex Grimaldo,es ESP,DF,29-228,28.0,23,13,12,7,4,16,38,42.1,22,22,3,19,15,38,43,3,Matches,Bayer-Leverkusen,Bundesliga
2608,Lukáš Hrádecký,fi FIN,GK,35-163,27.0,0,0,0,0,0,0,1,0.0,1,0,0,0,0,0,7,2,Matches,Bayer-Leverkusen,Bundesliga
2609,Edmond Tapsoba,bf BFA,DF,26-093,25.9,36,21,17,15,4,19,36,52.8,17,18,12,6,24,60,82,3,Matches,Bayer-Leverkusen,Bundesliga
2610,Piero Hincapié,ec ECU,DF,23-117,27.8,47,36,25,15,7,23,38,60.5,15,34,17,17,32,79,107,1,Matches,Bayer-Leverkusen,Bundesliga
2611,Jeremie Frimpong,nl NED,"DF,MF",24-147,24.7,31,23,13,11,7,15,28,53.6,13,24,0,24,8,39,21,1,Matches,Bayer-Leverkusen,Bundesliga
2612,Florian Wirtz,de GER,"MF,FW",22-003,24.1,32,20,10,12,10,9,20,45.0,11,25,1,24,9,41,5,1,Matches,Bayer-Leverkusen,Bundesliga
2613,Patrik Schick,cz CZE,FW,29-102,17.4,6,5,1,3,2,1,5,20.0,4,7,0,7,4,10,15,1,Matches,Bayer-Leverkusen,Bundesliga
2614,Robert Andrich,de GER,"MF,DF",30-226,16.5,23,11,8,14,1,7,14,50.0,7,14,7,7,26,49,21,0,Matches,Bayer-Leverkusen,Bundesliga
2615,Aleix García,es ESP,MF,27-312,15.1,12,6,4,6,2,6,13,46.2,7,12,2,10,10,22,24,1,Matches,Bayer-Leverkusen,Bundesliga
2616,Nathan Tella,ng NGA,"MF,FW",25-305,14.0,15,10,4,6,5,5,12,41.7,7,13,1,12,4,19,6,0,Matches,Bayer-Leverkusen,Bundesliga
2617,Victor Boniface,ng NGA,FW,24-134,11.2,5,4,0,3,2,3,4,75.0,1,1,0,1,0,5,5,0,Matches,Bayer-Leverkusen,Bundesliga
2618,Exequiel Palacios,ar ARG,MF,26-213,11.6,19,13,7,8,4,7,14,50.0,7,14,1,13,11,30,11,0,Matches,Bayer-Leverkusen,Bundesliga
2619,Nordi Mukiele,fr FRA,DF,27-186,10.0,20,16,8,8,4,12,18,66.7,6,10,0,10,16,36,37,2,Matches,Bayer-Leverkusen,Bundesliga
2620,Arthur,br BRA,DF,22-050,7.5,14,11,3,9,2,5,10,50.0,5,7,0,7,9,23,24,0,Matches,Bayer-Leverkusen,Bundesliga
2621,Martin Terrier,fr FRA,"MF,FW",28-063,6.5,4,2,1,0,3,1,4,25.0,3,3,0,3,1,5,1,0,Matches,Bayer-Leverkusen,Bundesliga
2622,Amine Adli,ma MAR,"MF,FW",24-361,7.4,14,8,3,2,9,4,10,40.0,6,10,0,10,0,14,4,0,Matches,Bayer-Leverkusen,Bundesliga
2623,Matej Kovar,cz CZE,GK,24-354,5.0,0,0,0,0,0,0,0,,0,0,0,0,0,0,0,1,Matches,Bayer-Leverkusen,Bundesliga
2624,Mario Hermoso,es ESP,DF,29-322,3.3,0,0,0,0,0,0,0,,0,3,1,2,9,9,15,1,Matches,Bayer-Leverkusen,Bundesliga
2625,Jonas Hofmann,de GER,"MF,DF",32-296,3.1,2,0,0,2,0,1,3,33.3,2,2,0,2,0,2,2,0,Matches,Bayer-Leverkusen,Bundesliga
2626,Emi Buendía,ar ARG,MF,28-132,2.8,6,5,1,4,1,5,8,62.5,3,5,0,5,0,6,0,0,Matches,Bayer-Leverkusen,Bundesliga
2627,Jeanuël Belocian,fr FRA,"DF,MF",20-078,0.8,1,1,1,0,0,1,1,100.0,0,0,0,0,0,1,2,0,Matches,Bayer-Leverkusen,Bundesliga
2628,Kaishu Sano,jp JPN,MF,24-127,31.8,56,34,20,28,8,22,47,46.8,25,63,13,50,59,115,54,1,Matches,Mainz-05,Bundesliga
2629,Robin Zentner,de GER,GK,30-190,31.0,2,1,2,0,0,1,2,50.0,1,0,0,0,0,2,31,4,Matches,Mainz-05,Bundesliga
2630,Anthony Caci,fr FRA,DF,27-309,28.1,59,39,22,25,12,28,43,65.1,15,32,8,24,23,82,46,2,Matches,Mainz-05,Bundesliga
2631,Phillipp Mwene,at AUT,DF,31-097,27.3,45,26,19,21,5,15,41,36.6,26,27,6,21,24,69,51,1,Matches,Mainz-05,Bundesliga
2632,Lee Jae-sung,kr KOR,MF,32-269,27.8,40,21,15,18,7,14,37,37.8,23,35,3,32,34,74,37,0,Matches,Mainz-05,Bundesliga
2633,Nadiem Amiri,de GER,MF,28-191,25.5,44,21,13,23,8,16,43,37.2,27,18,4,14,16,60,30,2,Matches,Mainz-05,Bundesliga
2634,Dominik Kohr,de GER,"DF,MF",31-095,25.5,62,46,34,21,7,35,55,63.6,20,43,24,19,42,104,127,0,Matches,Mainz-05,Bundesliga
2635,Jonathan Burkardt,de GER,FW,24-299,21.5,12,7,1,5,6,5,9,55.6,4,11,1,10,1,13,13,0,Matches,Mainz-05,Bundesliga
2636,Paul Nebel,de GER,MF,22-208,24.1,34,22,10,15,9,11,34,32.4,23,52,4,48,12,46,30,2,Matches,Mainz-05,Bundesliga
2637,Danny da Costa,de GER,DF,31-297,20.3,39,22,21,14,4,16,24,66.7,8,19,10,9,24,63,89,3,Matches,Mainz-05,Bundesliga
2638,Moritz Jenz,de GER,DF,26-006,17.8,36,20,18,18,0,16,21,76.2,5,23,14,9,30,66,128,2,Matches,Mainz-05,Bundesliga
2639,Stefan Bell,de GER,DF,33-255,14.0,18,10,14,4,0,8,13,61.5,5,15,13,2,25,43,90,1,Matches,Mainz-05,Bundesliga
2640,Andreas Hanche-Olsen,no NOR,DF,28-109,12.3,19,11,10,8,1,8,11,72.7,3,21,16,5,9,28,75,2,Matches,Mainz-05,Bundesliga
2641,Nelson Weiper,de GER,"FW,MF",20-050,7.8,5,4,2,3,0,2,4,50.0,2,5,0,5,2,7,5,1,Matches,Mainz-05,Bundesliga
2642,Maxim Leitsch,de GER,DF,26-353,7.5,12,4,6,4,2,7,9,77.8,2,12,4,8,10,22,42,1,Matches,Mainz-05,Bundesliga
2643,Armindo Sieb,de GER,"FW,MF",22-078,8.5,10,4,4,5,1,3,10,30.0,7,4,0,4,1,11,7,0,Matches,Mainz-05,Bundesliga
2644,Hong Hyunseok,kr KOR,MF,25-324,5.5,7,3,3,2,2,1,4,25.0,3,6,1,5,7,14,8,0,Matches,Mainz-05,Bundesliga
2645,Silvan Widmer,ch SUI,DF,32-062,5.2,11,5,3,6,2,8,12,66.7,4,7,1,6,5,16,24,0,Matches,Mainz-05,Bundesliga
2646,Nikolas Veratschnig,at AUT,"DF,MF",22-102,3.8,9,6,1,4,4,2,3,66.7,1,4,0,4,4,13,8,0,Matches,Mainz-05,Bundesliga
2647,Karim Onisiwo,at AUT,"MF,FW",33-050,1.2,1,1,0,0,1,0,0,,0,0,0,0,0,1,0,0,Matches,Mainz-05,Bundesliga
2648,Lasse Rieß,de GER,GK,23-283,1.0,0,0,0,0,0,0,0,,0,0,0,0,0,0,2,0,Matches,Mainz-05,Bundesliga
2649,Arnaud Nordin,fr FRA,"DF,MF",26-323,0.9,2,0,0,2,0,1,1,100.0,0,2,1,1,0,2,2,0,Matches,Mainz-05,Bundesliga
2650,Aymen Barkok,ma MAR,MF,26-350,0.8,2,1,1,1,0,1,1,100.0,0,1,1,0,2,4,0,0,Matches,Mainz-05,Bundesliga
2651,Lennard Maloney,us USA,MF,25-210,0.3,1,0,0,0,1,1,1,100.0,0,1,0,1,0,1,3,0,Matches,Mainz-05,Bundesliga
2652,Gabriel Vidovic,hr CRO,MF,21-156,0.0,0,0,0,0,0,0,0,,0,0,0,0,0,0,0,0,Matches,Mainz-05,Bundesliga
2653,Benjamin Šeško,si SVN,"FW,MF",21-340,25.6,7,3,0,4,3,3,11,27.3,8,14,4,10,5,12,20,0,Matches,RB-Leipzig,Bundesliga
2654,Péter Gulácsi,hu HUN,GK,35-000,27.2,0,0,0,0,0,0,1,0.0,1,0,0,0,0,0,12,4,Matches,RB-Leipzig,Bundesliga
2655,Loïs Openda,be BEL,"FW,MF",25-079,26.3,9,4,3,4,2,3,11,27.3,8,19,1,18,5,14,12,0,Matches,RB-Leipzig,Bundesliga
2656,Willi Orban,hu HUN,DF,32-184,24.7,38,21,23,14,1,23,32,71.9,9,45,31,14,21,59,169,4,Matches,RB-Leipzig,Bundesliga
2657,Xavi Simons,nl NED,MF,22-015,21.9,25,18,5,15,5,12,25,48.0,13,16,3,13,12,37,17,1,Matches,RB-Leipzig,Bundesliga
2658,David Raum,de GER,DF,27-014,18.8,36,27,15,13,8,19,34,55.9,15,25,8,17,9,45,43,4,Matches,RB-Leipzig,Bundesliga
2659,Lukas Klostermann,de GER,DF,28-337,19.4,27,14,18,7,2,14,22,63.6,8,30,16,14,24,51,134,3,Matches,RB-Leipzig,Bundesliga
2660,Nicolas Seiwald,at AUT,"MF,DF",24-002,21.2,49,29,18,26,5,24,48,50.0,24,38,8,30,29,78,67,2,Matches,RB-Leipzig,Bundesliga
2661,Christoph Baumgartner,at AUT,"MF,FW",25-278,16.9,43,27,13,19,11,17,40,42.5,23,42,8,34,12,55,22,1,Matches,RB-Leipzig,Bundesliga
2662,Kevin Kampl,si SVN,MF,34-209,16.7,26,18,11,9,6,15,22,68.2,7,25,6,19,23,49,24,0,Matches,RB-Leipzig,Bundesliga
2663,Castello Lukeba,fr FRA,DF,22-140,16.5,31,17,15,12,4,17,23,73.9,6,24,11,13,16,47,70,0,Matches,RB-Leipzig,Bundesliga
2664,Lutsharel Geertruida,nl NED,DF,24-292,16.3,35,24,24,11,0,15,31,48.4,16,15,4,11,16,51,56,4,Matches,RB-Leipzig,Bundesliga
2665,Arthur Vermeeren,be BEL,MF,20-088,15.7,30,17,13,12,5,12,42,28.6,30,32,10,22,22,52,21,2,Matches,RB-Leipzig,Bundesliga
2666,Amadou Haidara,ml MLI,MF,27-095,14.7,30,17,12,16,2,12,29,41.4,17,42,12,30,18,48,56,1,Matches,RB-Leipzig,Bundesliga
2667,Antonio Nusa,no NOR,"MF,DF",20-019,16.2,30,17,16,9,5,18,36,50.0,18,21,2,19,8,38,11,0,Matches,RB-Leipzig,Bundesliga
2668,Ridle Baku,de GER,"DF,MF",27-028,13.0,21,18,9,11,1,8,20,40.0,12,16,2,14,7,28,44,0,Matches,RB-Leipzig,Bundesliga
2669,El Chadaille Bitshiabu,fr FRA,DF,19-355,10.6,22,16,12,9,1,8,17,47.1,9,21,12,9,11,33,81,1,Matches,RB-Leipzig,Bundesliga
2670,Benjamin Henrichs,de GER,DF,28-072,10.4,32,16,18,10,4,14,27,51.9,13,22,3,19,15,47,33,0,Matches,RB-Leipzig,Bundesliga
2671,Kosta Nedeljković,rs SRB,DF,19-141,4.3,10,7,4,6,0,5,9,55.6,4,4,2,2,1,11,12,0,Matches,RB-Leipzig,Bundesliga
2672,Maarten Vandevoordt,be BEL,GK,23-069,4.8,1,0,1,0,0,1,1,100.0,0,0,0,0,0,1,4,0,Matches,RB-Leipzig,Bundesliga
2673,Yussuf Poulsen,dk DEN,"FW,MF",30-325,3.7,10,5,2,6,2,4,8,50.0,4,6,2,4,0,10,11,0,Matches,RB-Leipzig,Bundesliga
2674,Xaver Schlager,at AUT,MF,27-220,2.0,4,2,2,1,1,3,7,42.9,4,7,0,7,0,4,3,0,Matches,RB-Leipzig,Bundesliga
2675,Mohamed Simakan,fr FRA,DF,25-003,0.6,0,0,0,0,0,0,0,,0,0,0,0,2,2,0,0,Matches,RB-Leipzig,Bundesliga
2676,André Silva,pt POR,"FW,MF",29-181,1.5,1,1,1,0,0,0,1,0.0,1,1,0,1,1,2,2,0,Matches,RB-Leipzig,Bundesliga
2677,Tidiam Gomis,fr FRA,"MF,DF",18-271,0.9,0,0,0,0,0,0,0,,0,2,0,2,1,1,0,0,Matches,RB-Leipzig,Bundesliga
2678,Assan Ouedraogo,de GER,MF,18-362,0.6,0,0,0,0,0,0,0,,0,1,0,1,0,0,0,0,Matches,RB-Leipzig,Bundesliga
2679,Elif Elmas,mk MKD,MF,25-224,0.5,3,1,3,0,0,1,3,33.3,2,2,0,2,0,3,2,0,Matches,RB-Leipzig,Bundesliga
2680,Viggo Gebel,de GER,MF,17-165,0.2,0,0,0,0,0,0,0,,0,0,0,0,0,0,0,0,Matches,RB-Leipzig,Bundesliga
2681,Faik Sakar,de GER,MF,17-112,0.0,0,0,0,0,0,0,0,,0,0,0,0,0,0,0,0,Matches,RB-Leipzig,Bundesliga
2682,Nikola Vasilj,ba BIH,GK,29-155,32.0,0,0,0,0,0,0,2,0.0,2,0,0,0,0,0,22,3,Matches,St-Pauli,Bundesliga
2683,Hauke Wahl,de GER,DF,31-021,31.0,34,25,19,13,2,21,34,61.8,13,43,25,18,31,65,163,4,Matches,St-Pauli,Bundesliga
2684,Philipp Treu,de GER,"MF,DF",24-154,30.4,60,42,35,16,9,38,65,58.5,27,49,11,38,19,79,84,2,Matches,St-Pauli,Bundesliga
2685,Eric Smith,se SWE,"DF,MF",28-118,29.4,45,29,25,17,3,22,37,59.5,15,35,10,25,37,82,102,4,Matches,St-Pauli,Bundesliga
2686,Jackson Irvine,au AUS,MF,32-060,29.0,56,28,24,26,6,25,45,55.6,20,27,5,22,36,92,63,2,Matches,St-Pauli,Bundesliga
2687,Manolis Saliakas,gr GRE,"MF,DF",28-236,24.0,43,21,22,17,4,24,47,51.1,23,36,8,28,19,62,59,0,Matches,St-Pauli,Bundesliga
2688,David Nemeth,at AUT,DF,24-049,21.7,42,28,25,15,2,25,41,61.0,16,27,11,16,16,58,89,2,Matches,St-Pauli,Bundesliga
2689,Johannes Eggestein,de GER,FW,26-363,20.3,5,3,0,2,3,1,5,20.0,4,5,0,5,0,5,8,0,Matches,St-Pauli,Bundesliga
2690,Morgan Guilavogui,gn GUI,"FW,MF",27-057,18.3,32,17,11,16,5,14,29,48.3,15,27,0,27,13,45,30,0,Matches,St-Pauli,Bundesliga
2691,Carlo Boukhalfa,ma MAR,MF,26-003,16.3,24,10,7,16,1,6,17,35.3,11,18,3,15,12,36,21,1,Matches,St-Pauli,Bundesliga
2692,Oladapo Afolayan,eng ENG,"FW,MF",27-083,16.9,16,8,4,8,4,6,18,33.3,12,16,1,15,8,24,18,0,Matches,St-Pauli,Bundesliga
2693,Noah Weißhaupt,de GER,"FW,MF",23-228,12.2,6,4,3,0,3,3,8,37.5,5,6,0,6,2,8,8,1,Matches,St-Pauli,Bundesliga
2694,Danel Sinani,lu LUX,"FW,MF",28-031,12.2,13,10,2,7,4,6,13,46.2,7,12,1,11,1,14,12,0,Matches,St-Pauli,Bundesliga
2695,Karol Mets,ee EST,DF,31-355,10.0,13,8,6,7,0,4,7,57.1,3,9,3,6,12,25,60,0,Matches,St-Pauli,Bundesliga
2696,Elias Saad,tn TUN,"FW,MF",25-130,10.0,20,13,7,8,5,10,20,50.0,10,14,0,14,3,23,1,0,Matches,St-Pauli,Bundesliga
2697,Siebe Van Der Heyden,be BEL,"DF,MF",26-341,9.3,17,10,10,7,0,8,18,44.4,10,8,4,4,17,34,40,2,Matches,St-Pauli,Bundesliga
2698,Lars Ritzka,de GER,"DF,MF",26-364,8.7,46,29,26,15,5,22,37,59.5,15,14,2,12,9,55,35,0,Matches,St-Pauli,Bundesliga
2699,James Sands,us USA,"MF,DF",24-304,5.0,15,6,5,8,2,4,4,100.0,0,5,1,4,5,20,8,0,Matches,St-Pauli,Bundesliga
2700,Robert Wagner,de GER,MF,21-296,4.4,8,3,2,6,0,4,13,30.8,9,8,0,8,2,10,11,0,Matches,St-Pauli,Bundesliga
2701,Connor Metcalfe,au AUS,"MF,FW",25-182,3.9,2,0,1,1,0,0,5,0.0,5,4,0,4,3,5,5,0,Matches,St-Pauli,Bundesliga
2702,Adam Dźwigała,pl POL,"DF,MF",29-223,3.5,19,10,12,6,1,10,15,66.7,5,6,1,5,3,22,23,0,Matches,St-Pauli,Bundesliga
2703,Scott Banks,sct SCO,"FW,MF",23-222,1.1,1,1,1,0,0,0,2,0.0,2,0,0,0,2,3,2,0,Matches,St-Pauli,Bundesliga
2704,Andreas Albers,dk DEN,FW,35-044,0.7,1,1,0,0,1,0,1,0.0,1,0,0,0,0,1,1,0,Matches,St-Pauli,Bundesliga
2705,Abdoulie Ceesay,gm GAM,FW,21-121,0.7,3,3,1,1,1,2,3,66.7,1,2,0,2,0,3,1,0,Matches,St-Pauli,Bundesliga
2706,Erik Ahlstrand,se SWE,"FW,MF",23-204,0.5,0,0,0,0,0,0,0,,0,1,0,1,1,1,1,0,Matches,St-Pauli,Bundesliga
2707,Maurides,br BRA,FW,31-057,0.0,0,0,0,0,0,0,0,,0,0,0,0,0,0,0,0,Matches,St-Pauli,Bundesliga
2708,Ben Alexander Voll,de GER,"GK,MF",24-148,0.0,0,0,0,0,0,0,0,,0,0,0,0,0,0,0,0,Matches,St-Pauli,Bundesliga
2709,Finley Stevens,wls WAL,DF,22-026,0.0,0,0,0,0,0,0,0,,0,0,0,0,0,0,0,0,Matches,St-Pauli,Bundesliga
2710,Alexander Nübel,de GER,GK,28-218,32.0,0,0,0,0,0,0,1,0.0,1,0,0,0,0,0,17,3,Matches,Stuttgart,Bundesliga
2711,Angelo Stiller,de GER,MF,24-032,30.3,49,27,18,25,6,14,30,46.7,16,29,9,20,25,74,50,4,Matches,Stuttgart,Bundesliga
2712,Atakan Karazor,,MF,28-205,27.1,56,27,17,27,12,27,55,49.1,28,36,6,30,27,83,49,1,Matches,Stuttgart,Bundesliga
2713,Maximilian Mittelstädt,de GER,DF,28-049,25.7,76,53,41,28,7,51,71,71.8,20,43,11,32,43,119,96,2,Matches,Stuttgart,Bundesliga
2714,Julian Chabot,de GER,DF,27-083,23.2,33,21,17,14,2,14,30,46.7,16,26,17,9,35,68,128,0,Matches,Stuttgart,Bundesliga
2715,Chris Führich,de GER,"MF,FW",27-117,20.8,13,8,3,5,5,11,25,44.0,14,21,2,19,6,19,19,0,Matches,Stuttgart,Bundesliga
2716,Enzo Millot,fr FRA,"MF,FW",22-293,19.1,26,12,10,13,3,9,30,30.0,21,26,0,26,11,37,6,1,Matches,Stuttgart,Bundesliga
2717,Ermedin Demirović,ba BIH,FW,27-042,20.1,11,6,2,4,5,2,10,20.0,8,14,3,11,3,14,11,0,Matches,Stuttgart,Bundesliga
2718,Jamie Leweling,de GER,"MF,FW",24-069,17.0,16,6,6,3,7,11,24,45.8,13,22,1,21,10,26,17,1,Matches,Stuttgart,Bundesliga
2719,Josha Vagnoman,de GER,"DF,MF",24-146,19.2,24,12,11,11,2,17,31,54.8,14,15,2,13,12,36,54,1,Matches,Stuttgart,Bundesliga
2720,Deniz Undav,de GER,"FW,MF",28-291,17.2,10,9,2,3,5,0,13,0.0,13,12,1,11,3,13,9,0,Matches,Stuttgart,Bundesliga
2721,Nick Woltemade,de GER,"FW,MF",23-081,16.1,9,6,2,4,3,6,10,60.0,4,22,2,20,1,10,13,1,Matches,Stuttgart,Bundesliga
2722,Anthony Rouault,fr FRA,DF,23-342,13.5,15,11,10,3,2,10,15,66.7,5,18,9,9,19,34,63,1,Matches,Stuttgart,Bundesliga
2723,Leonidas Stergiou,ch SUI,DF,23-064,9.5,24,13,9,11,4,16,19,84.2,3,16,5,11,14,38,39,0,Matches,Stuttgart,Bundesliga
2724,Ramon Hendriks,nl NED,DF,23-292,11.8,18,7,10,7,1,9,13,69.2,4,15,7,8,17,35,59,0,Matches,Stuttgart,Bundesliga
2725,Fabian Rieder,ch SUI,"MF,FW",23-079,9.6,17,14,4,9,4,7,23,30.4,16,10,1,9,10,27,7,1,Matches,Stuttgart,Bundesliga
2726,Finn Jeltsch,de GER,DF,18-293,8.2,18,13,6,11,1,12,15,80.0,3,12,6,6,11,29,27,2,Matches,Stuttgart,Bundesliga
2727,Anrie Chase,jp JPN,DF,21-043,8.2,10,4,6,4,0,5,7,71.4,2,10,6,4,9,19,35,0,Matches,Stuttgart,Bundesliga
2728,Ameen Al-Dakhil,be BEL,DF,23-061,4.8,6,6,4,2,0,4,4,100.0,0,12,8,4,9,15,30,1,Matches,Stuttgart,Bundesliga
2729,Jacob Bruun Larsen,dk DEN,"MF,FW",26-229,4.5,1,1,1,0,0,0,2,0.0,2,7,0,7,1,2,3,1,Matches,Stuttgart,Bundesliga
2730,El Bilal Touré,ml MLI,"FW,MF",23-215,4.0,4,1,1,1,2,3,3,100.0,0,1,0,1,0,4,1,0,Matches,Stuttgart,Bundesliga
2731,Pascal Stenzel,de GER,DF,29-047,2.4,1,0,1,0,0,0,1,0.0,1,5,1,4,2,3,5,0,Matches,Stuttgart,Bundesliga
2732,Yannik Keitel,de GER,MF,25-080,2.8,9,6,3,5,1,9,10,90.0,1,5,2,3,4,13,6,0,Matches,Stuttgart,Bundesliga
2733,Luca Jaquez,ch SUI,DF,21-338,1.3,3,0,3,0,0,1,2,50.0,1,1,0,1,1,4,2,0,Matches,Stuttgart,Bundesliga
2734,Frans Krätzig,de GER,DF,22-112,0.6,2,1,1,0,1,1,3,33.3,2,2,1,1,0,2,1,0,Matches,Stuttgart,Bundesliga
2735,Justin Diehl,de GER,"FW,DF",20-160,1.2,1,0,0,1,0,1,1,100.0,0,2,0,2,0,1,0,0,Matches,Stuttgart,Bundesliga
2736,Dan-Axel Zagadou,fr FRA,"DF,MF",25-337,0.3,0,0,0,0,0,0,0,,0,0,0,0,1,1,1,0,Matches,Stuttgart,Bundesliga
2737,Jarzinho Malanga,de GER,DF,18-300,0.0,0,0,0,0,0,0,0,,0,0,0,0,0,0,0,0,Matches,Stuttgart,Bundesliga
2738,Danilho Doekhi,nl NED,DF,26-310,32.0,35,22,17,15,3,13,23,56.5,10,31,15,16,42,77,163,1,Matches,Union-Berlin,Bundesliga
2739,Diogo Leite,pt POR,DF,26-103,28.3,64,32,43,17,4,33,50,66.0,17,61,25,36,57,121,162,1,Matches,Union-Berlin,Bundesliga
2740,Rani Khedira,de GER,MF,31-099,28.3,64,37,26,35,3,23,37,62.2,14,31,11,20,43,107,55,0,Matches,Union-Berlin,Bundesliga
2741,Benedict Hollerbach,de GER,"FW,MF",23-354,26.3,40,20,8,21,11,20,48,41.7,28,30,0,30,2,42,12,1,Matches,Union-Berlin,Bundesliga
2742,Frederik Rønnow,dk DEN,GK,32-275,27.0,0,0,0,0,0,0,1,0.0,1,0,0,0,0,0,19,2,Matches,Union-Berlin,Bundesliga
2743,Christopher Trimmel,at AUT,"DF,MF",38-071,18.3,36,24,22,13,1,26,38,68.4,12,13,6,7,17,53,88,0,Matches,Union-Berlin,Bundesliga
2744,Janik Haberer,de GER,"MF,DF",31-034,16.8,29,23,13,14,2,19,36,52.8,17,14,0,14,15,44,34,0,Matches,Union-Berlin,Bundesliga
2745,Tom Rothe,de GER,"DF,MF",20-189,16.9,41,24,25,13,3,27,47,57.4,20,38,3,35,16,57,49,1,Matches,Union-Berlin,Bundesliga
2746,Jeong Woo-yeong,kr KOR,"MF,FW",25-228,14.0,10,7,5,5,0,3,11,27.3,8,10,1,9,11,21,11,0,Matches,Union-Berlin,Bundesliga
2747,András Schäfer,hu HUN,MF,26-023,16.2,47,25,22,20,5,23,38,60.5,15,33,6,27,22,69,35,0,Matches,Union-Berlin,Bundesliga
2748,Leopold Querfeld,at AUT,DF,21-137,17.4,22,10,18,4,0,11,16,68.8,5,23,10,13,15,37,130,2,Matches,Union-Berlin,Bundesliga
2749,Kevin Vogt,de GER,DF,33-225,14.5,11,8,6,5,0,7,12,58.3,5,16,8,8,9,20,75,0,Matches,Union-Berlin,Bundesliga
2750,Josip Juranović,hr CRO,"DF,MF",29-263,11.9,19,11,11,5,3,9,22,40.9,13,12,6,6,7,26,35,2,Matches,Union-Berlin,Bundesliga
2751,Aljoscha Kemlein,de GER,MF,20-277,10.2,10,4,4,5,1,5,14,35.7,9,14,3,11,6,16,15,0,Matches,Union-Berlin,Bundesliga
2752,Robert Skov,dk DEN,"DF,MF",28-351,9.5,15,11,8,7,0,10,20,50.0,10,8,1,7,8,23,9,0,Matches,Union-Berlin,Bundesliga
2753,Tim Skarke,de GER,"FW,MF",28-241,11.7,13,11,5,7,1,9,18,50.0,9,7,0,7,5,18,17,0,Matches,Union-Berlin,Bundesliga
2754,Jordan Pefok,us USA,FW,29-010,10.1,11,6,6,0,5,3,7,42.9,4,9,2,7,4,15,18,0,Matches,Union-Berlin,Bundesliga
2755,Andrej Ilic,rs SRB,FW,25-033,9.6,2,2,0,2,0,0,5,0.0,5,7,3,4,4,6,5,1,Matches,Union-Berlin,Bundesliga
2756,Yorbe Vertessen,be BEL,"MF,FW",24-118,8.0,6,3,3,2,1,2,8,25.0,6,6,0,6,3,9,6,0,Matches,Union-Berlin,Bundesliga
2757,Lucas Tousart,fr FRA,MF,28-007,5.9,17,9,6,9,2,5,12,41.7,7,9,3,6,7,24,23,0,Matches,Union-Berlin,Bundesliga
2758,Alexander Schwolow,de GER,GK,32-338,5.0,0,0,0,0,0,0,0,,0,0,0,0,0,0,1,0,Matches,Union-Berlin,Bundesliga
2759,László Bénes,sk SVK,"MF,FW",27-239,5.7,2,2,1,1,0,1,2,50.0,1,5,1,4,3,5,9,0,Matches,Union-Berlin,Bundesliga
2760,Ivan Prtajin,hr CRO,FW,28-357,1.8,3,2,0,1,2,0,0,,0,2,0,2,0,3,3,0,Matches,Union-Berlin,Bundesliga
2761,Marin Ljubicic,hr CRO,"FW,MF",23-067,2.5,0,0,0,0,0,0,2,0.0,2,2,0,2,0,0,7,0,Matches,Union-Berlin,Bundesliga
2762,Jérôme Roussillon,fr FRA,"DF,MF",32-120,1.5,0,0,0,0,0,0,2,0.0,2,0,0,0,2,2,7,0,Matches,Union-Berlin,Bundesliga
2763,Robin Gosens,de GER,DF,30-305,1.0,0,0,0,0,0,0,3,0.0,3,1,0,1,1,1,2,0,Matches,Union-Berlin,Bundesliga
2764,Kevin Volland,de GER,"FW,MF",32-280,0.7,0,0,0,0,0,0,0,,0,1,0,1,0,0,1,0,Matches,Union-Berlin,Bundesliga
2765,David Preu,de GER,"MF,DF",20-192,0.4,0,0,0,0,0,0,1,0.0,1,2,1,1,0,0,2,0,Matches,Union-Berlin,Bundesliga
2766,Michael Zetterer,de GER,GK,29-298,32.0,0,0,0,0,0,0,1,0.0,1,1,0,1,1,1,10,6,Matches,Werder-Bremen,Bundesliga
2767,Mitchell Weiser,de GER,"DF,MF",31-015,29.9,56,37,17,31,8,26,49,53.1,23,29,2,27,21,77,58,3,Matches,Werder-Bremen,Bundesliga
2768,Romano Schmid,at AUT,MF,25-099,29.5,40,23,10,20,10,21,45,46.7,24,42,3,39,11,51,9,2,Matches,Werder-Bremen,Bundesliga
2769,Senne Lynen,be BEL,MF,26-076,28.4,70,37,35,29,6,37,64,57.8,27,54,12,42,62,132,68,5,Matches,Werder-Bremen,Bundesliga
2770,Marvin Ducksch,de GER,FW,31-060,24.9,10,7,3,5,2,3,14,21.4,11,7,1,6,8,18,24,2,Matches,Werder-Bremen,Bundesliga
2771,Jens Stage,dk DEN,MF,28-179,22.7,43,26,20,20,3,23,43,53.5,20,42,8,34,17,60,41,2,Matches,Werder-Bremen,Bundesliga
2772,Marco Friedl,at AUT,DF,27-051,22.0,56,38,30,25,1,35,61,57.4,26,37,22,15,32,88,124,1,Matches,Werder-Bremen,Bundesliga
2773,Niklas Stark,de GER,DF,30-022,21.4,33,21,20,11,2,14,21,66.7,7,38,25,13,32,65,121,1,Matches,Werder-Bremen,Bundesliga
2774,Anthony Jung,de GER,DF,33-184,21.0,34,22,22,11,1,22,34,64.7,12,23,14,9,25,59,76,1,Matches,Werder-Bremen,Bundesliga
2775,Felix Agu,de GER,DF,25-221,17.8,28,13,11,13,4,12,21,57.1,9,23,8,15,18,46,47,0,Matches,Werder-Bremen,Bundesliga
2776,Amos Pieper,de GER,DF,27-109,14.7,29,16,16,9,4,18,28,64.3,10,25,16,9,22,51,89,1,Matches,Werder-Bremen,Bundesliga
2777,Derrick Köhn,de GER,"DF,FW",26-091,14.6,20,10,7,10,3,10,14,71.4,4,20,4,16,9,29,26,0,Matches,Werder-Bremen,Bundesliga
2778,Marco Grüll,at AUT,"FW,MF",26-304,12.2,10,7,1,3,6,3,16,18.8,13,14,2,12,3,13,9,0,Matches,Werder-Bremen,Bundesliga
2779,Miloš Veljković,rs SRB,DF,29-222,11.4,10,5,6,3,1,7,15,46.7,8,14,9,5,2,12,47,1,Matches,Werder-Bremen,Bundesliga
2780,Leonardo Bittencourt,de GER,MF,31-138,10.6,25,9,15,7,3,6,18,33.3,12,8,0,8,14,39,11,0,Matches,Werder-Bremen,Bundesliga
2781,Justin Njinmah,de GER,"FW,MF",24-172,10.3,5,2,1,3,1,3,5,60.0,2,5,0,5,3,8,1,0,Matches,Werder-Bremen,Bundesliga
2782,Oliver Burke,sct SCO,FW,28-029,9.2,11,4,5,1,5,4,5,80.0,1,19,0,19,2,13,6,0,Matches,Werder-Bremen,Bundesliga
2783,Julián Malatini,ar ARG,DF,23-340,5.0,11,9,5,5,1,5,11,45.5,6,8,3,5,7,18,17,0,Matches,Werder-Bremen,Bundesliga
2784,André Silva,pt POR,FW,29-181,4.2,2,2,1,1,0,0,1,0.0,1,3,1,2,0,2,3,0,Matches,Werder-Bremen,Bundesliga
2785,Issa Kaboré,bf BFA,"DF,FW",23-359,3.4,8,4,2,5,1,4,6,66.7,2,8,2,6,2,10,7,0,Matches,Werder-Bremen,Bundesliga
2786,Keke Maximilian Topp,de GER,"FW,MF",21-042,2.7,3,1,0,2,1,1,2,50.0,1,0,0,0,1,4,4,0,Matches,Werder-Bremen,Bundesliga
2787,Skelly Alvero,fr FRA,MF,23-002,2.6,11,6,5,5,1,4,5,80.0,1,4,0,4,2,13,10,0,Matches,Werder-Bremen,Bundesliga
2788,Olivier Deman,be BEL,DF,25-030,0.7,6,3,2,4,0,2,7,28.6,5,3,1,2,3,9,4,0,Matches,Werder-Bremen,Bundesliga
2789,Kilian Fischer,de GER,DF,24-206,24.9,63,43,47,12,4,46,88,52.3,42,39,8,31,19,82,96,2,Matches,Wolfsburg,Bundesliga
2790,Kamil Grabara,pl POL,GK,26-118,26.7,0,0,0,0,0,0,2,0.0,2,1,0,1,0,0,12,2,Matches,Wolfsburg,Bundesliga
2791,Mohamed Amoura,dz ALG,FW,24-362,25.4,24,18,10,5,9,11,33,33.3,22,38,2,36,9,33,22,0,Matches,Wolfsburg,Bundesliga
2792,Konstantinos Koulierakis,gr GRE,DF,21-159,25.4,39,19,24,13,2,24,38,63.2,14,31,13,18,29,68,132,2,Matches,Wolfsburg,Bundesliga
2793,Maximilian Arnold,de GER,MF,30-344,25.2,33,20,13,18,2,15,33,45.5,18,21,11,10,24,57,69,2,Matches,Wolfsburg,Bundesliga
2794,Denis Vavro,sk SVK,DF,29-026,25.3,17,12,13,4,0,7,18,38.9,11,42,28,14,31,48,214,3,Matches,Wolfsburg,Bundesliga
2795,Joakim Mæhle,dk DEN,DF,27-351,22.3,32,14,24,6,2,16,43,37.2,27,24,3,21,22,54,47,1,Matches,Wolfsburg,Bundesliga
2796,Tiago Tomás,pt POR,"FW,MF",22-324,20.9,33,19,15,11,7,15,35,42.9,20,17,4,13,9,42,19,0,Matches,Wolfsburg,Bundesliga
2797,Jonas Wind,dk DEN,"FW,MF",26-088,20.8,9,5,1,7,1,3,7,42.9,4,16,3,13,6,15,15,0,Matches,Wolfsburg,Bundesliga
2798,Patrick Wimmer,at AUT,"MF,FW",23-341,18.2,42,31,19,17,6,14,42,33.3,28,31,4,27,31,73,13,2,Matches,Wolfsburg,Bundesliga
2799,Bence Dárdai,hu HUN,MF,19-102,14.3,24,14,9,13,2,16,29,55.2,13,20,4,16,12,36,28,1,Matches,Wolfsburg,Bundesliga
2800,Mattias Svanberg,se SWE,MF,26-121,13.5,20,10,6,11,3,9,19,47.4,10,11,4,7,15,35,26,0,Matches,Wolfsburg,Bundesliga
2801,Ridle Baku,de GER,"FW,MF",27-028,13.0,23,15,9,9,5,8,19,42.1,11,22,1,21,15,38,15,0,Matches,Wolfsburg,Bundesliga
2802,Yannick Gerhardt,de GER,"MF,DF",31-054,14.9,23,12,12,10,1,8,26,30.8,18,28,8,20,16,39,41,0,Matches,Wolfsburg,Bundesliga
2803,Jakub Kamiński,pl POL,"DF,MF",22-335,11.1,16,7,7,3,6,8,21,38.1,13,17,7,10,11,27,21,1,Matches,Wolfsburg,Bundesliga
2804,Sebastiaan Bornauw,be BEL,DF,26-045,8.7,9,6,4,4,1,4,8,50.0,4,14,12,2,12,21,35,0,Matches,Wolfsburg,Bundesliga
2805,Cedric Zesiger,ch SUI,DF,26-316,5.8,13,8,6,5,2,6,12,50.0,6,6,5,1,3,16,28,0,Matches,Wolfsburg,Bundesliga
2806,Aster Vranckx,be BEL,MF,22-214,5.7,10,5,2,8,0,2,7,28.6,5,14,3,11,9,19,13,0,Matches,Wolfsburg,Bundesliga
2807,Marius Müller,de GER,GK,31-298,5.3,0,0,0,0,0,0,0,,0,0,0,0,0,0,0,0,Matches,Wolfsburg,Bundesliga
2808,Andreas Skov Olsen,dk DEN,"FW,DF",25-128,5.1,8,6,5,3,0,4,4,100.0,0,4,0,4,2,10,9,0,Matches,Wolfsburg,Bundesliga
2809,Salih Özcan,tr TUR,MF,27-115,3.9,2,2,1,0,1,1,5,20.0,4,5,1,4,7,9,5,0,Matches,Wolfsburg,Bundesliga
2810,Lukas Nmecha,de GER,"FW,MF",26-143,4.2,2,0,1,1,0,0,1,0.0,1,1,0,1,2,4,3,0,Matches,Wolfsburg,Bundesliga
2811,Mads Roerslev,dk DEN,DF,25-316,3.0,10,9,8,1,1,6,9,66.7,3,2,2,0,5,15,14,0,Matches,Wolfsburg,Bundesliga
2812,David Odogu,de GER,DF,18-337,2.2,6,4,4,2,0,3,5,60.0,2,2,2,0,2,8,25,1,Matches,Wolfsburg,Bundesliga
2813,Lovro Majer,hr CRO,MF,27-109,2.1,0,0,0,0,0,0,3,0.0,3,2,0,2,0,0,2,0,Matches,Wolfsburg,Bundesliga
2814,Kevin Paredes,us USA,DF,21-364,1.4,3,1,3,0,0,2,3,66.7,1,2,2,0,1,4,0,0,Matches,Wolfsburg,Bundesliga
2815,Kevin Behrens,de GER,FW,34-092,1.7,1,1,0,1,0,0,1,0.0,1,0,0,0,1,2,2,0,Matches,Wolfsburg,Bundesliga
