,Player,Nation,Pos,Age,90s,Tkl,TklW,Def 3rd,Mid 3rd,Att 3rd,Tkl,Att,Tkl%,Lost,Blocks,Sh,Pass,Int,Tkl+Int,Clr,Err,Matches,Squad,League
0,David Raya,es ESP,GK,29-238,35.0,0,0,0,0,0,0,2,0.0,2,0,0,0,2,2,18,6,Matches,Arsenal,Premier-League
1,William Saliba,fr FRA,DF,24-048,32.3,60,36,35,23,2,21,27,77.8,6,24,15,9,21,81,111,6,Matches,Arsenal,Premier-League
2,Declan Rice,eng ENG,MF,26-117,29.4,52,24,21,25,6,16,37,43.2,21,24,11,13,25,77,44,0,Matches,Arsenal,Premier-League
3,Thomas Partey,gh GHA,"MF,DF",31-332,28.1,80,49,23,37,20,44,72,61.1,28,25,7,18,33,113,46,4,Matches,Arsenal,Premier-League
4,Gabriel Magalhães,br BRA,DF,27-143,26.3,25,15,12,8,5,12,16,75.0,4,42,29,13,16,41,93,2,Matches,Arsenal,Premier-League
5,Jurriën Timber,nl NED,DF,23-328,26.9,58,38,17,30,11,18,27,66.7,9,19,4,15,22,80,44,1,Matches,Arsenal,Premier-League
6,Leandro Trossard,be BEL,FW,30-158,26.2,26,17,5,14,7,9,31,29.0,22,31,0,31,9,35,17,0,Matches,Arsenal,Premier-League
7,Martin Ødegaard,no NOR,MF,26-145,23.7,19,11,9,7,3,4,24,16.7,20,5,0,5,4,23,5,1,Matches,Arsenal,Premier-League
8,Gabriel Martinelli,br BRA,"FW,MF",23-327,22.7,20,15,8,5,7,7,23,30.4,16,10,0,10,4,24,15,0,Matches,Arsenal,Premier-League
9,Kai Havertz,de GER,"FW,MF",25-334,20.4,16,9,3,6,7,4,15,26.7,11,22,4,18,6,22,31,1,Matches,Arsenal,Premier-League
10,Bukayo Saka,eng ENG,"FW,MF",23-248,17.1,24,13,7,10,7,11,22,50.0,11,21,0,21,3,27,8,0,Matches,Arsenal,Premier-League
11,Mikel Merino,es ESP,"MF,FW",28-323,15.8,38,22,6,21,11,15,29,51.7,14,18,5,13,14,52,24,1,Matches,Arsenal,Premier-League
12,Myles Lewis-Skelly,eng ENG,DF,18-227,13.0,22,14,10,9,3,10,10,100.0,0,2,1,1,6,28,20,0,Matches,Arsenal,Premier-League
13,Riccardo Calafiori,it ITA,DF,22-357,10.3,26,18,15,9,2,18,29,62.1,11,12,6,6,9,35,25,0,Matches,Arsenal,Premier-League
14,Ben White,eng ENG,DF,27-215,10.5,13,9,9,2,2,11,28,39.3,17,9,7,2,15,28,35,0,Matches,Arsenal,Premier-League
15,Ethan Nwaneri,eng ENG,"FW,MF",18-051,9.1,11,7,4,4,3,7,18,38.9,11,8,2,6,2,13,4,1,Matches,Arsenal,Premier-League
16,Jorginho,it ITA,MF,33-142,7.8,12,4,1,7,4,8,20,40.0,12,3,0,3,7,19,2,2,Matches,Arsenal,Premier-League
17,Jakub Kiwior,pl POL,DF,25-085,9.5,13,7,7,5,1,8,11,72.7,3,8,5,3,3,16,37,2,Matches,Arsenal,Premier-League
18,Gabriel Jesus,br BRA,FW,28-038,6.8,10,6,4,3,3,4,9,44.4,5,10,1,9,4,14,8,0,Matches,Arsenal,Premier-League
19,Raheem Sterling,eng ENG,"FW,MF",30-154,4.9,8,4,1,2,5,4,8,50.0,4,3,0,3,1,9,3,0,Matches,Arsenal,Premier-League
20,Oleksandr Zinchenko,ua UKR,"DF,MF",28-147,5.1,4,1,1,2,1,2,7,28.6,5,5,0,5,4,8,6,0,Matches,Arsenal,Premier-League
21,Kieran Tierney,sct SCO,"DF,FW",27-340,2.0,5,4,3,1,1,3,5,60.0,2,0,0,0,2,7,5,0,Matches,Arsenal,Premier-League
22,Nathan Butler-Oyedeji,eng ENG,FW,22-127,0.1,0,0,0,0,0,0,0,,0,0,0,0,0,0,0,0,Matches,Arsenal,Premier-League
23,Takehiro Tomiyasu,jp JPN,DF,26-187,0.1,0,0,0,0,0,0,0,,0,0,0,0,0,0,1,0,Matches,Arsenal,Premier-League
24,Reiss Nelson,eng ENG,FW,25-152,0.0,1,0,0,1,0,0,1,0.0,1,0,0,0,0,1,1,0,Matches,Arsenal,Premier-League
25,Emiliano Martínez,ar ARG,GK,32-251,34.0,3,3,3,0,0,2,2,100.0,0,1,0,1,0,3,17,6,Matches,Aston-Villa,Premier-League
26,Youri Tielemans,be BEL,MF,28-004,33.3,83,57,31,44,8,40,73,54.8,33,37,16,21,22,105,47,4,Matches,Aston-Villa,Premier-League
27,Morgan Rogers,eng ENG,"FW,MF",22-289,32.7,40,21,15,14,11,22,44,50.0,22,26,7,19,5,45,20,2,Matches,Aston-Villa,Premier-League
28,Ezri Konsa,eng ENG,DF,27-200,30.6,32,17,19,9,4,18,23,78.3,5,18,10,8,21,53,107,4,Matches,Aston-Villa,Premier-League
29,Ollie Watkins,eng ENG,FW,29-132,26.9,10,7,0,6,4,3,11,27.3,8,11,3,8,8,18,15,2,Matches,Aston-Villa,Premier-League
30,Lucas Digne,fr FRA,DF,31-295,26.1,65,38,40,16,9,44,66,66.7,22,23,4,19,25,90,89,1,Matches,Aston-Villa,Premier-League
31,John McGinn,sct SCO,"MF,FW",30-205,23.0,31,22,10,13,8,11,29,37.9,18,21,2,19,14,45,17,3,Matches,Aston-Villa,Premier-League
32,Matty Cash,pl POL,DF,27-277,21.0,50,29,26,20,4,25,36,69.4,11,20,8,12,21,71,63,2,Matches,Aston-Villa,Premier-League
33,Pau Torres,es ESP,DF,28-115,20.4,20,14,11,7,2,9,15,60.0,6,14,10,4,9,29,66,2,Matches,Aston-Villa,Premier-League
34,Jacob Ramsey,eng ENG,"FW,MF",23-348,17.7,30,15,14,10,6,10,20,50.0,10,23,4,19,8,38,8,1,Matches,Aston-Villa,Premier-League
35,Boubacar Kamara,fr FRA,MF,25-169,17.3,49,20,28,17,4,28,55,50.9,27,17,7,10,19,68,50,3,Matches,Aston-Villa,Premier-League
36,Amadou Onana,be BEL,MF,23-268,16.3,49,24,22,23,4,14,27,51.9,13,15,7,8,25,74,41,3,Matches,Aston-Villa,Premier-League
37,Leon Bailey,jm JAM,"FW,MF",27-275,12.6,6,4,1,3,2,2,10,20.0,8,6,0,6,3,9,12,0,Matches,Aston-Villa,Premier-League
38,Tyrone Mings,eng ENG,DF,32-059,12.4,7,6,6,1,0,2,2,100.0,0,13,11,2,7,14,61,1,Matches,Aston-Villa,Premier-League
39,Ian Maatsen,nl NED,DF,23-062,10.7,27,15,16,8,3,16,22,72.7,6,11,0,11,15,42,34,2,Matches,Aston-Villa,Premier-League
40,Diego Carlos,br BRA,DF,32-057,9.2,8,3,6,1,1,4,6,66.7,2,13,7,6,5,13,36,2,Matches,Aston-Villa,Premier-League
41,Marco Asensio,es ESP,MF,29-110,6.8,7,5,0,7,0,3,9,33.3,6,4,0,4,2,9,3,0,Matches,Aston-Villa,Premier-League
42,Axel Disasi,fr FRA,DF,27-061,5.4,8,5,7,1,0,3,7,42.9,4,4,1,3,5,13,18,0,Matches,Aston-Villa,Premier-League
43,Lamare Bogarde,nl NED,"DF,MF",21-126,5.3,14,6,6,6,2,10,16,62.5,6,5,3,2,1,15,13,0,Matches,Aston-Villa,Premier-League
44,Andrés García,es ESP,"DF,MF",22-093,3.5,9,5,5,3,1,4,8,50.0,4,2,0,2,2,11,10,2,Matches,Aston-Villa,Premier-League
45,Jáder Durán,co COL,FW,21-149,7.1,8,7,1,2,5,1,4,25.0,3,5,0,5,0,8,13,0,Matches,Aston-Villa,Premier-League
46,Marcus Rashford,eng ENG,FW,27-192,4.9,10,7,2,3,5,4,6,66.7,2,2,0,2,1,11,3,0,Matches,Aston-Villa,Premier-League
47,Ross Barkley,eng ENG,MF,31-157,6.3,14,3,4,10,0,9,14,64.3,5,9,3,6,10,24,5,0,Matches,Aston-Villa,Premier-League
48,Jaden Philogene Bidace,eng ENG,"FW,MF",23-092,3.7,11,5,4,7,0,4,6,66.7,2,5,0,5,3,14,2,1,Matches,Aston-Villa,Premier-League
49,Donyell Malen,nl NED,FW,26-122,3.3,7,4,3,3,1,1,4,25.0,3,1,0,1,0,7,1,0,Matches,Aston-Villa,Premier-League
50,Robin Olsen,se SWE,GK,35-123,2.0,1,0,1,0,0,1,1,100.0,0,0,0,0,0,1,2,1,Matches,Aston-Villa,Premier-League
51,Kosta Nedeljković,rs SRB,DF,19-146,1.4,7,5,1,3,3,2,3,66.7,1,1,0,1,0,7,3,0,Matches,Aston-Villa,Premier-League
52,Emi Buendía,ar ARG,"MF,FW",28-137,1.1,6,6,3,2,1,0,5,0.0,5,5,1,4,0,6,2,0,Matches,Aston-Villa,Premier-League
53,Milos Kerkez,hu HUN,DF,21-186,35.2,52,26,25,20,7,24,38,63.2,14,36,11,25,44,96,103,3,Matches,Bournemouth,Premier-League
54,Antoine Semenyo,gh GHA,FW,25-125,33.6,53,34,16,24,13,16,42,38.1,26,61,8,53,10,63,38,2,Matches,Bournemouth,Premier-League
55,Illia Zabarnyi,ua UKR,DF,22-253,32.5,48,33,28,19,1,32,47,68.1,15,33,20,13,39,87,175,2,Matches,Bournemouth,Premier-League
56,Lewis Cook,eng ENG,"MF,DF",28-098,32.3,81,42,41,36,4,37,67,55.2,30,30,11,19,40,121,68,0,Matches,Bournemouth,Premier-League
57,Kepa Arrizabalaga,es ESP,GK,30-221,29.0,1,0,1,0,0,0,2,0.0,2,1,0,1,0,1,15,3,Matches,Bournemouth,Premier-League
58,Justin Kluivert,nl NED,"MF,FW",26-007,24.5,21,9,4,10,7,4,21,19.0,17,24,0,24,13,34,23,1,Matches,Bournemouth,Premier-League
59,Ryan Christie,sct SCO,MF,30-079,23.5,54,33,19,27,8,27,64,42.2,37,44,11,33,30,84,51,3,Matches,Bournemouth,Premier-League
60,Evanilson,br BRA,FW,25-218,23.9,16,10,6,5,5,8,12,66.7,4,11,2,9,0,16,21,0,Matches,Bournemouth,Premier-League
61,Dean Huijsen,es ESP,DF,20-028,25.8,36,26,19,16,1,18,28,64.3,10,36,28,8,50,86,185,4,Matches,Bournemouth,Premier-League
62,Dango Ouattara,bf BFA,FW,23-090,22.3,35,26,14,11,10,17,41,41.5,24,36,10,26,11,46,51,0,Matches,Bournemouth,Premier-League
63,Tyler Adams,us USA,MF,26-087,19.8,78,48,24,47,7,36,68,52.9,32,33,10,23,32,110,40,0,Matches,Bournemouth,Premier-League
64,Marcus Tavernier,eng ENG,"FW,MF",26-051,19.6,42,24,14,19,9,10,26,38.5,16,16,3,13,5,47,11,0,Matches,Bournemouth,Premier-League
65,Adam Smith,eng ENG,DF,34-013,16.4,22,10,11,5,6,12,25,48.0,13,12,5,7,14,36,48,1,Matches,Bournemouth,Premier-League
66,Marcos Senesi,ar ARG,DF,28-002,11.4,36,21,23,11,2,14,30,46.7,16,15,7,8,11,47,56,0,Matches,Bournemouth,Premier-League
67,David Brooks,wls WAL,"FW,MF",27-308,9.5,12,5,2,7,3,1,14,7.1,13,16,2,14,5,17,8,1,Matches,Bournemouth,Premier-League
68,Alex Scott,eng ENG,MF,21-264,8.4,27,14,11,8,8,19,42,45.2,23,17,4,13,10,37,15,0,Matches,Bournemouth,Premier-League
69,James Hill,eng ENG,DF,23-122,5.0,15,8,6,6,3,3,11,27.3,8,5,0,5,9,24,31,0,Matches,Bournemouth,Premier-League
70,Julian Araujo,mx MEX,DF,23-272,4.8,8,3,4,4,0,5,12,41.7,7,3,0,3,6,14,16,0,Matches,Bournemouth,Premier-League
71,Mark Travers,ie IRL,GK,25-359,5.0,0,0,0,0,0,0,0,,0,0,0,0,0,0,5,0,Matches,Bournemouth,Premier-League
72,Enes Ünal,tr TUR,"FW,MF",28-002,3.8,1,0,0,0,1,0,3,0.0,3,1,0,1,0,1,6,0,Matches,Bournemouth,Premier-League
73,Neto,br BRA,GK,35-297,2.0,0,0,0,0,0,0,0,,0,0,0,0,0,0,1,1,Matches,Bournemouth,Premier-League
74,Luis Sinisterra,co COL,"FW,MF",25-329,2.6,7,2,3,2,2,0,4,0.0,4,3,0,3,1,8,8,0,Matches,Bournemouth,Premier-League
75,Philip Billing,dk DEN,MF,28-335,2.0,14,5,7,6,1,3,4,75.0,1,3,0,3,5,19,2,0,Matches,Bournemouth,Premier-League
76,Max Aarons,eng ENG,DF,25-128,1.0,2,2,1,1,0,1,1,100.0,0,3,1,2,1,3,0,0,Matches,Bournemouth,Premier-League
77,Daniel Jebbison,eng ENG,FW,21-272,0.9,3,2,2,1,0,3,5,60.0,2,2,1,1,1,4,1,0,Matches,Bournemouth,Premier-League
78,Ben Winterburn,eng ENG,"FW,MF",20-250,0.3,0,0,0,0,0,0,1,0.0,1,0,0,0,2,2,0,0,Matches,Bournemouth,Premier-League
79,Julio Soler,ar ARG,FW,20-085,0.0,1,1,1,0,0,1,1,100.0,0,1,0,1,0,1,0,0,Matches,Bournemouth,Premier-League
80,Remy Rees-Dottin,eng ENG,FW,19-067,0.0,0,0,0,0,0,0,0,,0,0,0,0,0,0,0,0,Matches,Bournemouth,Premier-League
81,Zain Silcott-Duberry,ms MSR,FW,19-307,0.0,1,1,0,0,1,1,1,100.0,0,0,0,0,0,1,0,0,Matches,Bournemouth,Premier-League
82,Nathan Collins,ie IRL,DF,24-011,36.0,37,22,22,11,4,22,35,62.9,13,72,52,20,33,70,219,2,Matches,Brentford,Premier-League
83,Bryan Mbeumo,cm CMR,FW,25-277,35.9,45,29,17,14,14,18,31,58.1,13,24,3,21,14,59,52,1,Matches,Brentford,Premier-League
84,Mark Flekken,nl NED,GK,31-332,34.4,4,4,4,0,0,3,9,33.3,6,2,0,2,0,4,26,4,Matches,Brentford,Premier-League
85,Keane Lewis-Potter,eng ENG,"DF,FW",24-078,32.5,46,26,25,15,6,28,46,60.9,18,26,9,17,19,65,72,3,Matches,Brentford,Premier-League
86,Mikkel Damsgaard,dk DEN,"MF,FW",24-312,30.5,80,43,27,27,26,30,77,39.0,47,39,2,37,26,106,30,2,Matches,Brentford,Premier-League
87,Yoane Wissa,cd COD,FW,28-250,30.4,22,12,6,8,8,11,27,40.7,16,29,8,21,8,30,20,3,Matches,Brentford,Premier-League
88,Christian Nørgaard,dk DEN,MF,31-062,29.3,76,46,35,34,7,45,74,60.8,29,51,19,32,46,122,65,1,Matches,Brentford,Premier-League
89,Sepp van den Berg,nl NED,DF,23-142,26.7,37,22,23,10,4,18,27,66.7,9,51,37,14,20,57,124,3,Matches,Brentford,Premier-League
90,Vitaly Janelt,de GER,MF,27-001,25.0,38,22,14,13,11,21,36,58.3,15,33,9,24,27,65,53,1,Matches,Brentford,Premier-League
91,Kevin Schade,de GER,FW,23-165,23.8,36,23,14,10,12,12,20,60.0,8,17,2,15,5,41,32,0,Matches,Brentford,Premier-League
92,Ethan Pinnock,jm JAM,DF,31-347,21.3,35,19,15,16,4,13,24,54.2,11,29,18,11,24,59,142,4,Matches,Brentford,Premier-League
93,Kristoffer Ajer,no NOR,DF,27-024,15.6,25,17,14,10,1,14,26,53.8,12,17,4,13,12,37,49,0,Matches,Brentford,Premier-League
94,Yehor Yarmoliuk,ua UKR,MF,21-071,14.3,42,25,16,20,6,25,49,51.0,24,24,7,17,12,54,31,0,Matches,Brentford,Premier-League
95,Mads Roerslev,dk DEN,DF,25-321,12.2,18,8,14,3,1,11,28,39.3,17,12,5,7,4,22,35,0,Matches,Brentford,Premier-League
96,Mathias Jensen,dk DEN,MF,29-130,9.3,14,10,6,6,2,8,16,50.0,8,13,4,9,8,22,13,1,Matches,Brentford,Premier-League
97,Michael Kayode,it ITA,DF,20-305,4.2,15,10,11,4,0,9,11,81.8,2,2,0,2,5,20,15,0,Matches,Brentford,Premier-League
98,Fabio Carvalho,pt POR,"FW,MF",22-254,5.1,13,9,4,4,5,6,13,46.2,7,6,1,5,3,16,2,0,Matches,Brentford,Premier-League
99,Ben Mee,eng ENG,DF,35-232,2.0,2,2,0,2,0,1,1,100.0,0,3,3,0,4,6,7,0,Matches,Brentford,Premier-League
100,Thiago,br BRA,FW,23-319,1.6,4,3,1,1,2,0,1,0.0,1,2,0,2,2,6,2,1,Matches,Brentford,Premier-League
101,Hákon Rafn Valdimarsson,is ISL,GK,23-210,1.6,0,0,0,0,0,0,0,,0,0,0,0,0,0,2,0,Matches,Brentford,Premier-League
102,Edmond-Paris Maghoma,eng ENG,"MF,FW",24-003,1.3,2,1,0,2,0,1,3,33.3,2,2,2,0,1,3,2,0,Matches,Brentford,Premier-League
103,Rico Henry,eng ENG,DF,27-307,0.9,0,0,0,0,0,0,4,0.0,4,3,1,2,1,1,2,0,Matches,Brentford,Premier-League
104,Yunus Emre Konak,tr TUR,"FW,MF",19-121,0.5,4,4,0,4,0,1,2,50.0,1,2,0,2,0,4,0,0,Matches,Brentford,Premier-League
105,Kim Jisoo,kr KOR,DF,20-138,0.3,0,0,0,0,0,0,0,,0,0,0,0,0,0,2,0,Matches,Brentford,Premier-League
106,Frank Onyeka,ng NGA,MF,27-130,0.3,0,0,0,0,0,0,0,,0,0,0,0,0,0,0,0,Matches,Brentford,Premier-League
107,Gustavo Nunes,br BRA,"FW,MF",19-172,0.1,3,2,2,0,1,2,2,100.0,0,0,0,0,0,3,2,0,Matches,Brentford,Premier-League
108,Jayden Meghoma,eng ENG,DF,18-317,0.1,0,0,0,0,0,0,0,,0,0,0,0,0,0,0,0,Matches,Brentford,Premier-League
109,Ryan Trevitt,eng ENG,MF,22-060,0.0,1,1,1,0,0,0,0,,0,0,0,0,0,1,0,0,Matches,Brentford,Premier-League
110,Bart Verbruggen,nl NED,GK,22-266,34.0,0,0,0,0,0,0,3,0.0,3,1,0,1,0,0,28,5,Matches,Brighton-and-Hove-Albion,Premier-League
111,Jan Paul van Hecke,nl NED,DF,24-337,30.9,41,27,21,19,1,21,39,53.8,18,33,19,14,23,64,138,2,Matches,Brighton-and-Hove-Albion,Premier-League
112,Carlos Baleba,cm CMR,MF,21-128,27.6,73,42,25,33,15,46,76,60.5,30,44,10,34,43,116,42,1,Matches,Brighton-and-Hove-Albion,Premier-League
113,Kaoru Mitoma,jp JPN,"FW,MF",27-356,28.1,44,26,15,13,16,19,48,39.6,29,48,3,45,13,57,10,0,Matches,Brighton-and-Hove-Albion,Premier-League
114,Pervis Estupiñán,ec ECU,DF,27-110,25.7,60,40,31,22,7,32,47,68.1,15,17,3,14,36,96,63,2,Matches,Brighton-and-Hove-Albion,Premier-League
115,Lewis Dunk,eng ENG,DF,33-171,23.1,17,10,8,7,2,11,19,57.9,8,28,18,10,13,30,79,2,Matches,Brighton-and-Hove-Albion,Premier-League
116,Danny Welbeck,eng ENG,FW,34-166,22.6,24,15,6,13,5,7,19,36.8,12,18,3,15,5,29,14,0,Matches,Brighton-and-Hove-Albion,Premier-League
117,João Pedro,br BRA,"FW,MF",23-227,21.6,16,12,6,6,4,4,11,36.4,7,12,0,12,9,25,12,0,Matches,Brighton-and-Hove-Albion,Premier-League
118,Jack Hinshelwood,eng ENG,"DF,MF",20-030,19.4,26,18,8,10,8,11,27,40.7,16,8,3,5,15,41,37,1,Matches,Brighton-and-Hove-Albion,Premier-League
119,Yasin Ayari,se SWE,MF,21-217,20.5,56,31,15,30,11,23,53,43.4,30,23,6,17,20,76,25,0,Matches,Brighton-and-Hove-Albion,Premier-League
120,Joël Veltman,nl NED,DF,33-116,18.5,42,28,23,16,3,30,51,58.8,21,22,7,15,18,60,66,0,Matches,Brighton-and-Hove-Albion,Premier-League
121,Georginio Rutter,fr FRA,"MF,FW",23-021,18.4,39,15,13,18,8,14,36,38.9,22,20,3,17,10,49,13,2,Matches,Brighton-and-Hove-Albion,Premier-League
122,Yankuba Minteh,gm GAM,"FW,MF",20-293,18.5,47,34,25,13,9,17,45,37.8,28,21,0,21,11,58,31,0,Matches,Brighton-and-Hove-Albion,Premier-League
123,Matt O'Riley,dk DEN,MF,24-171,10.1,16,9,4,8,4,4,13,30.8,9,7,3,4,13,29,9,1,Matches,Brighton-and-Hove-Albion,Premier-League
124,Simon Adingra,ci CIV,"FW,MF",23-130,11.0,23,14,10,8,5,10,24,41.7,14,12,0,12,8,31,6,2,Matches,Brighton-and-Hove-Albion,Premier-League
125,Tariq Lamptey,gh GHA,DF,24-223,9.6,17,11,8,9,0,9,25,36.0,16,15,7,8,7,24,23,1,Matches,Brighton-and-Hove-Albion,Premier-League
126,Igor,br BRA,DF,27-093,10.0,4,4,2,1,1,4,10,40.0,6,23,14,9,4,8,39,1,Matches,Brighton-and-Hove-Albion,Premier-League
127,Adam Webster,eng ENG,DF,30-127,7.9,9,6,5,3,1,5,12,41.7,7,12,9,3,18,27,33,1,Matches,Brighton-and-Hove-Albion,Premier-League
128,Mats Wieffer,nl NED,"MF,DF",25-176,9.3,46,27,20,22,4,26,38,68.4,12,15,1,14,14,60,24,3,Matches,Brighton-and-Hove-Albion,Premier-League
129,Brajan Gruda,de GER,"MF,FW",20-345,6.0,14,6,6,5,3,7,14,50.0,7,8,0,8,2,16,5,1,Matches,Brighton-and-Hove-Albion,Premier-League
130,Ferdi Kadioglu,tr TUR,"DF,MF",25-216,4.3,10,6,4,5,1,6,15,40.0,9,2,2,0,8,18,17,0,Matches,Brighton-and-Hove-Albion,Premier-League
131,Diego Gómez,py PAR,MF,22-045,5.0,17,10,8,7,2,9,19,47.4,10,12,0,12,7,24,10,1,Matches,Brighton-and-Hove-Albion,Premier-League
132,James Milner,eng ENG,MF,39-127,1.9,5,2,1,3,1,3,3,100.0,0,4,2,2,2,7,2,1,Matches,Brighton-and-Hove-Albion,Premier-League
133,Julio Enciso,py PAR,"MF,FW",21-108,3.3,0,0,0,0,0,0,2,0.0,2,2,0,2,0,0,1,0,Matches,Brighton-and-Hove-Albion,Premier-League
134,Evan Ferguson,ie IRL,FW,20-204,2.7,4,3,0,3,1,2,5,40.0,3,3,1,2,0,4,4,0,Matches,Brighton-and-Hove-Albion,Premier-League
135,Jason Steele,eng ENG,GK,34-266,2.0,0,0,0,0,0,0,0,,0,0,0,0,0,0,1,0,Matches,Brighton-and-Hove-Albion,Premier-League
136,Solly March,eng ENG,"FW,MF",30-295,1.9,6,3,2,2,2,5,8,62.5,3,3,0,3,2,8,2,1,Matches,Brighton-and-Hove-Albion,Premier-League
137,Billy Gilmour,sct SCO,MF,23-334,1.1,3,3,2,1,0,3,4,75.0,1,1,0,1,0,3,1,0,Matches,Brighton-and-Hove-Albion,Premier-League
138,Eiran Cashin,ie IRL,DF,23-183,0.2,0,0,0,0,0,0,1,0.0,1,0,0,0,0,0,2,0,Matches,Brighton-and-Hove-Albion,Premier-League
139,Jakub Moder,pl POL,MF,26-034,0.1,1,0,1,0,0,0,2,0.0,2,0,0,0,0,1,3,0,Matches,Brighton-and-Hove-Albion,Premier-League
140,Jeremy Sarmiento,ec ECU,MF,22-329,0.1,0,0,0,0,0,0,0,,0,0,0,0,0,0,0,0,Matches,Brighton-and-Hove-Albion,Premier-League
141,Moisés Caicedo,ec ECU,"MF,DF",23-190,34.2,103,64,37,51,15,50,80,62.5,30,45,10,35,49,152,52,1,Matches,Chelsea,Premier-League
142,Cole Palmer,eng ENG,MF,23-005,32.5,27,17,11,9,7,9,23,39.1,14,14,1,13,11,38,18,1,Matches,Chelsea,Premier-League
143,Levi Colwill,eng ENG,DF,22-074,32.0,42,30,22,17,3,16,25,64.0,9,35,24,11,32,74,104,4,Matches,Chelsea,Premier-League
144,Marc Cucurella,es ESP,DF,26-293,30.2,59,39,30,24,5,26,53,49.1,27,45,14,31,25,84,84,3,Matches,Chelsea,Premier-League
145,Enzo Fernández,ar ARG,MF,24-114,29.7,63,32,17,29,17,31,83,37.3,52,36,7,29,13,76,22,4,Matches,Chelsea,Premier-League
146,Robert Sánchez,es ESP,GK,27-174,29.0,0,0,0,0,0,0,1,0.0,1,0,0,0,2,2,20,9,Matches,Chelsea,Premier-League
147,Nicolas Jackson,sn SEN,FW,23-325,24.3,22,13,6,7,9,5,10,50.0,5,14,2,12,3,25,15,0,Matches,Chelsea,Premier-League
148,Noni Madueke,eng ENG,FW,23-062,20.1,22,15,7,12,3,13,34,38.2,21,17,0,17,8,30,11,0,Matches,Chelsea,Premier-League
149,Pedro Neto,pt POR,FW,25-063,22.4,22,9,9,9,4,8,19,42.1,11,13,2,11,9,31,6,0,Matches,Chelsea,Premier-League
150,Malo Gusto,fr FRA,DF,21-357,20.4,43,28,26,15,2,24,47,51.1,23,29,8,21,23,66,48,5,Matches,Chelsea,Premier-League
151,Jadon Sancho,eng ENG,FW,25-047,18.7,10,6,3,2,5,5,12,41.7,7,9,0,9,2,12,6,2,Matches,Chelsea,Premier-League
152,Wesley Fofana,fr FRA,DF,24-145,13.0,13,12,6,7,0,6,14,42.9,8,14,9,5,14,27,55,2,Matches,Chelsea,Premier-League
153,Tosin Adarabioyo,eng ENG,DF,27-229,13.7,14,10,10,4,0,8,12,66.7,4,9,7,2,10,24,62,0,Matches,Chelsea,Premier-League
154,Reece James,eng ENG,"DF,MF",25-154,9.3,9,9,5,3,1,3,9,33.3,6,12,4,8,12,21,18,4,Matches,Chelsea,Premier-League
155,Trevoh Chalobah,eng ENG,DF,25-310,9.3,10,6,4,6,0,6,7,85.7,1,5,2,3,9,19,46,1,Matches,Chelsea,Premier-League
156,Roméo Lavia,be BEL,MF,21-125,7.6,21,13,5,12,4,9,19,47.4,10,6,0,6,14,35,8,0,Matches,Chelsea,Premier-League
157,Christopher Nkunku,fr FRA,FW,27-178,10.2,12,8,3,4,5,6,8,75.0,2,9,2,7,7,19,10,0,Matches,Chelsea,Premier-League
158,Filip Jørgensen,dk DEN,GK,23-025,6.0,0,0,0,0,0,0,0,,0,0,0,0,0,0,0,3,Matches,Chelsea,Premier-League
159,Axel Disasi,fr FRA,DF,27-061,4.0,7,4,5,1,1,6,11,54.5,5,4,1,3,2,9,11,1,Matches,Chelsea,Premier-League
160,João Félix,pt POR,"FW,MF",25-182,4.1,8,3,2,5,1,5,9,55.6,4,2,0,2,3,11,2,0,Matches,Chelsea,Premier-League
161,Benoît Badiashile,fr FRA,DF,24-046,3.7,9,6,5,4,0,4,5,80.0,1,2,2,0,6,15,12,2,Matches,Chelsea,Premier-League
162,Kiernan Dewsbury-Hall,eng ENG,"MF,FW",26-247,2.9,8,5,1,1,6,4,6,66.7,2,2,0,2,1,9,8,1,Matches,Chelsea,Premier-League
163,Joshua Acheampong,eng ENG,DF,19-006,1.9,2,1,2,0,0,2,2,100.0,0,1,0,1,1,3,2,0,Matches,Chelsea,Premier-League
164,Renato Veiga,pt POR,"DF,MF",21-286,2.0,9,6,6,3,0,4,12,33.3,8,3,1,2,1,10,2,0,Matches,Chelsea,Premier-League
165,Mykhailo Mudryk,ua UKR,FW,24-126,1.7,2,2,2,0,0,0,0,,0,3,1,2,0,2,1,0,Matches,Chelsea,Premier-League
166,Tyrique George,eng ENG,FW,19-096,1.1,2,0,2,0,0,2,3,66.7,1,0,0,0,1,3,1,0,Matches,Chelsea,Premier-League
167,Marc Guiu,es ESP,FW,19-127,0.8,1,1,0,1,0,1,1,100.0,0,0,0,0,0,1,0,0,Matches,Chelsea,Premier-League
168,Mathis Amougou,fr FRA,MF,19-113,0.1,0,0,0,0,0,0,0,,0,0,0,0,0,0,0,0,Matches,Chelsea,Premier-League
169,Shumaira Mheuka,eng ENG,MF,17-203,0.0,0,0,0,0,0,0,0,,0,0,0,0,0,0,0,0,Matches,Chelsea,Premier-League
170,Dean Henderson,eng ENG,GK,28-061,35.0,2,1,2,0,0,2,6,33.3,4,0,0,0,0,2,21,0,Matches,Crystal-Palace,Premier-League
171,Tyrick Mitchell,eng ENG,DF,25-253,32.7,87,54,54,26,7,22,42,52.4,20,62,12,50,14,101,99,2,Matches,Crystal-Palace,Premier-League
172,Daniel Muñoz,co COL,DF,28-351,32.9,113,74,53,37,23,52,89,58.4,37,36,4,32,40,153,102,1,Matches,Crystal-Palace,Premier-League
173,Marc Guéhi,eng ENG,DF,24-303,33.0,56,31,32,22,2,30,46,65.2,16,54,22,32,25,81,156,2,Matches,Crystal-Palace,Premier-League
174,Maxence Lacroix,fr FRA,DF,25-036,31.6,67,40,51,15,1,32,47,68.1,15,43,18,25,52,119,190,2,Matches,Crystal-Palace,Premier-League
175,Jean-Philippe Mateta,fr FRA,FW,27-318,28.0,17,12,4,11,2,3,16,18.8,13,16,3,13,2,19,22,0,Matches,Crystal-Palace,Premier-League
176,Eberechi Eze,eng ENG,"MF,FW",26-317,27.0,37,22,13,15,9,17,35,48.6,18,27,0,27,11,48,9,3,Matches,Crystal-Palace,Premier-League
177,Ismaila Sarr,sn SEN,"MF,FW",27-076,27.6,21,10,9,9,3,7,23,30.4,16,24,8,16,9,30,36,0,Matches,Crystal-Palace,Premier-League
178,Jefferson Lerma,co COL,"MF,DF",30-199,22.6,30,15,12,14,4,17,33,51.5,16,32,15,17,37,67,63,1,Matches,Crystal-Palace,Premier-League
179,Will Hughes,eng ENG,MF,30-025,21.1,61,33,17,31,13,27,59,45.8,32,30,14,16,19,80,24,3,Matches,Crystal-Palace,Premier-League
180,Chris Richards,us USA,DF,25-045,18.4,44,28,21,17,6,23,38,60.5,15,36,13,23,15,59,98,0,Matches,Crystal-Palace,Premier-League
181,Adam Wharton,eng ENG,MF,20-344,14.6,34,14,14,16,4,17,44,38.6,27,11,2,9,20,54,27,0,Matches,Crystal-Palace,Premier-League
182,Daichi Kamada,jp JPN,MF,28-280,15.8,45,27,19,22,4,13,38,34.2,25,21,5,16,16,61,14,0,Matches,Crystal-Palace,Premier-League
183,Trevoh Chalobah,eng ENG,DF,25-311,11.8,20,16,7,12,1,12,23,52.2,11,19,9,10,19,39,57,3,Matches,Crystal-Palace,Premier-League
184,Eddie Nketiah,eng ENG,"FW,MF",25-347,9.9,13,6,6,3,4,6,12,50.0,6,10,1,9,2,15,11,0,Matches,Crystal-Palace,Premier-League
185,Nathaniel Clyne,eng ENG,"DF,MF",34-037,5.4,12,8,8,3,1,6,11,54.5,5,4,2,2,3,15,14,1,Matches,Crystal-Palace,Premier-League
186,Cheick Doucouré,ml MLI,MF,25-124,5.0,16,8,6,8,2,5,11,45.5,6,4,0,4,11,27,10,1,Matches,Crystal-Palace,Premier-League
187,Justin Devenny,nir NIR,MF,21-213,4.8,14,9,6,7,1,7,14,50.0,7,3,0,3,0,14,10,0,Matches,Crystal-Palace,Premier-League
188,Odsonne Édouard,fr FRA,"MF,FW",27-116,1.3,1,0,0,1,0,0,2,0.0,2,1,0,1,0,1,1,0,Matches,Crystal-Palace,Premier-League
189,Joachim Andersen,dk DEN,DF,28-346,1.0,1,1,1,0,0,1,2,50.0,1,0,0,0,0,1,7,0,Matches,Crystal-Palace,Premier-League
190,Chadi Riad,ma MAR,DF,21-329,1.0,5,2,2,2,1,2,3,66.7,1,0,0,0,2,7,0,0,Matches,Crystal-Palace,Premier-League
191,Ben Chilwell,eng ENG,DF,28-142,1.5,4,4,2,2,0,0,3,0.0,3,3,1,2,4,8,11,0,Matches,Crystal-Palace,Premier-League
192,Jeffrey Schlupp,gh GHA,"MF,DF",32-140,1.1,2,0,1,0,1,0,3,0.0,3,6,0,6,0,2,2,0,Matches,Crystal-Palace,Premier-League
193,Romain Esse,eng ENG,MF,19-364,0.4,2,2,2,0,0,2,2,100.0,0,1,0,1,1,3,0,0,Matches,Crystal-Palace,Premier-League
194,Matheus França,br BRA,"FW,MF",21-041,0.3,1,0,0,1,0,0,0,,0,0,0,0,0,1,0,0,Matches,Crystal-Palace,Premier-League
195,Jordan Ayew,gh GHA,"FW,MF",33-243,0.2,1,0,0,0,1,0,0,,0,0,0,0,0,1,0,0,Matches,Crystal-Palace,Premier-League
196,Caleb Kporha,eng ENG,DF,18-301,0.1,2,1,2,0,0,2,2,100.0,0,0,0,0,0,2,1,0,Matches,Crystal-Palace,Premier-League
197,Asher Agbinone,eng ENG,MF,19-226,0.1,2,1,0,2,0,0,0,,0,0,0,0,0,2,0,0,Matches,Crystal-Palace,Premier-League
198,Joel Ward,eng ENG,DF,35-195,0.0,0,0,0,0,0,0,0,,0,0,0,0,0,0,0,0,Matches,Crystal-Palace,Premier-League
199,Jordan Pickford,eng ENG,GK,31-066,36.0,1,0,1,0,0,1,2,50.0,1,0,0,0,1,2,29,2,Matches,Everton,Premier-League
200,James Tarkowski,eng ENG,DF,32-174,32.5,64,40,39,22,3,24,39,61.5,15,57,42,15,41,105,213,4,Matches,Everton,Premier-League
201,Vitaliy Mykolenko,ua UKR,DF,25-348,32.2,55,33,33,14,8,26,52,50.0,26,25,10,15,39,94,137,2,Matches,Everton,Premier-League
202,Idrissa Gana Gueye,sn SEN,MF,35-228,32.0,125,74,57,52,16,54,91,59.3,37,48,9,39,44,169,33,1,Matches,Everton,Premier-League
203,Abdoulaye Doucouré,ml MLI,MF,32-131,27.6,46,27,21,18,7,13,41,31.7,28,31,6,25,9,55,19,1,Matches,Everton,Premier-League
204,Jarrad Branthwaite,eng ENG,DF,22-319,27.1,36,20,26,10,0,20,27,74.1,7,31,23,8,25,61,190,4,Matches,Everton,Premier-League
205,Iliman Ndiaye,sn SEN,FW,25-067,25.4,48,25,18,15,15,19,45,42.2,26,28,5,23,17,65,24,1,Matches,Everton,Premier-League
206,Jack Harrison,eng ENG,FW,28-173,21.8,32,22,12,12,8,15,43,34.9,28,18,2,16,9,41,32,2,Matches,Everton,Premier-League
207,Dominic Calvert-Lewin,eng ENG,FW,28-057,17.7,9,7,1,4,4,2,6,33.3,4,6,2,4,6,15,19,0,Matches,Everton,Premier-League
208,Ashley Young,eng ENG,"DF,FW",39-307,19.0,53,30,23,23,7,32,53,60.4,21,13,4,9,24,77,64,1,Matches,Everton,Premier-League
209,James Garner,eng ENG,"MF,DF",24-060,15.7,42,28,24,16,2,20,36,55.6,16,19,4,15,20,62,36,0,Matches,Everton,Premier-League
210,Jake O'Brien,ie IRL,DF,23-362,15.5,24,16,19,5,0,16,24,66.7,8,16,4,12,4,28,80,0,Matches,Everton,Premier-League
211,Jesper Lindstrøm,dk DEN,FW,25-072,13.8,45,25,24,19,2,19,55,34.5,36,15,3,12,12,57,17,0,Matches,Everton,Premier-League
212,Dwight McNeil,eng ENG,"MF,FW",25-171,14.4,12,7,5,5,2,9,20,45.0,11,7,0,7,5,17,2,1,Matches,Everton,Premier-League
213,Orel Mangala,be BEL,MF,27-055,14.0,16,8,3,11,2,5,8,62.5,3,8,3,5,21,37,24,1,Matches,Everton,Premier-League
214,Beto,gw GNB,FW,27-101,15.1,14,6,2,8,4,5,8,62.5,3,10,1,9,3,17,21,1,Matches,Everton,Premier-League
215,Michael Keane,eng ENG,DF,32-121,10.5,10,7,7,2,1,7,13,53.8,6,11,7,4,15,25,61,2,Matches,Everton,Premier-League
216,Carlos Alcaraz,ar ARG,"FW,MF",22-163,7.4,11,5,5,3,3,3,9,33.3,6,7,1,6,4,15,10,0,Matches,Everton,Premier-League
217,Tim Iroegbunam,eng ENG,MF,21-316,6.4,29,14,14,10,5,14,23,60.9,9,18,4,14,16,45,12,1,Matches,Everton,Premier-League
218,Armando Broja,al ALB,FW,23-244,3.7,3,1,1,1,1,0,0,,0,3,0,3,1,4,4,0,Matches,Everton,Premier-League
219,Nathan Patterson,sct SCO,DF,23-208,3.9,11,6,7,4,0,7,14,50.0,7,2,0,2,2,13,7,0,Matches,Everton,Premier-League
220,Séamus Coleman,ie IRL,DF,36-213,2.2,3,2,2,1,0,3,4,75.0,1,5,3,2,1,4,8,0,Matches,Everton,Premier-League
221,Roman Dixon,eng ENG,DF,20-137,1.0,5,5,3,2,0,4,4,100.0,0,1,0,1,1,6,3,0,Matches,Everton,Premier-League
222,Harrison Armstrong,eng ENG,MF,18-113,0.5,0,0,0,0,0,0,1,0.0,1,0,0,0,0,0,1,0,Matches,Everton,Premier-League
223,Youssef Chermiti,pt POR,"FW,MF",20-353,0.5,0,0,0,0,0,0,1,0.0,1,0,0,0,0,0,0,0,Matches,Everton,Premier-League
224,Mason Holgate,eng ENG,"FW,DF",28-202,0.1,0,0,0,0,0,0,0,,0,0,0,0,0,0,0,0,Matches,Everton,Premier-League
225,Bernd Leno,de GER,GK,33-068,36.0,2,2,2,0,0,2,2,100.0,0,1,0,1,0,2,10,5,Matches,Fulham,Premier-League
226,Alex Iwobi,ng NGA,"FW,MF",29-008,32.1,42,24,13,21,8,21,32,65.6,11,25,1,24,13,55,28,0,Matches,Fulham,Premier-League
227,Antonee Robinson,us USA,DF,27-276,33.2,90,57,53,30,7,44,89,49.4,45,37,7,30,57,147,124,2,Matches,Fulham,Premier-League
228,Calvin Bassey,ng NGA,DF,25-131,33.2,53,33,34,19,0,21,30,70.0,9,39,17,22,19,72,111,8,Matches,Fulham,Premier-League
229,Raúl Jiménez,mx MEX,FW,34-006,25.7,33,23,8,17,8,7,20,35.0,13,19,5,14,10,43,19,3,Matches,Fulham,Premier-League
230,Joachim Andersen,dk DEN,DF,28-345,26.7,26,18,19,6,1,14,21,66.7,7,33,26,7,31,57,174,1,Matches,Fulham,Premier-League
231,Saša Lukić,rs SRB,MF,28-271,24.1,66,37,21,39,6,21,53,39.6,32,19,7,12,26,92,32,0,Matches,Fulham,Premier-League
232,Sander Berge,no NOR,MF,27-086,24.1,48,28,22,22,4,25,37,67.6,12,26,8,18,21,69,36,1,Matches,Fulham,Premier-League
233,Andreas Pereira,br BRA,MF,29-130,21.7,23,13,7,11,5,10,41,24.4,31,16,2,14,8,31,17,3,Matches,Fulham,Premier-League
234,Emile Smith Rowe,eng ENG,MF,24-287,21.6,31,18,7,14,10,8,24,33.3,16,21,2,19,11,42,16,0,Matches,Fulham,Premier-League
235,Kenny Tete,nl NED,DF,29-214,17.7,50,34,24,14,12,20,34,58.8,14,25,8,17,29,79,53,0,Matches,Fulham,Premier-League
236,Timothy Castagne,be BEL,DF,29-157,18.3,46,29,28,15,3,26,45,57.8,19,15,6,9,22,68,83,0,Matches,Fulham,Premier-League
237,Adama Traoré,es ESP,"FW,MF",29-106,18.0,17,12,8,4,5,5,13,38.5,8,7,0,7,1,18,6,3,Matches,Fulham,Premier-League
238,Issa Diop,fr FRA,DF,28-122,14.9,26,12,18,8,0,13,18,72.2,5,10,7,3,9,35,72,2,Matches,Fulham,Premier-League
239,Harry Wilson,wls WAL,"FW,MF",28-050,12.0,16,11,10,3,3,9,15,60.0,6,13,1,12,5,21,7,1,Matches,Fulham,Premier-League
240,Rodrigo Muniz,br BRA,FW,24-007,10.7,10,5,3,5,2,4,4,100.0,0,9,2,7,5,15,14,0,Matches,Fulham,Premier-League
241,Ryan Sessegnon,eng ENG,"FW,DF",24-358,6.1,27,13,11,11,5,9,19,47.4,10,13,1,12,3,30,17,0,Matches,Fulham,Premier-League
242,Reiss Nelson,eng ENG,FW,25-152,5.4,8,6,3,3,2,5,13,38.5,8,11,0,11,5,13,2,0,Matches,Fulham,Premier-League
243,Jorge Cuenca,es ESP,DF,25-175,2.9,2,2,2,0,0,2,5,40.0,3,3,3,0,2,4,21,0,Matches,Fulham,Premier-League
244,Tom Cairney,sct SCO,MF,34-111,5.7,11,5,4,2,5,4,7,57.1,3,5,1,4,4,15,1,1,Matches,Fulham,Premier-League
245,Willian,br BRA,"FW,MF",36-275,2.9,4,2,0,3,1,2,6,33.3,4,0,0,0,1,5,1,0,Matches,Fulham,Premier-League
246,Joshua King,eng ENG,MF,18-128,1.0,5,3,2,3,0,0,2,0.0,2,2,0,2,1,6,1,0,Matches,Fulham,Premier-League
247,Harrison Reed,eng ENG,MF,30-104,1.2,6,3,3,2,1,1,3,33.3,2,1,0,1,1,7,3,0,Matches,Fulham,Premier-League
248,Martial Godo,eng ENG,"FW,DF",22-058,0.3,0,0,0,0,0,0,0,,0,1,0,1,1,1,0,0,Matches,Fulham,Premier-League
249,Carlos Vinícius,br BRA,"MF,FW",30-047,0.2,0,0,0,0,0,0,1,0.0,1,1,0,1,0,0,0,0,Matches,Fulham,Premier-League
250,Jay Stansfield,eng ENG,MF,22-168,0.0,0,0,0,0,0,0,0,,0,0,0,0,0,0,0,0,Matches,Fulham,Premier-League
251,Dara O'Shea,ie IRL,DF,26-069,32.7,47,30,33,11,3,20,31,64.5,11,61,49,12,31,78,211,4,Matches,Ipswich-Town,Premier-League
252,Liam Delap,eng ENG,FW,22-093,28.4,11,8,3,3,5,2,14,14.3,12,8,0,8,2,13,28,0,Matches,Ipswich-Town,Premier-League
253,Leif Davis,eng ENG,DF,25-120,28.5,45,26,32,9,4,29,46,63.0,17,24,8,16,25,70,72,3,Matches,Ipswich-Town,Premier-League
254,Sam Morsy,eg EGY,MF,33-244,28.6,65,38,38,23,4,26,58,44.8,32,32,13,19,29,94,44,4,Matches,Ipswich-Town,Premier-League
255,Omari Hutchinson,eng ENG,"MF,FW",21-194,26.7,31,12,14,10,7,13,47,27.7,34,25,1,24,10,41,13,1,Matches,Ipswich-Town,Premier-League
256,Jacob Greaves,eng ENG,DF,24-242,22.5,38,20,20,17,1,21,33,63.6,12,38,25,13,19,57,133,3,Matches,Ipswich-Town,Premier-League
257,Jens Cajuste,se SWE,MF,25-275,20.1,42,20,19,22,1,21,49,42.9,28,24,9,15,25,67,33,2,Matches,Ipswich-Town,Premier-League
258,Arijanet Muric,xk KVX,GK,26-186,18.0,0,0,0,0,0,0,2,0.0,2,0,0,0,0,0,10,5,Matches,Ipswich-Town,Premier-League
259,Axel Tuanzebe,cd COD,DF,27-179,17.0,29,17,20,3,6,16,24,66.7,8,18,9,9,22,51,54,1,Matches,Ipswich-Town,Premier-League
260,Cameron Burgess,au AUS,DF,29-203,17.1,17,12,14,3,0,9,11,81.8,2,20,15,5,14,31,128,3,Matches,Ipswich-Town,Premier-League
261,Ben Johnson,eng ENG,"DF,FW",25-108,15.0,38,22,23,12,3,20,41,48.8,21,22,5,17,13,51,54,1,Matches,Ipswich-Town,Premier-League
262,Kalvin Phillips,eng ENG,MF,29-161,13.7,35,19,8,20,7,15,39,38.5,24,35,6,29,19,54,37,2,Matches,Ipswich-Town,Premier-League
263,Sammie Szmodics,ie IRL,"FW,MF",29-230,10.9,15,9,4,9,2,6,23,26.1,17,10,2,8,6,21,14,0,Matches,Ipswich-Town,Premier-League
264,Luke Woolfenden,eng ENG,DF,26-203,13.2,9,6,5,4,0,2,5,40.0,3,21,14,7,19,28,76,0,Matches,Ipswich-Town,Premier-League
265,Alex Palmer,eng ENG,GK,28-275,12.0,0,0,0,0,0,0,0,,0,0,0,0,0,0,12,0,Matches,Ipswich-Town,Premier-League
266,Wes Burns,wls WAL,"FW,DF",30-170,10.3,13,11,1,9,3,4,10,40.0,6,7,2,5,10,23,13,2,Matches,Ipswich-Town,Premier-League
267,Jack Clarke,eng ENG,"FW,MF",24-170,12.1,28,17,11,9,8,16,32,50.0,16,6,0,6,7,35,29,1,Matches,Ipswich-Town,Premier-League
268,Julio Enciso,py PAR,"FW,MF",21-109,8.9,12,9,3,6,3,4,11,36.4,7,5,1,4,1,13,6,0,Matches,Ipswich-Town,Premier-League
269,Conor Chaplin,eng ENG,"MF,FW",28-085,8.5,12,5,4,6,2,6,13,46.2,7,8,1,7,3,15,3,0,Matches,Ipswich-Town,Premier-League
270,Nathan Broadhead,wls WAL,"MF,FW",27-037,6.7,7,3,2,5,0,3,9,33.3,6,6,1,5,4,11,5,0,Matches,Ipswich-Town,Premier-League
271,Christian Walton,eng ENG,GK,29-184,6.0,0,0,0,0,0,0,1,0.0,1,0,0,0,0,0,1,1,Matches,Ipswich-Town,Premier-League
272,Jaden Philogene Bidace,eng ENG,"FW,DF",23-093,5.3,14,7,6,6,2,8,15,53.3,7,11,1,10,10,24,9,1,Matches,Ipswich-Town,Premier-League
273,Jack Taylor,ie IRL,MF,26-323,9.2,20,10,6,11,3,12,25,48.0,13,10,3,7,9,29,24,0,Matches,Ipswich-Town,Premier-League
274,Harry Clarke,eng ENG,DF,24-071,4.2,5,3,3,2,0,3,6,50.0,3,5,4,1,4,9,14,3,Matches,Ipswich-Town,Premier-League
275,George Hirst,sct SCO,FW,26-086,5.8,3,3,1,0,2,1,3,33.3,2,1,1,0,2,5,10,0,Matches,Ipswich-Town,Premier-League
276,Conor Townsend,eng ENG,DF,32-069,3.7,11,8,9,2,0,8,11,72.7,3,8,6,2,4,15,16,0,Matches,Ipswich-Town,Premier-League
277,Chiedozie Ogbene,ie IRL,FW,28-011,2.6,7,3,1,2,4,2,4,50.0,2,1,0,1,1,8,3,0,Matches,Ipswich-Town,Premier-League
278,Massimo Luongo,au AUS,MF,32-229,2.2,8,5,6,1,1,4,7,57.1,3,4,2,2,2,10,2,0,Matches,Ipswich-Town,Premier-League
279,Ben Godfrey,eng ENG,DF,27-117,1.8,1,0,1,0,0,1,1,100.0,0,1,1,0,2,3,3,0,Matches,Ipswich-Town,Premier-League
280,Ali Al Hamadi,iq IRQ,FW,23-072,1.5,1,0,0,0,1,0,2,0.0,2,0,0,0,0,1,2,0,Matches,Ipswich-Town,Premier-League
281,Marcus Harness,eng ENG,MF,29-077,0.5,1,0,0,0,1,0,3,0.0,3,2,1,1,0,1,1,0,Matches,Ipswich-Town,Premier-League
282,George Edmundson,eng ENG,DF,27-254,0.0,0,0,0,0,0,0,0,,0,0,0,0,0,0,0,0,Matches,Ipswich-Town,Premier-League
283,Jamie Vardy,eng ENG,FW,38-121,29.5,18,13,6,7,5,4,13,30.8,9,8,4,4,5,23,23,0,Matches,Leicester-City,Premier-League
284,James Justin,eng ENG,DF,27-078,29.7,49,29,25,19,5,28,51,54.9,23,41,14,27,44,93,129,3,Matches,Leicester-City,Premier-League
285,Victor Bernth Kristiansen,dk DEN,DF,22-147,26.4,85,50,54,26,5,47,87,54.0,40,37,14,23,40,125,72,3,Matches,Leicester-City,Premier-League
286,Wout Faes,be BEL,DF,27-039,28.3,39,23,25,12,2,23,43,53.5,20,45,33,12,26,65,160,4,Matches,Leicester-City,Premier-League
287,Mads Hermansen,dk DEN,GK,24-305,26.5,1,1,1,0,0,1,1,100.0,0,1,0,1,0,1,13,4,Matches,Leicester-City,Premier-League
288,Wilfred Ndidi,ng NGA,MF,28-147,23.9,81,50,45,29,7,27,54,50.0,27,47,19,28,26,107,72,0,Matches,Leicester-City,Premier-League
289,Bilal El Khannouss,ma MAR,MF,21-002,22.3,46,26,15,26,5,15,28,53.6,13,21,4,17,6,52,9,3,Matches,Leicester-City,Premier-League
290,Boubakary Soumaré,fr FRA,MF,26-074,21.8,33,18,21,11,1,18,30,60.0,12,20,8,12,24,57,31,3,Matches,Leicester-City,Premier-League
291,Harry Winks,eng ENG,MF,29-099,17.1,24,11,12,10,2,13,30,43.3,17,19,7,12,9,33,20,0,Matches,Leicester-City,Premier-League
292,Stephy Mavididi,eng ENG,FW,26-346,17.9,34,19,16,10,8,14,42,33.3,28,26,2,24,11,45,15,0,Matches,Leicester-City,Premier-League
293,Conor Coady,eng ENG,DF,32-076,16.0,12,8,6,5,1,3,6,50.0,3,27,20,7,13,25,62,2,Matches,Leicester-City,Premier-League
294,Jordan Ayew,gh GHA,"FW,MF",33-243,15.8,24,13,7,12,5,6,19,31.6,13,16,0,16,12,36,17,0,Matches,Leicester-City,Premier-League
295,Jannik Vestergaard,dk DEN,DF,32-282,15.5,22,10,16,6,0,9,15,60.0,6,21,14,7,16,38,74,1,Matches,Leicester-City,Premier-League
296,Facundo Buonanotte,ar ARG,"FW,MF",20-140,16.4,53,32,17,22,14,21,67,31.3,46,32,6,26,11,64,14,0,Matches,Leicester-City,Premier-League
297,Caleb Okoli,it ITA,DF,23-303,12.5,25,14,8,15,2,11,18,61.1,7,24,14,10,15,40,79,3,Matches,Leicester-City,Premier-League
298,Luke Thomas,eng ENG,DF,23-336,9.7,25,20,19,4,2,18,32,56.3,14,13,5,8,18,43,39,1,Matches,Leicester-City,Premier-League
299,Bobby De Cordova-Reid,jm JAM,FW,32-099,8.3,9,4,3,6,0,4,14,28.6,10,6,1,5,0,9,10,0,Matches,Leicester-City,Premier-League
300,Oliver Skipp,eng ENG,MF,24-238,11.1,20,4,5,12,3,9,15,60.0,6,17,4,13,10,30,10,1,Matches,Leicester-City,Premier-League
301,Jakub Stolarczyk,pl POL,GK,24-144,7.0,2,1,2,0,0,1,2,50.0,1,0,0,0,0,2,5,0,Matches,Leicester-City,Premier-League
302,Kasey McAteer,ie IRL,"FW,MF",23-171,6.8,14,11,7,4,3,9,21,42.9,12,13,1,12,3,17,11,0,Matches,Leicester-City,Premier-League
303,Abdul Fatawu Issahaku,gh GHA,FW,21-065,6.4,21,15,13,2,6,11,19,57.9,8,7,0,7,4,25,12,0,Matches,Leicester-City,Premier-League
304,Patson Daka,zm ZAM,"FW,MF",26-215,7.3,17,9,4,9,4,7,17,41.2,10,7,1,6,1,18,10,0,Matches,Leicester-City,Premier-League
305,Ricardo Pereira,pt POR,DF,31-218,3.8,11,6,4,4,3,6,12,50.0,6,6,2,4,2,13,10,0,Matches,Leicester-City,Premier-League
306,Danny Ward,wls WAL,GK,31-324,1.5,0,0,0,0,0,0,0,,0,0,0,0,0,0,1,0,Matches,Leicester-City,Premier-League
307,Hamza Choudhury,bd BAN,"MF,DF",27-223,1.5,1,1,1,0,0,1,3,33.3,2,4,2,2,5,6,2,0,Matches,Leicester-City,Premier-League
308,Woyo Coulibaly,fr FRA,DF,25-357,1.2,6,4,4,2,0,2,2,100.0,0,3,1,2,5,11,1,0,Matches,Leicester-City,Premier-League
309,Jeremy Monga,,"FW,MF",,0.6,1,1,0,1,0,1,1,100.0,0,3,2,1,0,1,1,0,Matches,Leicester-City,Premier-League
310,Odsonne Édouard,fr FRA,FW,27-116,0.3,1,1,1,0,0,0,0,,0,0,0,0,0,1,1,0,Matches,Leicester-City,Premier-League
311,Jake Evans,,FW,,0.1,0,0,0,0,0,0,1,0.0,1,0,0,0,0,0,1,0,Matches,Leicester-City,Premier-League
312,Will Alves,eng ENG,FW,20-098,0.0,0,0,0,0,0,0,0,,0,0,0,0,0,0,0,0,Matches,Leicester-City,Premier-League
313,Michael Golding,eng ENG,MF,18-354,0.0,0,0,0,0,0,0,0,,0,0,0,0,0,0,0,0,Matches,Leicester-City,Premier-League
314,Virgil van Dijk,nl NED,DF,33-307,35.0,35,17,17,16,2,11,20,55.0,9,25,14,11,54,89,179,4,Matches,Liverpool,Premier-League
315,Mohamed Salah,eg EGY,FW,32-330,34.5,20,11,7,5,8,7,16,43.8,9,11,0,11,7,27,5,0,Matches,Liverpool,Premier-League
316,Ryan Gravenberch,nl NED,MF,22-360,32.5,65,34,25,29,11,30,51,58.8,21,34,10,24,57,122,56,1,Matches,Liverpool,Premier-League
317,Alexis Mac Allister,ar ARG,MF,26-138,28.6,95,58,28,51,16,55,104,52.9,49,61,6,55,22,117,29,1,Matches,Liverpool,Premier-League
318,Trent Alexander-Arnold,eng ENG,DF,26-216,25.5,70,49,43,18,9,48,103,46.6,55,26,9,17,30,100,54,4,Matches,Liverpool,Premier-League
319,Ibrahima Konaté,fr FRA,DF,25-351,25.8,36,25,24,11,1,24,34,70.6,10,27,15,12,12,48,124,2,Matches,Liverpool,Premier-League
320,Andrew Robertson,sct SCO,DF,31-061,25.6,38,22,24,10,4,30,47,63.8,17,9,4,5,20,58,51,2,Matches,Liverpool,Premier-League
321,Dominik Szoboszlai,hu HUN,MF,24-198,25.3,31,20,10,16,5,15,39,38.5,24,36,4,32,9,40,17,2,Matches,Liverpool,Premier-League
322,Luis Díaz,co COL,FW,28-118,24.7,33,21,10,17,6,13,34,38.2,21,18,0,18,7,40,7,1,Matches,Liverpool,Premier-League
323,Alisson,br BRA,GK,32-221,24.9,1,0,1,0,0,0,1,0.0,1,0,0,0,0,1,13,1,Matches,Liverpool,Premier-League
324,Cody Gakpo,nl NED,FW,26-004,19.1,26,14,5,12,9,11,23,47.8,12,19,2,17,11,37,16,1,Matches,Liverpool,Premier-League
325,Curtis Jones,eng ENG,"MF,DF",24-101,17.0,36,20,6,22,8,17,25,68.0,8,16,7,9,6,42,8,2,Matches,Liverpool,Premier-League
326,Diogo Jota,pt POR,FW,28-158,12.8,14,8,2,8,4,7,19,36.8,12,9,0,9,7,21,6,0,Matches,Liverpool,Premier-League
327,Caoimhín Kelleher,ie IRL,GK,26-169,10.0,0,0,0,0,0,0,0,,0,0,0,0,0,0,1,2,Matches,Liverpool,Premier-League
328,Darwin Núñez,uy URU,FW,25-321,11.7,19,16,11,3,5,6,16,37.5,10,6,0,6,3,22,12,0,Matches,Liverpool,Premier-League
329,Kostas Tsimikas,gr GRE,DF,28-364,8.3,29,18,13,11,5,13,20,65.0,7,5,2,3,10,39,20,0,Matches,Liverpool,Premier-League
330,Joe Gomez,eng ENG,DF,27-353,5.8,13,10,5,7,1,11,16,68.8,5,9,6,3,7,20,20,2,Matches,Liverpool,Premier-League
331,Conor Bradley,nir NIR,DF,21-306,6.3,11,8,5,4,2,8,17,47.1,9,4,0,4,3,14,21,0,Matches,Liverpool,Premier-League
332,Jarell Quansah,eng ENG,DF,22-102,4.5,11,8,8,3,0,6,8,75.0,2,8,7,1,6,17,18,1,Matches,Liverpool,Premier-League
333,Harvey Elliott,eng ENG,"MF,FW",22-037,3.0,4,3,2,1,1,1,5,20.0,4,5,1,4,1,5,2,0,Matches,Liverpool,Premier-League
334,Wataru Endo,jp JPN,MF,32-091,2.6,11,8,6,5,0,6,10,60.0,4,7,1,6,3,14,7,0,Matches,Liverpool,Premier-League
335,Federico Chiesa,it ITA,FW,27-198,0.5,0,0,0,0,0,0,2,0.0,2,1,0,1,0,0,0,1,Matches,Liverpool,Premier-League
336,Vitezslav Jaros,cz CZE,GK,23-292,0.1,0,0,0,0,0,0,0,,0,0,0,0,0,0,0,0,Matches,Liverpool,Premier-League
337,Jayden Danns,eng ENG,MF,19-115,0.1,0,0,0,0,0,0,1,0.0,1,0,0,0,0,0,0,0,Matches,Liverpool,Premier-League
338,Joško Gvardiol,hr CRO,DF,23-108,34.4,54,36,24,19,11,20,38,52.6,18,41,20,21,39,93,117,8,Matches,Manchester-City,Premier-League
339,Erling Haaland,no NOR,FW,24-294,28.6,10,5,3,3,4,2,6,33.3,4,11,1,10,5,15,23,0,Matches,Manchester-City,Premier-League
340,Bernardo Silva,pt POR,"MF,FW",30-274,27.7,53,35,15,29,9,24,52,46.2,28,33,7,26,20,73,29,3,Matches,Manchester-City,Premier-League
341,Ederson,br BRA,GK,31-267,23.8,0,0,0,0,0,0,2,0.0,2,0,0,0,1,1,9,2,Matches,Manchester-City,Premier-League
342,Mateo Kovačić,hr CRO,MF,31-005,23.7,68,38,22,38,8,31,65,47.7,34,20,0,20,22,90,20,1,Matches,Manchester-City,Premier-League
343,Rúben Dias,pt POR,DF,27-362,23.2,16,10,6,9,1,7,11,63.6,4,19,16,3,18,34,61,3,Matches,Manchester-City,Premier-League
344,İlkay Gündoğan,de GER,MF,34-199,22.8,24,13,4,15,5,10,23,43.5,13,14,0,14,13,37,22,0,Matches,Manchester-City,Premier-League
345,Rico Lewis,eng ENG,"DF,MF",20-171,21.0,30,19,13,12,5,13,21,61.9,8,28,7,21,13,43,45,1,Matches,Manchester-City,Premier-League
346,Manuel Akanji,ch SUI,DF,29-296,20.4,17,11,10,4,3,9,15,60.0,6,11,8,3,7,24,61,3,Matches,Manchester-City,Premier-League
347,Sávio,br BRA,"FW,MF",21-031,19.4,23,17,5,10,8,10,19,52.6,9,14,2,12,6,29,9,1,Matches,Manchester-City,Premier-League
348,Phil Foden,eng ENG,"MF,FW",24-348,19.6,12,5,5,4,3,7,18,38.9,11,13,1,12,9,21,7,1,Matches,Manchester-City,Premier-League
349,Kevin De Bruyne,be BEL,"MF,FW",33-317,18.1,17,9,7,5,5,5,23,21.7,18,8,0,8,7,24,10,1,Matches,Manchester-City,Premier-League
350,Matheus Nunes,pt POR,"DF,MF",26-257,16.6,32,21,13,13,6,15,34,44.1,19,14,3,11,13,45,35,1,Matches,Manchester-City,Premier-League
351,Jeremy Doku,be BEL,"FW,MF",22-349,16.0,30,21,9,12,9,8,15,53.3,7,10,1,9,4,34,2,0,Matches,Manchester-City,Premier-League
352,Stefan Ortega,de GER,GK,32-186,12.2,0,0,0,0,0,0,1,0.0,1,0,0,0,0,0,11,1,Matches,Manchester-City,Premier-League
353,Omar Marmoush,eg EGY,"FW,MF",26-093,11.2,11,6,2,7,2,7,15,46.7,8,15,1,14,5,16,3,0,Matches,Manchester-City,Premier-League
354,Kyle Walker,eng ENG,DF,34-348,10.8,17,10,7,7,3,14,26,53.8,12,13,4,9,3,20,13,1,Matches,Manchester-City,Premier-League
355,Nathan Aké,nl NED,DF,30-082,7.5,9,7,7,2,0,4,6,66.7,2,7,2,5,3,12,22,1,Matches,Manchester-City,Premier-League
356,Nicolás González,es ESP,MF,23-128,7.2,15,6,5,6,4,6,11,54.5,5,9,0,9,5,20,17,0,Matches,Manchester-City,Premier-League
357,Jack Grealish,eng ENG,"FW,MF",29-243,8.0,9,5,4,2,3,2,5,40.0,3,12,2,10,2,11,5,1,Matches,Manchester-City,Premier-League
358,John Stones,eng ENG,"DF,MF",30-348,6.1,6,2,3,2,1,5,5,100.0,0,5,3,2,4,10,19,1,Matches,Manchester-City,Premier-League
359,Nico O’Reilly,eng ENG,DF,20-051,5.9,9,4,3,3,3,4,8,50.0,4,5,1,4,4,13,12,0,Matches,Manchester-City,Premier-League
360,Abdukodir Khusanov,uz UZB,DF,21-071,5.6,5,4,4,1,0,2,3,66.7,1,5,4,1,3,8,29,1,Matches,Manchester-City,Premier-League
361,James Mcatee,eng ENG,"MF,FW",22-205,3.9,5,2,0,4,1,1,7,14.3,6,8,0,8,2,7,1,0,Matches,Manchester-City,Premier-League
362,Jahmai Simpson-Pusey,eng ENG,DF,19-188,1.1,1,0,1,0,0,0,1,0.0,1,1,1,0,0,1,2,0,Matches,Manchester-City,Premier-League
363,Rodri,es ESP,MF,28-323,0.7,2,1,1,1,0,0,0,,0,1,0,1,1,3,0,0,Matches,Manchester-City,Premier-League
364,Divin Mubama,eng ENG,FW,20-198,0.3,0,0,0,0,0,0,0,,0,0,0,0,0,0,0,0,Matches,Manchester-City,Premier-League
365,Oscar Bobb,no NOR,FW,21-303,0.2,0,0,0,0,0,0,0,,0,0,0,0,0,0,0,0,Matches,Manchester-City,Premier-League
366,Vitor Reis,br BRA,DF,19-119,0.0,0,0,0,0,0,0,0,,0,0,0,0,0,0,1,0,Matches,Manchester-City,Premier-League
367,André Onana,cm CMR,GK,29-039,33.0,1,1,1,0,0,1,3,33.3,2,0,0,0,0,1,11,4,Matches,Manchester-United,Premier-League
368,Bruno Fernandes,pt POR,MF,30-245,30.6,76,47,24,37,15,29,75,38.7,46,32,4,28,25,101,34,2,Matches,Manchester-United,Premier-League
369,Diogo Dalot,pt POR,DF,26-054,31.0,67,39,39,22,6,34,52,65.4,18,22,9,13,37,104,72,0,Matches,Manchester-United,Premier-League
370,Noussair Mazraoui,ma MAR,DF,27-178,29.3,102,60,53,36,13,51,85,60.0,34,33,8,25,34,136,88,1,Matches,Manchester-United,Premier-League
371,Matthijs de Ligt,nl NED,DF,25-272,23.6,30,22,17,12,1,23,32,71.9,9,29,21,8,33,63,96,0,Matches,Manchester-United,Premier-League
372,Alejandro Garnacho,ar ARG,"MF,FW",20-314,23.8,29,18,10,6,13,12,36,33.3,24,19,0,19,13,42,11,2,Matches,Manchester-United,Premier-League
373,Manuel Ugarte Ribeiro,uy URU,MF,24-030,19.0,74,46,32,34,8,28,66,42.4,38,31,4,27,26,100,16,1,Matches,Manchester-United,Premier-League
374,Lisandro Martínez,ar ARG,DF,27-113,19.5,40,24,25,12,3,21,36,58.3,15,22,8,14,32,72,57,1,Matches,Manchester-United,Premier-League
375,Rasmus Højlund,dk DEN,FW,22-096,19.4,3,1,0,2,1,0,4,0.0,4,5,0,5,1,4,6,0,Matches,Manchester-United,Premier-League
376,Kobbie Mainoo,eng ENG,MF,20-022,16.7,42,25,16,13,13,22,36,61.1,14,16,2,14,19,61,12,1,Matches,Manchester-United,Premier-League
377,Amad Diallo,ci CIV,"FW,MF",22-304,18.2,35,28,7,19,9,17,28,60.7,11,11,0,11,11,46,16,0,Matches,Manchester-United,Premier-League
378,Harry Maguire,eng ENG,DF,32-067,17.1,26,13,20,5,1,13,18,72.2,5,14,12,2,37,63,72,1,Matches,Manchester-United,Premier-League
379,Casemiro,br BRA,MF,33-077,14.8,77,46,45,23,9,41,66,62.1,25,33,10,23,12,89,48,3,Matches,Manchester-United,Premier-League
380,Joshua Zirkzee,nl NED,"FW,MF",23-354,15.6,14,8,3,8,3,5,10,50.0,5,15,4,11,6,20,8,1,Matches,Manchester-United,Premier-League
381,Marcus Rashford,eng ENG,"FW,MF",27-192,10.9,7,4,2,2,3,3,9,33.3,6,8,0,8,4,11,7,0,Matches,Manchester-United,Premier-League
382,Leny Yoro,fr FRA,DF,19-179,12.4,26,11,17,8,1,11,17,64.7,6,5,3,2,18,44,43,0,Matches,Manchester-United,Premier-League
383,Christian Eriksen,dk DEN,MF,33-086,11.4,19,9,4,12,3,11,26,42.3,15,14,4,10,7,26,7,0,Matches,Manchester-United,Premier-League
384,Patrick Dorgu,dk DEN,DF,20-197,7.0,23,17,12,9,2,12,17,70.6,5,9,0,9,4,27,19,2,Matches,Manchester-United,Premier-League
385,Mason Mount,eng ENG,"MF,FW",26-121,4.8,10,4,5,5,0,8,10,80.0,2,8,1,7,3,13,1,0,Matches,Manchester-United,Premier-League
386,Victor Lindelöf,se SWE,DF,30-298,5.4,5,1,5,0,0,2,3,66.7,1,4,2,2,7,12,33,1,Matches,Manchester-United,Premier-League
387,Jonny Evans,nir NIR,DF,37-128,3.2,7,5,4,3,0,2,4,50.0,2,2,1,1,4,11,13,0,Matches,Manchester-United,Premier-League
388,Harry Amass,eng ENG,DF,18-056,2.8,6,2,5,1,0,2,6,33.3,4,6,1,5,2,8,10,0,Matches,Manchester-United,Premier-League
389,Luke Shaw,eng ENG,DF,29-303,2.4,4,3,2,2,0,2,2,100.0,0,2,1,1,2,6,6,0,Matches,Manchester-United,Premier-League
390,Altay Bayındır,tr TUR,GK,27-027,2.0,0,0,0,0,0,0,1,0.0,1,0,0,0,0,0,5,1,Matches,Manchester-United,Premier-League
391,Tyler Fredricson,eng ENG,DF,20-077,1.8,5,3,3,2,0,1,2,50.0,1,2,0,2,1,6,11,0,Matches,Manchester-United,Premier-League
392,Tyrell Malacia,nl NED,DF,25-267,1.1,2,1,2,0,0,1,2,50.0,1,0,0,0,1,3,1,1,Matches,Manchester-United,Premier-League
393,Chidozie Obi-Martin,dk DEN,FW,17-163,1.7,2,1,0,0,2,2,2,100.0,0,0,0,0,0,2,1,0,Matches,Manchester-United,Premier-League
394,Ayden Heaven,eng ENG,DF,18-231,1.1,3,3,1,2,0,2,2,100.0,0,2,2,0,1,4,6,0,Matches,Manchester-United,Premier-League
395,Toby Collyer,eng ENG,MF,21-128,2.0,12,9,6,6,0,5,6,83.3,1,2,1,1,2,14,3,0,Matches,Manchester-United,Premier-League
396,Antony,br BRA,"DF,MF",25-076,1.6,6,3,4,2,0,2,5,40.0,3,2,0,2,2,8,0,0,Matches,Manchester-United,Premier-League
397,Scott McTominay,sct SCO,MF,28-154,0.2,0,0,0,0,0,0,1,0.0,1,0,0,0,0,0,1,0,Matches,Manchester-United,Premier-League
398,Bruno Guimarães,br BRA,MF,27-176,33.4,75,43,36,28,11,31,64,48.4,33,34,9,25,27,102,41,4,Matches,Newcastle-United,Premier-League
399,Dan Burn,eng ENG,DF,33-002,34.0,34,19,20,12,2,17,32,53.1,15,32,23,9,25,59,180,3,Matches,Newcastle-United,Premier-League
400,Alexander Isak,se SWE,FW,25-232,28.6,12,5,2,3,7,5,13,38.5,8,18,2,16,3,15,17,1,Matches,Newcastle-United,Premier-League
401,Fabian Schär,ch SUI,DF,33-142,29.6,34,21,15,17,2,14,34,41.2,20,37,24,13,41,75,116,3,Matches,Newcastle-United,Premier-League
402,Valentino Livramento,eng ENG,DF,22-180,28.6,52,34,33,15,4,30,56,53.6,26,34,10,24,21,73,99,1,Matches,Newcastle-United,Premier-League
403,Joelinton,br BRA,"MF,FW",28-270,26.6,57,35,23,23,11,25,44,56.8,19,37,7,30,23,80,47,2,Matches,Newcastle-United,Premier-League
404,Jacob Murphy,eng ENG,FW,30-076,23.8,22,15,7,9,6,16,31,51.6,15,31,0,31,11,33,26,1,Matches,Newcastle-United,Premier-League
405,Sandro Tonali,it ITA,MF,25-003,26.2,47,30,20,22,5,22,44,50.0,22,32,10,22,33,80,32,2,Matches,Newcastle-United,Premier-League
406,Nick Pope,eng ENG,GK,33-022,25.0,0,0,0,0,0,0,0,,0,1,0,1,1,1,30,5,Matches,Newcastle-United,Premier-League
407,Anthony Gordon,eng ENG,FW,24-076,24.8,31,17,9,18,4,12,34,35.3,22,24,2,22,6,37,9,2,Matches,Newcastle-United,Premier-League
408,Lewis Hall,eng ENG,DF,20-245,24.3,58,41,28,22,8,40,74,54.1,34,33,18,15,18,76,75,3,Matches,Newcastle-United,Premier-League
409,Harvey Barnes,eng ENG,FW,27-153,16.7,16,9,4,6,6,3,10,30.0,7,7,1,6,6,22,12,1,Matches,Newcastle-United,Premier-League
410,Kieran Trippier,eng ENG,DF,34-234,14.2,37,20,18,13,6,21,35,60.0,14,11,3,8,12,49,49,0,Matches,Newcastle-United,Premier-League
411,Joe Willock,eng ENG,"MF,FW",25-264,11.4,28,16,15,10,3,18,29,62.1,11,24,6,18,6,34,7,0,Matches,Newcastle-United,Premier-League
412,Martin Dúbravka,sk SVK,GK,36-116,10.0,0,0,0,0,0,0,0,,0,0,0,0,0,0,3,0,Matches,Newcastle-United,Premier-League
413,Sean Longstaff,eng ENG,MF,27-193,8.9,27,16,10,9,8,18,27,66.7,9,17,5,12,7,34,8,0,Matches,Newcastle-United,Premier-League
414,Lloyd Kelly,eng ENG,DF,26-217,3.4,5,4,4,1,0,1,1,100.0,0,6,4,2,1,6,17,0,Matches,Newcastle-United,Premier-League
415,Sven Botman,nl NED,DF,25-119,2.6,6,4,3,3,0,2,3,66.7,1,2,1,1,4,10,16,0,Matches,Newcastle-United,Premier-League
416,Emil Krafth,se SWE,DF,30-282,3.2,4,2,2,1,1,2,3,66.7,1,5,4,1,2,6,11,0,Matches,Newcastle-United,Premier-League
417,Callum Wilson,eng ENG,FW,33-073,3.2,2,2,0,1,1,0,2,0.0,2,2,0,2,1,3,1,0,Matches,Newcastle-United,Premier-League
418,Lewis Miley,eng ENG,MF,19-010,2.8,11,9,4,6,1,6,11,54.5,5,5,1,4,2,13,5,2,Matches,Newcastle-United,Premier-League
419,Miguel Almirón,py PAR,FW,31-090,1.7,3,2,2,0,1,2,3,66.7,1,2,0,2,0,3,0,0,Matches,Newcastle-United,Premier-League
420,William Osula,dk DEN,FW,21-280,1.2,1,0,0,0,1,0,2,0.0,2,0,0,0,4,5,2,0,Matches,Newcastle-United,Premier-League
421,Matt Targett,eng ENG,DF,29-235,0.2,0,0,0,0,0,0,1,0.0,1,0,0,0,1,1,1,0,Matches,Newcastle-United,Premier-League
422,Matz Sels,be BEL,GK,33-075,35.0,1,1,1,0,0,1,1,100.0,0,0,0,0,0,1,23,1,Matches,Nottingham-Forest,Premier-League
423,Nikola Milenković,rs SRB,DF,27-212,34.0,43,26,30,11,2,21,27,77.8,6,40,24,16,25,68,192,1,Matches,Nottingham-Forest,Premier-League
424,Murillo,br BRA,DF,22-312,33.4,53,36,38,12,3,27,46,58.7,19,67,44,23,32,85,236,3,Matches,Nottingham-Forest,Premier-League
425,Ola Aina,ng NGA,DF,28-216,30.4,54,41,39,14,1,35,63,55.6,28,32,12,20,31,85,103,3,Matches,Nottingham-Forest,Premier-League
426,Chris Wood,nz NZL,FW,33-156,29.9,5,4,1,2,2,2,9,22.2,7,11,7,4,5,10,26,1,Matches,Nottingham-Forest,Premier-League
427,Morgan Gibbs-White,eng ENG,MF,25-105,28.2,40,19,14,20,6,15,30,50.0,15,16,4,12,20,60,28,1,Matches,Nottingham-Forest,Premier-League
428,Elliot Anderson,eng ENG,MF,22-187,27.4,84,52,50,27,7,43,100,43.0,57,44,9,35,30,114,67,4,Matches,Nottingham-Forest,Premier-League
429,Anthony Elanga,se SWE,"FW,MF",23-015,24.8,18,13,8,8,2,5,17,29.4,12,11,1,10,6,24,25,0,Matches,Nottingham-Forest,Premier-League
430,Neco Williams,wls WAL,DF,24-029,25.8,75,45,56,14,5,45,73,61.6,28,40,9,31,25,100,126,2,Matches,Nottingham-Forest,Premier-League
431,Callum Hudson-Odoi,eng ENG,"FW,MF",24-186,23.9,20,14,7,8,5,11,17,64.7,6,11,0,11,13,33,11,1,Matches,Nottingham-Forest,Premier-League
432,Nicolás Domínguez,ar ARG,"MF,FW",26-318,19.3,76,40,35,30,11,30,66,45.5,36,34,11,23,27,103,48,1,Matches,Nottingham-Forest,Premier-League
433,Ryan Yates,eng ENG,MF,27-172,20.8,41,21,23,14,4,17,37,45.9,20,35,9,26,26,67,61,1,Matches,Nottingham-Forest,Premier-League
434,Álex Moreno,es ESP,"DF,MF",31-338,10.6,25,18,20,5,0,15,39,38.5,24,11,5,6,15,40,43,0,Matches,Nottingham-Forest,Premier-League
435,Jota Silva,pt POR,"FW,MF",25-284,9.4,25,13,12,11,2,5,25,20.0,20,9,1,8,12,37,17,0,Matches,Nottingham-Forest,Premier-League
436,Morato,br BRA,DF,23-316,9.0,21,13,18,2,1,13,20,65.0,7,12,4,8,10,31,71,2,Matches,Nottingham-Forest,Premier-League
437,James Ward-Prowse,eng ENG,MF,30-192,4.4,4,1,1,3,0,2,2,100.0,0,3,2,1,5,9,8,0,Matches,Nottingham-Forest,Premier-League
438,Danilo,br BRA,"MF,FW",24-013,3.0,6,3,5,1,0,2,4,50.0,2,2,1,1,3,9,3,0,Matches,Nottingham-Forest,Premier-League
439,Ibrahim Sangaré,ci CIV,MF,27-161,4.1,19,11,5,13,1,4,12,33.3,8,8,3,5,3,22,6,1,Matches,Nottingham-Forest,Premier-League
440,Taiwo Awoniyi,ng NGA,FW,27-273,4.5,6,3,0,3,3,4,5,80.0,1,1,0,1,0,6,7,0,Matches,Nottingham-Forest,Premier-League
441,Ramón Sosa,py PAR,"FW,MF",25-254,3.3,5,3,3,0,2,1,5,20.0,4,9,0,9,4,9,5,0,Matches,Nottingham-Forest,Premier-League
442,Willy Boly,ci CIV,DF,34-098,1.7,6,1,5,1,0,4,4,100.0,0,4,2,2,3,9,12,0,Matches,Nottingham-Forest,Premier-League
443,Harry Toffolo,eng ENG,DF,29-266,1.5,5,3,3,1,1,3,4,75.0,1,2,2,0,2,7,12,0,Matches,Nottingham-Forest,Premier-League
444,Eric da Silva Moreira,de GER,"MF,DF",19-009,0.3,2,2,2,0,0,2,6,33.3,4,0,0,0,1,3,0,0,Matches,Nottingham-Forest,Premier-League
445,Kyle Walker-Peters,eng ENG,DF,28-029,32.4,44,29,22,15,7,16,35,45.7,19,27,15,12,19,63,90,1,Matches,Southampton,Premier-League
446,Mateus Fernandes,pt POR,MF,20-306,30.3,86,46,43,28,15,33,66,50.0,33,41,7,34,26,112,34,7,Matches,Southampton,Premier-League
447,Taylor Harwood-Bellis,eng ENG,DF,23-102,30.5,27,19,13,11,3,19,35,54.3,16,62,40,22,30,57,137,6,Matches,Southampton,Premier-League
448,Jan Bednarek,pl POL,DF,29-030,28.1,36,19,23,13,0,16,31,51.6,15,47,36,11,56,92,190,5,Matches,Southampton,Premier-League
449,Aaron Ramsdale,eng ENG,GK,26-363,28.0,0,0,0,0,0,0,2,0.0,2,0,0,0,2,2,9,2,Matches,Southampton,Premier-League
450,Flynn Downes,eng ENG,MF,26-112,21.9,46,24,21,20,5,15,35,42.9,20,24,6,18,31,77,46,4,Matches,Southampton,Premier-League
451,Joe Aribo,ng NGA,"MF,DF",28-295,21.7,47,33,17,24,6,17,35,48.6,18,26,10,16,20,67,32,3,Matches,Southampton,Premier-League
452,Tyler Dibling,eng ENG,"FW,MF",19-061,20.1,34,20,13,18,3,16,26,61.5,10,19,5,14,8,42,16,1,Matches,Southampton,Premier-League
453,Ryan Manning,ie IRL,"DF,MF",28-332,16.2,28,17,16,10,2,14,26,53.8,12,20,11,9,17,45,47,0,Matches,Southampton,Premier-League
454,Lesley Ugochukwu,fr FRA,MF,21-047,17.4,49,24,15,30,4,18,35,51.4,17,27,10,17,14,63,21,1,Matches,Southampton,Premier-League
455,Jack Stephens,eng ENG,DF,31-105,14.4,32,19,23,9,0,15,27,55.6,12,20,13,7,11,43,49,2,Matches,Southampton,Premier-League
456,Yukinari Sugawara,jp JPN,"DF,MF",24-318,16.3,29,16,14,14,1,18,30,60.0,12,17,7,10,10,39,46,3,Matches,Southampton,Premier-League
457,Kamaldeen Sulemana,gh GHA,"FW,MF",23-086,14.1,17,15,6,4,7,8,13,61.5,5,12,3,9,6,23,9,0,Matches,Southampton,Premier-League
458,Adam Armstrong,eng ENG,"FW,MF",28-091,13.9,12,3,2,7,3,3,14,21.4,11,6,1,5,3,15,8,0,Matches,Southampton,Premier-League
459,Cameron Archer,eng ENG,FW,23-295,15.5,11,7,6,3,2,2,9,22.2,7,5,1,4,2,13,10,0,Matches,Southampton,Premier-League
460,James Bree,eng ENG,DF,27-213,10.9,18,13,8,9,1,10,25,40.0,15,9,3,6,8,26,28,0,Matches,Southampton,Premier-League
461,Paul Onuachu,ng NGA,FW,30-349,11.4,7,2,1,5,1,3,7,42.9,4,7,2,5,1,8,16,1,Matches,Southampton,Premier-League
462,Nathan Wood-Gordon,eng ENG,DF,22-346,6.9,10,7,6,3,1,5,8,62.5,3,8,5,3,4,14,26,2,Matches,Southampton,Premier-League
463,William Smallbone,ie IRL,MF,25-080,7.2,18,11,8,8,2,7,21,33.3,14,8,0,8,2,20,12,2,Matches,Southampton,Premier-League
464,Alex McCarthy,eng ENG,GK,35-160,5.0,0,0,0,0,0,0,0,,0,0,0,0,0,0,1,4,Matches,Southampton,Premier-League
465,Adam Lallana,eng ENG,MF,37-002,4.0,8,5,4,4,0,2,12,16.7,10,4,1,3,5,13,5,0,Matches,Southampton,Premier-League
466,Ben Brereton,cl CHI,FW,26-024,5.0,3,2,0,2,1,1,9,11.1,8,2,1,1,0,3,4,0,Matches,Southampton,Premier-League
467,Ryan Fraser,sct SCO,"FW,DF",31-077,3.4,6,2,2,4,0,4,6,66.7,2,1,1,0,1,7,9,0,Matches,Southampton,Premier-League
468,Welington,br BRA,"DF,MF",24-082,3.4,16,5,12,3,1,10,15,66.7,5,3,1,2,6,22,21,0,Matches,Southampton,Premier-League
469,Ross Stewart,sct SCO,FW,28-305,3.2,3,2,1,0,2,2,6,33.3,4,3,0,3,0,3,6,0,Matches,Southampton,Premier-League
470,Joe Lumley,eng ENG,GK,30-086,3.0,0,0,0,0,0,0,0,,0,0,0,0,0,0,3,3,Matches,Southampton,Premier-League
471,Armel Bella Kotchap,de GER,DF,23-152,3.7,7,5,5,2,0,3,6,50.0,3,2,2,0,5,12,21,1,Matches,Southampton,Premier-League
472,Charlie Taylor,eng ENG,DF,31-236,3.0,7,5,4,3,0,5,6,83.3,1,5,3,2,3,10,22,1,Matches,Southampton,Premier-League
473,Albert Grønbaek,dk DEN,"FW,MF",23-354,1.6,4,1,1,1,2,3,10,30.0,7,1,1,0,0,4,1,0,Matches,Southampton,Premier-League
474,Maxwel Cornet,ci CIV,FW,28-227,0.8,5,5,1,4,0,0,4,0.0,4,0,0,0,0,5,2,0,Matches,Southampton,Premier-League
475,Samuel Edozie,eng ENG,"DF,FW",22-104,0.7,3,1,0,1,2,2,2,100.0,0,0,0,0,0,3,0,0,Matches,Southampton,Premier-League
476,Jay Robinson,eng ENG,"MF,FW",18-058,0.4,2,1,2,0,0,0,0,,0,0,0,0,0,2,0,0,Matches,Southampton,Premier-League
477,Samuel Amo-Ameyaw,eng ENG,"FW,DF",18-298,0.3,1,0,0,1,0,1,1,100.0,0,0,0,0,0,1,0,0,Matches,Southampton,Premier-League
478,Ronnie Edwards,eng ENG,DF,22-045,0.1,0,0,0,0,0,0,0,,0,1,1,0,0,0,0,0,Matches,Southampton,Premier-League
479,Carlos Alcaraz,ar ARG,MF,22-163,0.1,0,0,0,0,0,0,0,,0,0,0,0,1,1,0,0,Matches,Southampton,Premier-League
480,Pedro Porro,es ESP,DF,25-241,27.4,63,46,31,22,10,42,73,57.5,31,44,17,27,34,97,80,1,Matches,Tottenham-Hotspur,Premier-League
481,Dejan Kulusevski,se SWE,"MF,FW",25-017,26.3,45,23,17,13,15,19,51,37.3,32,34,5,29,13,58,10,1,Matches,Tottenham-Hotspur,Premier-League
482,Dominic Solanke,eng ENG,FW,27-240,23.5,18,11,1,12,5,4,14,28.6,10,18,7,11,0,18,22,0,Matches,Tottenham-Hotspur,Premier-League
483,Brennan Johnson,wls WAL,FW,23-354,23.1,39,26,9,20,10,16,31,51.6,15,25,3,22,4,43,11,0,Matches,Tottenham-Hotspur,Premier-League
484,Guglielmo Vicario,it ITA,GK,28-217,23.0,0,0,0,0,0,0,0,,0,0,0,0,1,1,14,6,Matches,Tottenham-Hotspur,Premier-League
485,Son Heung-min,kr KOR,FW,32-308,22.3,17,9,3,8,6,5,23,21.7,18,10,0,10,5,22,16,1,Matches,Tottenham-Hotspur,Premier-League
486,Destiny Udogie,it ITA,DF,22-165,20.4,74,47,41,26,7,33,47,70.2,14,40,6,34,21,95,35,1,Matches,Tottenham-Hotspur,Premier-League
487,James Maddison,eng ENG,MF,28-170,20.1,31,19,8,16,7,9,29,31.0,20,15,4,11,12,43,19,1,Matches,Tottenham-Hotspur,Premier-League
488,Pape Matar Sarr,sn SEN,MF,22-240,19.2,44,32,17,22,5,11,23,47.8,12,23,9,14,26,70,20,1,Matches,Tottenham-Hotspur,Premier-League
489,Rodrigo Bentancur,uy URU,MF,27-321,16.9,38,20,17,17,4,19,39,48.7,20,24,8,16,36,74,33,1,Matches,Tottenham-Hotspur,Premier-League
490,Cristian Romero,ar ARG,DF,27-015,15.7,35,29,26,8,1,21,30,70.0,9,18,3,15,21,56,57,2,Matches,Tottenham-Hotspur,Premier-League
491,Djed Spence,eng ENG,DF,24-276,17.8,40,30,22,12,6,20,27,74.1,7,24,9,15,18,58,64,1,Matches,Tottenham-Hotspur,Premier-League
492,Archie Gray,eng ENG,"DF,MF",19-061,16.5,13,7,4,6,3,7,17,41.2,10,19,10,9,13,26,42,2,Matches,Tottenham-Hotspur,Premier-League
493,Yves Bissouma,ml MLI,MF,28-255,14.4,47,29,19,25,3,18,33,54.5,15,9,6,3,16,63,35,4,Matches,Tottenham-Hotspur,Premier-League
494,Radu Drăgușin,ro ROU,DF,23-098,13.9,10,6,8,2,0,6,12,50.0,6,22,16,6,15,25,49,4,Matches,Tottenham-Hotspur,Premier-League
495,Ben Davies,wls WAL,DF,32-018,12.5,14,10,6,8,0,7,14,50.0,7,24,16,8,12,26,65,1,Matches,Tottenham-Hotspur,Premier-League
496,Lucas Bergvall,se SWE,MF,19-099,13.5,39,19,14,20,5,17,32,53.1,15,18,8,10,24,63,22,3,Matches,Tottenham-Hotspur,Premier-League
497,Micky van de Ven,nl NED,DF,24-023,10.6,10,6,5,4,1,8,14,57.1,6,9,6,3,10,20,36,1,Matches,Tottenham-Hotspur,Premier-League
498,Mathys Tel,fr FRA,FW,20-015,7.2,8,3,0,4,4,2,9,22.2,7,6,0,6,0,8,2,2,Matches,Tottenham-Hotspur,Premier-League
499,Fraser Forster,eng ENG,GK,37-056,7.0,0,0,0,0,0,0,1,0.0,1,0,0,0,0,0,7,3,Matches,Tottenham-Hotspur,Premier-League
500,Wilson Odobert,fr FRA,FW,20-165,7.0,9,3,4,3,2,6,11,54.5,5,4,0,4,3,12,3,1,Matches,Tottenham-Hotspur,Premier-League
501,Kevin Danso,at AUT,DF,26-235,6.4,6,5,3,3,0,5,8,62.5,3,7,7,0,3,9,44,1,Matches,Tottenham-Hotspur,Premier-League
502,Timo Werner,de GER,"FW,MF",29-067,5.7,6,4,3,3,0,3,13,23.1,10,10,1,9,1,7,7,0,Matches,Tottenham-Hotspur,Premier-League
503,Richarlison,br BRA,FW,28-002,5.3,4,3,0,3,1,0,2,0.0,2,1,1,0,0,4,8,0,Matches,Tottenham-Hotspur,Premier-League
504,Antonín Kinský,cz CZE,GK,22-060,4.0,3,1,3,0,0,1,1,100.0,0,0,0,0,0,3,5,1,Matches,Tottenham-Hotspur,Premier-League
505,Mikey Moore,eng ENG,FW,17-274,2.3,0,0,0,0,0,0,1,0.0,1,1,0,1,1,1,1,0,Matches,Tottenham-Hotspur,Premier-League
506,Brandon Austin,eng ENG,GK,26-124,1.0,0,0,0,0,0,0,0,,0,0,0,0,0,0,1,0,Matches,Tottenham-Hotspur,Premier-League
507,Sergio Reguilón,es ESP,DF,28-147,1.4,4,3,1,3,0,2,3,66.7,1,4,0,4,2,6,3,0,Matches,Tottenham-Hotspur,Premier-League
508,Dane Scarlett,eng ENG,"FW,MF",21-049,0.4,1,0,0,1,0,0,0,,0,0,0,0,0,1,1,0,Matches,Tottenham-Hotspur,Premier-League
509,Alfie Dorrington,eng ENG,DF,20-022,0.2,0,0,0,0,0,0,0,,0,0,0,0,0,0,0,0,Matches,Tottenham-Hotspur,Premier-League
510,Will Lankshear,eng ENG,"FW,MF",20-022,0.1,0,0,0,0,0,0,0,,0,0,0,0,0,0,0,0,Matches,Tottenham-Hotspur,Premier-League
511,Max Kilman,eng ENG,DF,27-353,34.2,33,20,13,17,3,21,25,84.0,4,55,37,18,38,71,196,5,Matches,West-Ham-United,Premier-League
512,Aaron Wan-Bissaka,eng ENG,DF,27-166,32.0,64,45,29,30,5,20,27,74.1,7,32,9,23,60,124,116,0,Matches,West-Ham-United,Premier-League
513,Jarrod Bowen,eng ENG,"FW,MF",28-142,30.2,37,24,13,10,14,17,37,45.9,20,21,3,18,16,53,23,0,Matches,West-Ham-United,Premier-League
514,Mohammed Kudus,gh GHA,"FW,MF",24-282,26.9,35,21,7,17,11,10,27,37.0,17,24,1,23,4,39,8,2,Matches,West-Ham-United,Premier-League
515,Lucas Paquetá,br BRA,"MF,FW",27-257,26.0,66,37,25,30,11,27,54,50.0,27,28,4,24,17,83,37,6,Matches,West-Ham-United,Premier-League
516,Tomáš Souček,cz CZE,MF,30-073,25.9,42,19,19,20,3,22,39,56.4,17,35,17,18,18,60,74,1,Matches,West-Ham-United,Premier-League
517,Emerson Palmieri,it ITA,DF,30-281,23.4,60,31,37,18,5,27,48,56.3,21,32,8,24,21,81,59,0,Matches,West-Ham-United,Premier-League
518,Alphonse Areola,fr FRA,GK,32-073,23.1,2,2,2,0,0,2,3,66.7,1,0,0,0,0,2,15,2,Matches,West-Ham-United,Premier-League
519,Konstantinos Mavropanos,gr GRE,DF,27-151,21.6,32,22,22,9,1,14,25,56.0,11,23,17,6,38,70,117,1,Matches,West-Ham-United,Premier-League
520,Edson Álvarez,mx MEX,MF,27-199,18.1,44,23,24,12,8,15,33,45.5,18,21,8,13,16,60,39,1,Matches,West-Ham-United,Premier-League
521,Jean-Clair Todibo,fr FRA,DF,25-132,17.4,40,24,26,13,1,25,33,75.8,8,24,12,12,21,61,70,3,Matches,West-Ham-United,Premier-League
522,Carlos Soler,es ESP,"MF,FW",28-129,15.1,15,11,8,6,1,7,23,30.4,16,19,6,13,8,23,21,2,Matches,West-Ham-United,Premier-League
523,Guido Rodríguez,ar ARG,MF,31-029,11.3,30,16,19,11,0,14,30,46.7,16,21,9,12,12,42,28,1,Matches,West-Ham-United,Premier-League
524,Łukasz Fabiański,pl POL,GK,40-023,11.9,0,0,0,0,0,0,1,0.0,1,0,0,0,0,0,5,1,Matches,West-Ham-United,Premier-League
525,Michail Antonio,jm JAM,FW,35-044,9.3,2,2,0,1,1,2,3,66.7,1,6,0,6,0,2,2,0,Matches,West-Ham-United,Premier-League
526,Vladimír Coufal,cz CZE,DF,32-262,9.7,17,11,10,5,2,7,18,38.9,11,13,11,2,8,25,37,1,Matches,West-Ham-United,Premier-League
527,James Ward-Prowse,eng ENG,MF,30-191,9.0,15,10,7,5,3,4,13,30.8,9,6,3,3,5,20,13,0,Matches,West-Ham-United,Premier-League
528,Aaron Cresswell,eng ENG,DF,35-147,7.5,9,5,4,4,1,7,9,77.8,2,9,4,5,8,17,34,0,Matches,West-Ham-United,Premier-League
529,Crysencio Summerville,nl NED,"FW,MF",23-193,8.7,13,7,2,8,3,3,9,33.3,6,13,4,9,0,13,7,0,Matches,West-Ham-United,Premier-League
530,Oliver Scarles,eng ENG,DF,19-150,6.6,17,11,13,3,1,13,21,61.9,8,14,2,12,10,27,24,0,Matches,West-Ham-United,Premier-League
531,Niclas Füllkrug,de GER,FW,32-091,7.4,2,2,0,1,1,2,3,66.7,1,1,0,1,0,2,12,0,Matches,West-Ham-United,Premier-League
532,Danny Ings,eng ENG,"FW,MF",32-292,3.2,4,2,2,2,0,1,3,33.3,2,5,0,5,1,5,4,0,Matches,West-Ham-United,Premier-League
533,Andy Irving,sct SCO,MF,24-363,1.8,7,4,3,3,1,1,5,20.0,4,5,1,4,1,8,5,0,Matches,West-Ham-United,Premier-League
534,Evan Ferguson,ie IRL,FW,20-204,1.7,3,1,0,1,2,0,0,,0,2,1,1,1,4,1,0,Matches,West-Ham-United,Premier-League
535,Luis Guilherme,br BRA,"MF,FW",19-091,1.5,1,0,1,0,0,0,3,0.0,3,7,0,7,3,4,2,0,Matches,West-Ham-United,Premier-League
536,Lewis Orford,eng ENG,MF,19-082,0.5,0,0,0,0,0,0,0,,0,1,0,1,1,1,0,0,Matches,West-Ham-United,Premier-League
537,Kaelan Casey,eng ENG,DF,20-195,0.0,0,0,0,0,0,0,0,,0,0,0,0,0,0,1,0,Matches,West-Ham-United,Premier-League
538,Rayan Aït-Nouri,dz ALG,DF,23-339,32.8,85,55,51,26,8,41,68,60.3,27,41,6,35,25,110,70,1,Matches,Wolverhampton-Wanderers,Premier-League
539,João Gomes,br BRA,MF,24-088,31.5,105,62,53,48,4,42,103,40.8,61,42,4,38,25,130,32,0,Matches,Wolverhampton-Wanderers,Premier-League
540,Nélson Semedo,pt POR,DF,31-176,30.6,59,34,31,21,7,31,54,57.4,23,29,10,19,23,82,101,3,Matches,Wolverhampton-Wanderers,Premier-League
541,Jørgen Strand Larsen,no NOR,FW,25-094,27.7,9,6,2,3,4,4,27,14.8,23,18,4,14,6,15,28,0,Matches,Wolverhampton-Wanderers,Premier-League
542,André,br BRA,MF,23-299,26.0,88,53,40,40,8,35,61,57.4,26,42,8,34,35,123,30,1,Matches,Wolverhampton-Wanderers,Premier-League
543,José Sá,pt POR,GK,32-114,28.0,2,2,2,0,0,2,2,100.0,0,0,0,0,0,2,15,1,Matches,Wolverhampton-Wanderers,Premier-League
544,Matheus Cunha,br BRA,"MF,FW",25-349,27.6,35,21,16,15,4,11,36,30.6,25,21,1,20,17,52,23,0,Matches,Wolverhampton-Wanderers,Premier-League
545,Toti Gomes,pt POR,DF,26-115,27.0,57,41,40,14,3,33,42,78.6,9,28,17,11,24,81,142,5,Matches,Wolverhampton-Wanderers,Premier-League
546,Matt Doherty,ie IRL,DF,33-115,22.5,37,20,25,12,0,16,24,66.7,8,27,15,12,22,59,95,3,Matches,Wolverhampton-Wanderers,Premier-League
547,Jean-Ricner Bellegarde,fr FRA,"MF,FW",26-318,17.6,37,22,17,17,3,13,19,68.4,6,19,3,16,10,47,18,1,Matches,Wolverhampton-Wanderers,Premier-League
548,Santiago Bueno,uy URU,DF,26-183,18.7,40,21,21,18,1,17,22,77.3,5,35,20,15,15,55,70,0,Matches,Wolverhampton-Wanderers,Premier-League
549,Mario Lemina,ga GAB,"MF,DF",31-252,15.2,51,31,27,19,5,20,29,69.0,9,12,7,5,27,78,50,3,Matches,Wolverhampton-Wanderers,Premier-League
550,Emmanuel Agbadou,ci CIV,DF,27-328,13.7,27,18,18,9,0,11,17,64.7,6,19,13,6,11,38,82,0,Matches,Wolverhampton-Wanderers,Premier-League
551,Marshall Munetsi,zw ZIM,"MF,FW",28-323,10.8,22,10,6,10,6,12,21,57.1,9,13,1,12,6,28,16,0,Matches,Wolverhampton-Wanderers,Premier-League
552,Craig Dawson,eng ENG,DF,35-005,10.8,15,3,8,6,1,12,15,80.0,3,16,11,5,9,24,52,1,Matches,Wolverhampton-Wanderers,Premier-League
553,Gonçalo Guedes,pt POR,"MF,FW",28-163,9.3,14,4,2,5,7,3,15,20.0,12,9,0,9,5,19,3,0,Matches,Wolverhampton-Wanderers,Premier-League
554,Sam Johnstone,eng ENG,GK,32-047,7.0,0,0,0,0,0,0,1,0.0,1,0,0,0,0,0,7,0,Matches,Wolverhampton-Wanderers,Premier-League
555,Pablo Sarabia,es ESP,"MF,FW",33-000,8.3,15,8,4,8,3,9,15,60.0,6,10,0,10,4,19,7,1,Matches,Wolverhampton-Wanderers,Premier-League
556,Rodrigo Gomes,pt POR,"DF,FW",21-308,7.8,21,13,12,9,0,10,19,52.6,9,8,1,7,5,26,20,1,Matches,Wolverhampton-Wanderers,Premier-League
557,Hwang Hee-chan,kr KOR,"MF,FW",29-105,7.2,6,4,2,1,3,2,6,33.3,4,9,0,9,2,8,11,0,Matches,Wolverhampton-Wanderers,Premier-League
558,Yerson Mosquera,co COL,DF,24-009,4.9,11,7,9,2,0,9,14,64.3,5,13,10,3,10,21,14,0,Matches,Wolverhampton-Wanderers,Premier-League
559,Tommy Doyle,eng ENG,MF,23-206,5.4,11,6,6,3,2,6,15,40.0,9,11,5,6,5,16,11,1,Matches,Wolverhampton-Wanderers,Premier-League
560,Carlos Forbs,pt POR,"MF,FW",21-053,2.7,8,5,5,2,1,4,6,66.7,2,3,0,3,1,9,2,1,Matches,Wolverhampton-Wanderers,Premier-League
561,Daniel Bentley,eng ENG,GK,31-302,1.0,0,0,0,0,0,0,0,,0,0,0,0,0,0,0,0,Matches,Wolverhampton-Wanderers,Premier-League
562,Pedro Lima,br BRA,DF,18-314,0.8,1,0,0,0,1,1,3,33.3,2,0,0,0,2,3,5,0,Matches,Wolverhampton-Wanderers,Premier-League
563,Daniel Podence,pt POR,"MF,FW",29-202,0.5,0,0,0,0,0,0,1,0.0,1,0,0,0,0,0,0,0,Matches,Wolverhampton-Wanderers,Premier-League
564,Nasser Djiga,bf BFA,"DF,FW",22-177,0.2,0,0,0,0,0,0,0,,0,0,0,0,2,2,3,1,Matches,Wolverhampton-Wanderers,Premier-League
565,Chiquinho,pt POR,MF,25-095,0.1,0,0,0,0,0,0,0,,0,0,0,0,0,0,0,0,Matches,Wolverhampton-Wanderers,Premier-League
566,Mateus Mane,,MF,,0.0,0,0,0,0,0,0,0,,0,1,0,1,0,0,0,0,Matches,Wolverhampton-Wanderers,Premier-League
567,Alfie Pond,eng ENG,DF,21-071,0.0,0,0,0,0,0,0,0,,0,0,0,0,0,0,0,0,Matches,Wolverhampton-Wanderers,Premier-League
568,Boubacar Traoré,ml MLI,MF,23-264,0.0,2,0,0,2,0,1,1,100.0,0,0,0,0,0,2,0,0,Matches,Wolverhampton-Wanderers,Premier-League
569,Carlos Vicente,es ESP,"FW,MF",26-018,30.4,41,26,23,10,8,23,57,40.4,34,28,2,26,13,54,37,0,Matches,Alaves,La-Liga
570,Nahuel Tenaglia,ar ARG,DF,29-079,29.3,87,52,54,28,5,46,75,61.3,29,29,7,22,37,124,115,2,Matches,Alaves,La-Liga
571,Abdel Abqar,ma MAR,DF,26-062,27.4,36,23,24,11,1,20,34,58.8,14,28,18,10,39,75,146,1,Matches,Alaves,La-Liga
572,Antonio Sivera,es ESP,GK,28-273,27.2,2,1,2,0,0,2,2,100.0,0,1,0,1,0,2,17,0,Matches,Alaves,La-Liga
573,Antonio Blanco,es ESP,MF,24-292,26.6,60,37,20,36,4,31,71,43.7,40,27,6,21,39,99,43,1,Matches,Alaves,La-Liga
574,Kiké,es ESP,FW,35-167,25.6,17,12,1,11,5,5,11,45.5,6,9,2,7,1,18,22,0,Matches,Alaves,La-Liga
575,Manu Sánchez,es ESP,DF,24-260,25.5,69,45,34,25,10,35,57,61.4,22,46,9,37,28,97,61,1,Matches,Alaves,La-Liga
576,Jon Guridi,es ESP,"MF,FW",30-072,20.0,33,17,6,21,6,15,39,38.5,24,19,1,18,12,45,11,0,Matches,Alaves,La-Liga
577,Moussa Diarra,ml MLI,DF,24-182,19.7,38,23,19,16,3,17,28,60.7,11,14,5,9,21,59,40,1,Matches,Alaves,La-Liga
578,Ander Guevara,es ESP,MF,27-308,18.6,43,26,18,24,1,18,42,42.9,24,19,5,14,11,54,40,1,Matches,Alaves,La-Liga
579,Santiago Mouriño,uy URU,DF,23-087,17.5,34,24,26,8,0,18,32,56.3,14,25,11,14,25,59,102,0,Matches,Alaves,La-Liga
580,Carlos Martín,es ESP,"FW,MF",23-019,14.5,39,20,15,16,8,13,49,26.5,36,30,1,29,5,44,18,0,Matches,Alaves,La-Liga
581,Joan Jordán,es ESP,MF,30-309,15.1,31,17,11,16,4,16,29,55.2,13,12,0,12,8,39,20,0,Matches,Alaves,La-Liga
582,Tomás Conechny,ar ARG,"FW,MF",27-042,8.8,12,9,4,6,2,8,24,33.3,16,13,2,11,6,18,8,0,Matches,Alaves,La-Liga
583,Carles Aleñá,es ESP,"MF,FW",27-126,8.5,17,10,6,6,5,7,15,46.7,8,7,0,7,2,19,3,0,Matches,Alaves,La-Liga
584,Toni Martínez,es ESP,"FW,MF",27-315,10.1,11,6,4,4,3,3,4,75.0,1,7,2,5,0,11,11,0,Matches,Alaves,La-Liga
585,Stoichkov,es ESP,"MF,FW",31-187,7.8,14,9,6,7,1,6,11,54.5,5,2,0,2,1,15,7,0,Matches,Alaves,La-Liga
586,Aleksandar Sedlar,rs SRB,DF,33-149,5.7,17,9,7,10,0,8,10,80.0,2,2,1,1,9,26,18,1,Matches,Alaves,La-Liga
587,Jesús Owono,gq EQG,GK,24-071,5.4,1,1,1,0,0,1,1,100.0,0,0,0,0,0,1,2,0,Matches,Alaves,La-Liga
588,Pica,es ESP,DF,23-130,5.4,9,7,7,2,0,4,9,44.4,5,7,6,1,8,17,23,0,Matches,Alaves,La-Liga
589,Carlos Benavídez,uy URU,MF,27-042,4.4,12,9,6,4,2,4,8,50.0,4,4,2,2,8,20,11,1,Matches,Alaves,La-Liga
590,Abderrahman Rebbach,dz ALG,"FW,MF",26-273,4.3,3,2,3,0,0,0,6,0.0,6,4,0,4,0,3,6,0,Matches,Alaves,La-Liga
591,Facundo Garcés,ar ARG,DF,25-248,3.5,2,0,2,0,0,1,2,50.0,1,6,5,1,2,4,28,0,Matches,Alaves,La-Liga
592,Asier Villalibre,es ESP,FW,27-223,3.5,1,1,0,0,1,1,2,50.0,1,1,0,1,1,2,7,0,Matches,Alaves,La-Liga
593,Hugo Novoa,es ESP,"DF,MF",22-130,2.6,8,5,4,3,1,5,5,100.0,0,2,1,1,0,8,6,0,Matches,Alaves,La-Liga
594,Luka Romero,ar ARG,"FW,MF",20-174,2.2,4,4,1,1,2,2,3,66.7,1,2,0,2,1,5,0,0,Matches,Alaves,La-Liga
595,Pau Cabanes,es ESP,"MF,FW",20-083,2.0,7,2,4,2,1,5,11,45.5,6,1,0,1,0,7,1,0,Matches,Alaves,La-Liga
596,Adrian Rodriguez,es ESP,GK,24-150,1.4,0,0,0,0,0,0,1,0.0,1,0,0,0,0,0,3,1,Matches,Alaves,La-Liga
597,Luis Rioja,es ESP,FW,31-207,0.3,2,1,0,1,1,1,2,50.0,1,2,0,2,0,2,0,0,Matches,Alaves,La-Liga
598,Iñaki Williams,gh GHA,FW,30-331,29.0,17,10,4,8,5,12,23,52.2,11,34,5,29,12,29,32,0,Matches,Athletic-Club,La-Liga
599,Daniel Vivian,es ESP,DF,25-301,25.7,37,23,21,13,3,19,30,63.3,11,24,9,15,38,75,120,2,Matches,Athletic-Club,La-Liga
600,Álex Berenguer,es ESP,"FW,MF",29-312,23.0,29,13,4,16,9,13,26,50.0,13,18,2,16,9,38,17,0,Matches,Athletic-Club,La-Liga
601,Mikel Jauregizar,es ESP,MF,21-181,21.8,76,43,23,40,13,39,74,52.7,35,22,3,19,26,102,28,2,Matches,Athletic-Club,La-Liga
602,Nico Williams,es ESP,FW,22-304,21.3,27,17,10,11,6,10,31,32.3,21,19,1,18,6,33,9,0,Matches,Athletic-Club,La-Liga
603,Beñat Prados,es ESP,MF,24-093,17.9,51,33,19,24,8,23,51,45.1,28,21,2,19,28,79,25,0,Matches,Athletic-Club,La-Liga
604,Gorka Guruzeta,es ESP,FW,28-242,18.1,15,8,1,12,2,7,28,25.0,21,27,4,23,8,23,19,0,Matches,Athletic-Club,La-Liga
605,Aitor Paredes,es ESP,DF,25-013,18.1,11,9,8,3,0,5,12,41.7,7,22,12,10,22,33,107,4,Matches,Athletic-Club,La-Liga
606,Yuri Berchiche,es ESP,DF,35-091,18.7,32,20,18,11,3,19,30,63.3,11,20,3,17,20,52,47,2,Matches,Athletic-Club,La-Liga
607,Yeray Álvarez,es ESP,DF,30-108,17.8,24,13,13,9,2,14,20,70.0,6,10,6,4,33,57,104,1,Matches,Athletic-Club,La-Liga
608,Oihan Sancet,es ESP,MF,25-017,16.3,12,7,6,5,1,4,12,33.3,8,9,0,9,5,17,5,0,Matches,Athletic-Club,La-Liga
609,Unai Simón,es ESP,GK,27-335,17.0,0,0,0,0,0,0,0,,0,1,0,1,1,1,10,4,Matches,Athletic-Club,La-Liga
610,Andoni Gorosabel,es ESP,DF,28-281,15.6,43,25,27,9,7,27,41,65.9,14,17,2,15,17,60,54,0,Matches,Athletic-Club,La-Liga
611,Óscar de Marcos,es ESP,DF,36-028,15.3,28,13,13,11,4,19,34,55.9,15,15,1,14,14,42,30,0,Matches,Athletic-Club,La-Liga
612,Iñigo Ruiz de Galarreta,es ESP,MF,31-279,13.9,34,21,11,17,6,19,29,65.5,10,8,3,5,12,46,9,2,Matches,Athletic-Club,La-Liga
613,Julen Agirrezabala,es ESP,GK,24-137,13.4,0,0,0,0,0,0,1,0.0,1,0,0,0,0,0,4,0,Matches,Athletic-Club,La-Liga
614,Unai Gómez,es ESP,"MF,FW",21-352,12.3,10,6,3,6,1,4,6,66.7,2,12,1,11,2,12,12,0,Matches,Athletic-Club,La-Liga
615,Adama Boiro,es ESP,DF,22-324,11.2,20,11,11,7,2,10,14,71.4,4,8,3,5,12,32,26,1,Matches,Athletic-Club,La-Liga
616,Mikel Vesga,es ESP,MF,31-356,9.8,20,14,7,12,1,10,26,38.5,16,10,1,9,13,33,20,0,Matches,Athletic-Club,La-Liga
617,Iñigo Lekue,es ESP,DF,32-008,7.6,15,12,12,3,0,9,17,52.9,8,7,2,5,7,22,26,2,Matches,Athletic-Club,La-Liga
618,Álvaro djaló,es ESP,FW,25-269,6.7,7,5,3,2,2,1,3,33.3,2,3,0,3,1,8,4,0,Matches,Athletic-Club,La-Liga
619,Unai Núñez,es ESP,DF,28-102,6.5,9,4,6,3,0,3,6,50.0,3,4,4,0,17,26,42,1,Matches,Athletic-Club,La-Liga
620,Maroan Sannadi,es ESP,FW,24-100,5.7,1,0,1,0,0,1,4,25.0,3,1,0,1,0,1,1,0,Matches,Athletic-Club,La-Liga
621,Alex Padilla,es ESP,GK,21-253,3.6,0,0,0,0,0,0,0,,0,0,0,0,0,0,2,1,Matches,Athletic-Club,La-Liga
622,Ander Herrera,es ESP,MF,35-271,3.0,8,4,1,7,0,3,6,50.0,3,1,0,1,2,10,10,0,Matches,Athletic-Club,La-Liga
623,Peio Canales,es ESP,"MF,FW",20-115,2.1,2,2,0,0,2,1,1,100.0,0,1,0,1,2,4,1,0,Matches,Athletic-Club,La-Liga
624,Nicolás Serrano,es ESP,FW,22-068,1.2,1,1,0,1,0,1,3,33.3,2,4,0,4,1,2,1,0,Matches,Athletic-Club,La-Liga
625,Javi Martón,es ESP,"FW,MF",26-006,0.6,0,0,0,0,0,0,0,,0,0,0,0,0,0,0,0,Matches,Athletic-Club,La-Liga
626,Adu Ares,es ESP,FW,23-212,0.2,0,0,0,0,0,0,1,0.0,1,0,0,0,0,0,0,0,Matches,Athletic-Club,La-Liga
627,Endika Buján,es ESP,FW,22-116,0.1,0,0,0,0,0,0,1,0.0,1,0,0,0,0,0,0,0,Matches,Athletic-Club,La-Liga
628,Jan Oblak,si SVN,GK,32-124,34.0,0,0,0,0,0,0,0,,0,0,0,0,0,0,16,2,Matches,Atletico-Madrid,La-Liga
629,Antoine Griezmann,fr FRA,"FW,MF",34-051,26.2,30,17,13,13,4,7,29,24.1,22,16,1,15,6,36,23,1,Matches,Atletico-Madrid,La-Liga
630,Julián Álvarez,ar ARG,FW,25-100,25.2,24,16,5,10,9,8,28,28.6,20,14,0,14,0,24,10,1,Matches,Atletico-Madrid,La-Liga
631,Pablo Barrios,es ESP,MF,21-330,25.2,44,25,21,20,3,22,46,47.8,24,17,5,12,34,78,33,7,Matches,Atletico-Madrid,La-Liga
632,Marcos Llorente,es ESP,"DF,MF",30-101,24.9,65,48,36,25,4,34,50,68.0,16,28,7,21,24,89,48,1,Matches,Atletico-Madrid,La-Liga
633,Giuliano Simeone,ar ARG,MF,22-144,19.7,24,12,6,8,10,14,29,48.3,15,19,2,17,12,36,20,1,Matches,Atletico-Madrid,La-Liga
634,Robin Le Normand,es ESP,DF,28-181,21.9,26,17,22,4,0,11,18,61.1,7,18,8,10,9,35,109,1,Matches,Atletico-Madrid,La-Liga
635,Clément Lenglet,fr FRA,DF,29-328,19.9,22,14,16,6,0,8,11,72.7,3,24,18,6,20,42,96,1,Matches,Atletico-Madrid,La-Liga
636,Rodrigo De Paul,ar ARG,MF,30-352,20.8,28,23,11,13,4,13,31,41.9,18,22,2,20,5,33,14,3,Matches,Atletico-Madrid,La-Liga
637,José María Giménez,uy URU,DF,30-111,21.2,25,15,17,8,0,16,27,59.3,11,28,18,10,26,51,110,2,Matches,Atletico-Madrid,La-Liga
638,Javi Galán,es ESP,DF,30-173,18.3,50,30,30,15,5,24,48,50.0,24,13,3,10,11,61,44,0,Matches,Atletico-Madrid,La-Liga
639,Conor Gallagher,eng ENG,MF,25-094,17.4,42,30,16,16,10,20,46,43.5,26,23,5,18,19,61,23,0,Matches,Atletico-Madrid,La-Liga
640,Samuel Lino,br BRA,"MF,DF",25-139,15.1,26,14,20,4,2,18,45,40.0,27,21,4,17,7,33,12,0,Matches,Atletico-Madrid,La-Liga
641,Koke,es ESP,MF,33-123,18.9,43,22,17,20,6,20,40,50.0,20,22,2,20,18,61,25,2,Matches,Atletico-Madrid,La-Liga
642,Nahuel Molina,ar ARG,DF,27-035,16.4,40,17,19,20,1,29,53,54.7,24,16,3,13,12,52,49,0,Matches,Atletico-Madrid,La-Liga
643,Alexander Sørloth,no NOR,FW,29-157,15.6,8,4,2,4,2,3,5,60.0,2,6,1,5,1,9,24,0,Matches,Atletico-Madrid,La-Liga
644,Reinildo Mandava,mz MOZ,DF,31-110,10.5,18,11,10,7,1,10,18,55.6,8,11,5,6,16,34,35,0,Matches,Atletico-Madrid,La-Liga
645,César Azpilicueta,es ESP,DF,35-256,8.2,23,12,11,8,4,16,22,72.7,6,6,2,4,3,26,27,0,Matches,Atletico-Madrid,La-Liga
646,Axel Witsel,be BEL,DF,36-119,8.5,13,12,4,8,1,10,12,83.3,2,15,8,7,9,22,32,1,Matches,Atletico-Madrid,La-Liga
647,Rodrigo Riquelme,es ESP,"MF,DF",25-039,5.7,11,5,4,6,1,6,11,54.5,5,3,0,3,2,13,3,0,Matches,Atletico-Madrid,La-Liga
648,Ángel Correa,ar ARG,"FW,MF",30-063,8.3,8,2,4,1,3,4,14,28.6,10,9,0,9,4,12,7,0,Matches,Atletico-Madrid,La-Liga
649,Juan Musso,ar ARG,GK,31-005,1.0,0,0,0,0,0,0,0,,0,0,0,0,0,0,0,0,Matches,Atletico-Madrid,La-Liga
650,Thomas Lemar,fr FRA,MF,29-180,0.9,2,1,1,1,0,2,4,50.0,2,0,0,0,0,2,1,0,Matches,Atletico-Madrid,La-Liga
651,Adrian Niño,es ESP,FW,20-326,0.1,0,0,0,0,0,0,0,,0,0,0,0,0,0,0,0,Matches,Atletico-Madrid,La-Liga
652,Pedri,es ESP,MF,22-167,28.6,55,30,13,33,9,22,62,35.5,40,40,3,37,26,81,21,1,Matches,Barcelona,La-Liga
653,Jules Koundé,fr FRA,DF,26-180,28.9,63,43,29,23,11,44,66,66.7,22,35,5,30,20,83,68,2,Matches,Barcelona,La-Liga
654,Robert Lewandowski,pl POL,FW,36-263,27.1,9,4,1,5,3,4,10,40.0,6,14,2,12,3,12,24,0,Matches,Barcelona,La-Liga
655,Raphinha,br BRA,"FW,MF",28-148,27.8,35,21,6,18,11,19,35,54.3,16,26,2,24,8,43,24,0,Matches,Barcelona,La-Liga
656,Lamine Yamal,es ESP,FW,17-302,27.7,39,26,5,17,17,15,34,44.1,19,12,0,12,13,52,3,0,Matches,Barcelona,La-Liga
657,Pau Cubarsí,es ESP,DF,18-109,26.0,28,18,18,7,3,16,25,64.0,9,10,8,2,13,41,75,1,Matches,Barcelona,La-Liga
658,Iñigo Martínez,es ESP,DF,33-359,25.7,23,13,18,5,0,15,21,71.4,6,18,7,11,18,41,104,1,Matches,Barcelona,La-Liga
659,Alejandro Balde,es ESP,DF,21-205,23.1,16,10,9,4,3,9,14,64.3,5,23,4,19,5,21,25,0,Matches,Barcelona,La-Liga
660,Marc Casado,es ESP,MF,21-239,17.9,44,25,7,30,7,20,41,48.8,21,20,5,15,22,66,22,1,Matches,Barcelona,La-Liga
661,Iñaki Peña,es ESP,GK,26-070,14.5,0,0,0,0,0,0,2,0.0,2,0,0,0,0,0,20,1,Matches,Barcelona,La-Liga
662,Wojciech Szczęsny,pl POL,GK,35-023,13.0,1,1,1,0,0,0,0,,0,0,0,0,0,1,14,1,Matches,Barcelona,La-Liga
663,Gavi,es ESP,"MF,FW",20-279,9.9,19,15,4,11,4,10,18,55.6,8,13,1,12,10,29,5,0,Matches,Barcelona,La-Liga
664,Dani Olmo,es ESP,"MF,FW",27-004,11.4,14,9,8,4,2,3,11,27.3,8,6,3,3,3,17,10,1,Matches,Barcelona,La-Liga
665,Ferrán Torres,es ESP,"FW,MF",25-071,11.3,7,4,2,2,3,3,8,37.5,5,7,1,6,4,11,5,0,Matches,Barcelona,La-Liga
666,Eric García,es ESP,"MF,DF",24-122,13.7,28,16,7,19,2,14,20,70.0,6,20,7,13,10,38,36,0,Matches,Barcelona,La-Liga
667,Fermin López,es ESP,"MF,FW",22-000,11.5,18,14,3,8,7,7,25,28.0,18,8,0,8,4,22,3,0,Matches,Barcelona,La-Liga
668,Ronald Araújo,uy URU,DF,26-065,7.1,12,9,6,5,1,4,4,100.0,0,6,4,2,8,20,19,0,Matches,Barcelona,La-Liga
669,Gerard Martín,es ESP,DF,23-130,9.8,20,9,8,7,5,10,15,66.7,5,15,2,13,8,28,25,0,Matches,Barcelona,La-Liga
670,Frenkie de Jong,nl NED,MF,27-364,10.1,15,9,4,5,6,7,14,50.0,7,6,0,6,5,20,6,1,Matches,Barcelona,La-Liga
671,Marc-André ter Stegen,de GER,GK,33-011,6.5,0,0,0,0,0,0,1,0.0,1,0,0,0,0,0,2,2,Matches,Barcelona,La-Liga
672,Héctor Fort,es ESP,DF,18-282,6.0,13,8,6,4,3,10,15,66.7,5,11,0,11,6,19,15,0,Matches,Barcelona,La-Liga
673,Pablo Torre,es ESP,"MF,FW",22-038,3.4,5,4,1,3,1,2,4,50.0,2,0,0,0,3,8,5,1,Matches,Barcelona,La-Liga
674,Marc Bernal,es ESP,MF,17-350,2.7,8,6,2,5,1,7,8,87.5,1,5,1,4,1,9,4,0,Matches,Barcelona,La-Liga
675,Ansu Fati,es ESP,FW,22-192,2.6,4,1,0,2,2,1,2,50.0,1,1,0,1,1,5,0,1,Matches,Barcelona,La-Liga
676,Pau Victor Delgado,es ESP,FW,23-166,3.3,2,1,0,1,1,0,3,0.0,3,6,1,5,2,4,5,0,Matches,Barcelona,La-Liga
677,Sergi Dominguez,es ESP,DF,20-040,1.9,1,1,1,0,0,0,0,,0,0,0,0,3,4,7,0,Matches,Barcelona,La-Liga
678,Andreas Christensen,dk DEN,DF,29-031,1.3,1,1,0,1,0,1,1,100.0,0,0,0,0,0,1,3,0,Matches,Barcelona,La-Liga
679,Daniel Rodriguez,es ESP,FW,19-275,0.4,0,0,0,0,0,0,0,,0,1,0,1,0,0,0,0,Matches,Barcelona,La-Liga
680,Diego Llorente,es ESP,DF,31-269,28.0,36,20,23,12,1,25,38,65.8,13,29,20,9,43,79,154,1,Matches,Real-Betis,La-Liga
681,Johnny Cardoso,us USA,MF,23-234,21.7,51,28,12,31,8,20,50,40.0,30,26,12,14,46,97,58,1,Matches,Real-Betis,La-Liga
682,Marc Bartra,es ESP,DF,34-117,20.5,26,16,17,9,0,12,20,60.0,8,33,21,12,30,56,141,0,Matches,Real-Betis,La-Liga
683,Romain Perraud,fr FRA,DF,27-232,20.1,35,21,15,15,5,20,45,44.4,25,15,3,12,21,56,66,1,Matches,Real-Betis,La-Liga
684,Abde Ezzalzouli,ma MAR,"FW,MF",23-146,19.6,35,25,17,15,3,14,25,56.0,11,20,3,17,6,41,15,0,Matches,Real-Betis,La-Liga
685,Natan,br BRA,DF,24-095,20.2,32,21,21,9,2,23,27,85.2,4,22,13,9,23,55,104,1,Matches,Real-Betis,La-Liga
686,Sergi Altimira,es ESP,MF,23-260,19.5,54,32,15,33,6,32,55,58.2,23,27,1,26,20,74,40,2,Matches,Real-Betis,La-Liga
687,Youssouf Sabaly,sn SEN,DF,32-068,17.3,39,25,20,15,4,24,32,75.0,8,20,3,17,13,52,39,0,Matches,Real-Betis,La-Liga
688,Pablo Fornals,es ESP,"MF,FW",29-079,17.1,16,10,9,6,1,6,24,25.0,18,19,1,18,20,36,13,1,Matches,Real-Betis,La-Liga
689,Adrián,es ESP,GK,38-129,15.0,0,0,0,0,0,0,2,0.0,2,0,0,0,0,0,9,2,Matches,Real-Betis,La-Liga
690,Rui Silva,pt POR,GK,31-094,15.0,0,0,0,0,0,0,1,0.0,1,1,0,1,0,0,7,0,Matches,Real-Betis,La-Liga
691,Isco,es ESP,MF,33-021,14.6,16,9,1,11,4,7,26,26.9,19,9,0,9,8,24,6,0,Matches,Real-Betis,La-Liga
692,Vitor Roque,br BRA,FW,20-073,13.7,11,6,1,6,4,1,5,20.0,4,5,0,5,7,18,4,0,Matches,Real-Betis,La-Liga
693,Giovani Lo Celso,ar ARG,"MF,FW",29-033,14.5,33,22,8,16,9,16,24,66.7,8,14,2,12,5,38,3,1,Matches,Real-Betis,La-Liga
694,Ricardo Rodríguez,ch SUI,DF,32-260,12.3,25,13,13,5,7,16,25,64.0,9,8,1,7,6,31,45,0,Matches,Real-Betis,La-Liga
695,Antony,br BRA,FW,25-077,12.2,18,7,3,8,7,5,17,29.4,12,10,1,9,9,27,9,1,Matches,Real-Betis,La-Liga
696,Jesus Rodríguez,es ESP,FW,19-172,10.8,16,14,6,6,4,5,12,41.7,7,13,0,13,6,22,2,0,Matches,Real-Betis,La-Liga
697,Marc Roca,es ESP,MF,28-167,10.1,20,14,10,9,1,9,17,52.9,8,17,5,12,14,34,14,2,Matches,Real-Betis,La-Liga
698,Cucho,co COL,FW,26-022,9.7,12,8,1,5,6,5,9,55.6,4,13,1,12,6,18,3,0,Matches,Real-Betis,La-Liga
699,Aitor Ruibal,es ESP,"DF,FW",29-051,11.0,21,15,15,3,3,16,27,59.3,11,15,4,11,11,32,27,0,Matches,Real-Betis,La-Liga
700,Ezequiel Ávila,ar ARG,FW,31-095,7.5,8,3,2,2,4,4,10,40.0,6,4,0,4,2,10,8,0,Matches,Real-Betis,La-Liga
701,Héctor Bellerín,es ESP,DF,30-054,6.4,13,7,7,4,2,10,17,58.8,7,5,3,2,6,19,21,0,Matches,Real-Betis,La-Liga
702,Cédric Bakambu,cd COD,FW,34-031,6.9,6,4,0,5,1,3,7,42.9,4,11,2,9,0,6,5,0,Matches,Real-Betis,La-Liga
703,William Carvalho,pt POR,MF,33-035,4.3,5,3,1,4,0,3,5,60.0,2,5,1,4,3,8,4,0,Matches,Real-Betis,La-Liga
704,Fran Vieites,es ESP,GK,26-005,4.0,0,0,0,0,0,0,0,,0,0,0,0,0,0,1,0,Matches,Real-Betis,La-Liga
705,Ángel Ortíz,es ESP,DF,20-291,3.8,10,7,7,3,0,6,15,40.0,9,6,0,6,5,15,7,0,Matches,Real-Betis,La-Liga
706,Iker Losada,es ESP,"MF,FW",23-284,3.7,10,7,2,4,4,5,10,50.0,5,2,0,2,3,13,2,0,Matches,Real-Betis,La-Liga
707,Assane Diao,sn SEN,FW,19-247,3.1,5,3,1,3,1,4,9,44.4,5,3,0,3,0,5,3,0,Matches,Real-Betis,La-Liga
708,Juanmi,es ESP,"FW,MF",31-357,2.7,7,4,3,3,1,4,6,66.7,2,4,0,4,1,8,4,0,Matches,Real-Betis,La-Liga
709,Nabil Fekir,fr FRA,MF,31-298,2.0,3,2,1,1,1,1,2,50.0,1,2,0,2,0,3,0,0,Matches,Real-Betis,La-Liga
710,Carlos Guirao,es ESP,MF,22-015,1.2,5,3,1,4,0,4,6,66.7,2,1,1,0,3,8,2,0,Matches,Real-Betis,La-Liga
711,Mateo Flores,es ESP,MF,21-035,1.7,3,1,3,0,0,1,1,100.0,0,1,0,1,2,5,3,0,Matches,Real-Betis,La-Liga
712,Rodri,es ESP,FW,24-361,1.3,2,1,1,1,0,1,2,50.0,1,2,1,1,1,3,1,1,Matches,Real-Betis,La-Liga
713,Sergio Arribas,es ESP,DF,22-091,1.0,7,4,4,3,0,6,7,85.7,1,2,2,0,3,10,4,0,Matches,Real-Betis,La-Liga
714,Pablo Garcia,es ESP,FW,18-270,0.3,0,0,0,0,0,0,0,,0,1,0,1,0,0,0,0,Matches,Real-Betis,La-Liga
715,Vicente Guaita,es ESP,GK,38-122,31.0,0,0,0,0,0,0,0,,0,0,0,0,0,0,20,2,Matches,Celta-Vigo,La-Liga
716,Óscar Mingueza,es ESP,"MF,DF",25-364,27.4,35,21,18,12,5,24,63,38.1,39,30,5,25,21,56,42,6,Matches,Celta-Vigo,La-Liga
717,Marcos Alonso,es ESP,DF,34-135,27.5,33,20,18,12,3,24,43,55.8,19,22,7,15,34,67,117,4,Matches,Celta-Vigo,La-Liga
718,Carl Starfelt,se SWE,DF,29-345,25.2,40,20,25,14,1,18,27,66.7,9,29,21,8,31,71,129,3,Matches,Celta-Vigo,La-Liga
719,Fran Beltrán,es ESP,MF,26-098,23.9,42,30,19,18,5,19,49,38.8,30,23,5,18,24,66,32,4,Matches,Celta-Vigo,La-Liga
720,Javi Rodríguez,es ESP,DF,21-320,24.9,50,35,33,17,0,31,45,68.9,14,28,9,19,31,81,90,1,Matches,Celta-Vigo,La-Liga
721,Borja Iglesias,es ESP,FW,32-115,20.0,10,9,2,5,3,4,14,28.6,10,8,2,6,6,16,7,0,Matches,Celta-Vigo,La-Liga
722,Ilaix Moriba,gn GUI,MF,22-113,20.7,59,37,20,26,13,27,47,57.4,20,23,4,19,13,72,29,1,Matches,Celta-Vigo,La-Liga
723,Iago Aspas,es ESP,"FW,MF",37-284,18.2,13,8,4,5,4,8,19,42.1,11,16,1,15,7,20,5,0,Matches,Celta-Vigo,La-Liga
724,Sergio Carreira,es ESP,"MF,DF",24-211,16.4,27,16,15,6,6,14,24,58.3,10,18,2,16,17,44,35,0,Matches,Celta-Vigo,La-Liga
725,Hugo Álvarez,es ESP,"MF,DF",21-314,17.3,24,9,12,10,2,10,19,52.6,9,19,2,17,8,32,29,1,Matches,Celta-Vigo,La-Liga
726,Hugo Sotelo,es ESP,MF,21-144,13.9,28,17,8,10,10,13,30,43.3,17,9,1,8,5,33,9,1,Matches,Celta-Vigo,La-Liga
727,Pablo Durán,es ESP,"FW,MF",23-352,14.1,14,9,4,7,3,3,12,25.0,9,11,3,8,8,22,14,0,Matches,Celta-Vigo,La-Liga
728,Williot Swedberg,se SWE,"FW,MF",21-100,13.8,19,13,6,9,4,11,17,64.7,6,12,1,11,3,22,10,1,Matches,Celta-Vigo,La-Liga
729,Alfon,es ESP,"FW,MF",26-008,13.5,6,2,2,2,2,2,10,20.0,8,6,0,6,4,10,5,1,Matches,Celta-Vigo,La-Liga
730,Carlos Dominguez,es ESP,DF,24-090,11.0,21,11,13,8,0,15,21,71.4,6,10,7,3,9,30,65,1,Matches,Celta-Vigo,La-Liga
731,Damián Rodríguez,es ESP,MF,22-056,10.3,14,9,3,10,1,6,16,37.5,10,6,1,5,7,21,13,0,Matches,Celta-Vigo,La-Liga
732,Jonathan Bamba,ci CIV,"FW,MF",29-047,9.0,12,7,4,6,2,5,12,41.7,7,6,0,6,5,17,6,0,Matches,Celta-Vigo,La-Liga
733,Javier Manquillo,es ESP,DF,31-007,5.7,7,5,4,3,0,2,10,20.0,8,5,3,2,7,14,14,0,Matches,Celta-Vigo,La-Liga
734,Anastasios Douvikas,gr GRE,FW,25-283,7.8,9,4,2,6,1,3,6,50.0,3,5,2,3,3,12,6,0,Matches,Celta-Vigo,La-Liga
735,Jailson Siqueira,br BRA,"DF,MF",29-247,6.8,13,11,9,3,1,9,11,81.8,2,6,4,2,9,22,28,1,Matches,Celta-Vigo,La-Liga
736,Yoel Lago,es ESP,DF,21-048,5.3,11,7,7,3,1,6,7,85.7,1,3,2,1,4,15,24,0,Matches,Celta-Vigo,La-Liga
737,Fer López,,"FW,MF",,5.9,7,3,1,4,2,0,6,0.0,6,8,0,8,2,9,7,0,Matches,Celta-Vigo,La-Liga
738,Iván Villar,es ESP,GK,27-307,4.0,0,0,0,0,0,0,0,,0,0,0,0,0,0,3,0,Matches,Celta-Vigo,La-Liga
739,Iker Losada,es ESP,"FW,MF",23-284,3.8,3,3,0,1,2,1,5,20.0,4,3,0,3,1,4,8,0,Matches,Celta-Vigo,La-Liga
740,Franco Cervi,ar ARG,"FW,MF",30-351,3.0,8,3,2,6,0,3,8,37.5,5,4,0,4,8,16,7,0,Matches,Celta-Vigo,La-Liga
741,Mihailo Ristić,rs SRB,"MF,DF",29-193,3.0,3,3,2,1,0,1,3,33.3,2,0,0,0,1,4,7,0,Matches,Celta-Vigo,La-Liga
742,Luca de la Torre,us USA,MF,26-354,0.0,0,0,0,0,0,0,0,,0,0,0,0,0,0,0,0,Matches,Celta-Vigo,La-Liga
743,Joseph Aidoo,gh GHA,DF,29-225,0.0,1,0,1,0,0,0,0,,0,0,0,0,0,1,0,0,Matches,Celta-Vigo,La-Liga
744,Tadeo Allende,ar ARG,FW,26-081,0.0,0,0,0,0,0,0,0,,0,0,0,0,0,0,0,0,Matches,Celta-Vigo,La-Liga
745,Joan García,es ESP,GK,24-008,35.0,0,0,0,0,0,0,1,0.0,1,1,0,1,0,0,18,4,Matches,Espanyol,La-Liga
746,Omar El Hilali,ma MAR,DF,21-242,32.1,106,76,77,24,5,60,90,66.7,30,48,12,36,43,149,140,2,Matches,Espanyol,La-Liga
747,Marash Kumbulla,al ALB,DF,25-093,31.0,50,25,35,13,2,24,39,61.5,15,45,34,11,32,82,215,2,Matches,Espanyol,La-Liga
748,Javi Puado,es ESP,"FW,MF",26-352,30.3,19,15,11,4,4,8,15,53.3,7,14,2,12,5,24,19,0,Matches,Espanyol,La-Liga
749,Leandro Cabrera,uy URU,DF,33-329,30.0,38,22,27,8,3,18,32,56.3,14,34,24,10,29,67,191,2,Matches,Espanyol,La-Liga
750,Alex Král,cz CZE,MF,26-358,29.7,54,36,28,23,3,16,29,55.2,13,34,14,20,28,82,50,2,Matches,Espanyol,La-Liga
751,Carlos Romero,es ESP,DF,23-195,25.4,61,38,44,13,4,38,72,52.8,34,44,14,30,24,85,92,1,Matches,Espanyol,La-Liga
752,Jofre,es ESP,"MF,FW",23-329,23.0,22,16,14,5,3,13,23,56.5,10,13,0,13,15,37,28,0,Matches,Espanyol,La-Liga
753,Pol Lozano,es ESP,MF,25-218,19.8,50,33,20,25,5,24,54,44.4,30,28,5,23,21,71,29,0,Matches,Espanyol,La-Liga
754,Roberto Férnandez,es ESP,FW,22-313,13.9,4,4,2,1,1,0,3,0.0,3,8,1,7,3,7,23,0,Matches,Espanyol,La-Liga
755,Álvaro Tejero,es ESP,"MF,DF",28-296,13.7,13,4,6,6,1,6,21,28.6,15,9,1,8,13,26,34,1,Matches,Espanyol,La-Liga
756,Urko González,es ESP,MF,24-053,12.5,40,23,22,17,1,23,34,67.6,11,22,10,12,8,48,30,1,Matches,Espanyol,La-Liga
757,Brian Oliván,es ESP,DF,31-041,11.3,13,10,7,6,0,4,13,30.8,9,6,2,4,10,23,23,0,Matches,Espanyol,La-Liga
758,Antoniu,es ESP,"MF,FW",22-249,10.1,20,9,8,8,4,9,18,50.0,9,13,2,11,7,27,10,1,Matches,Espanyol,La-Liga
759,Alejo Véliz,ar ARG,FW,21-235,11.7,1,1,0,1,0,1,6,16.7,5,11,2,9,4,5,22,1,Matches,Espanyol,La-Liga
760,Edu Expósito,es ESP,MF,28-284,9.0,20,12,6,13,1,7,19,36.8,12,3,0,3,11,31,18,2,Matches,Espanyol,La-Liga
761,José Gragera,es ESP,MF,24-163,6.3,25,16,11,14,0,9,17,52.9,8,9,1,8,5,30,13,0,Matches,Espanyol,La-Liga
762,Sergi Gómez,es ESP,DF,33-045,7.2,8,5,7,1,0,2,3,66.7,1,12,8,4,7,15,36,0,Matches,Espanyol,La-Liga
763,Walid Cheddira,ma MAR,FW,27-110,7.0,5,0,1,1,3,0,1,0.0,1,4,0,4,1,6,6,0,Matches,Espanyol,La-Liga
764,Irvin Cardona,fr FRA,"FW,MF",27-277,6.7,8,5,2,4,2,6,16,37.5,10,5,1,4,4,12,10,0,Matches,Espanyol,La-Liga
765,Fernando Calero,es ESP,"DF,MF",29-240,5.8,13,6,10,3,0,5,8,62.5,3,12,6,6,13,26,32,0,Matches,Espanyol,La-Liga
766,Álvaro Aguado,es ESP,MF,29-011,4.8,4,2,2,2,0,2,8,25.0,6,6,1,5,4,8,5,1,Matches,Espanyol,La-Liga
767,Justin Smith,ca CAN,MF,22-097,2.3,9,3,3,6,0,4,6,66.7,2,5,1,4,4,13,3,0,Matches,Espanyol,La-Liga
768,Rafael Bauza,es ESP,MF,20-102,2.0,5,3,3,1,1,4,7,57.1,3,3,1,2,0,5,5,0,Matches,Espanyol,La-Liga
769,Pere Milla,es ESP,"MF,FW",32-231,3.7,4,1,3,0,1,0,14,0.0,14,10,2,8,2,6,4,0,Matches,Espanyol,La-Liga
770,Naci Ünüvar,nl NED,"MF,DF",21-333,0.3,2,2,1,1,0,1,2,50.0,1,0,0,0,0,2,0,0,Matches,Espanyol,La-Liga
771,Roger Hinojo,es ESP,DF,20-080,0.1,0,0,0,0,0,0,0,,0,0,0,0,0,0,1,0,Matches,Espanyol,La-Liga
772,David Soria,es ESP,GK,32-038,35.0,4,4,4,0,0,4,5,80.0,1,0,0,0,1,5,18,3,Matches,Getafe,La-Liga
773,Omar Alderete,py PAR,DF,28-137,31.0,41,27,29,10,2,20,30,66.7,10,33,21,12,37,78,209,1,Matches,Getafe,La-Liga
774,Luis Milla,es ESP,MF,30-217,29.9,55,35,28,22,5,31,65,47.7,34,23,0,23,22,77,27,3,Matches,Getafe,La-Liga
775,Djené,tg TOG,"DF,MF",33-132,27.3,25,13,12,11,2,12,31,38.7,19,18,8,10,21,46,104,3,Matches,Getafe,La-Liga
776,Iglesias,es ESP,DF,26-313,29.2,75,46,39,30,6,43,82,52.4,39,43,7,36,42,117,124,1,Matches,Getafe,La-Liga
777,Diego Rico,es ESP,DF,32-078,28.3,76,46,44,27,5,44,79,55.7,35,37,3,34,32,108,91,2,Matches,Getafe,La-Liga
778,Mauro Arambarri,uy URU,MF,29-224,26.9,45,26,9,31,5,21,44,47.7,23,33,6,27,13,58,41,0,Matches,Getafe,La-Liga
779,Chrisantus Uche,ng NGA,"FW,MF",21-358,24.8,28,17,6,16,6,6,15,40.0,9,18,2,16,9,37,17,0,Matches,Getafe,La-Liga
780,Domingos Duarte,pt POR,DF,30-063,18.0,23,11,18,4,1,13,17,76.5,4,25,15,10,13,36,129,1,Matches,Getafe,La-Liga
781,Carles Pérez,es ESP,"MF,FW",27-085,15.9,33,23,11,14,8,21,48,43.8,27,19,2,17,6,39,22,0,Matches,Getafe,La-Liga
782,Bertuğ Yıldırım,tr TUR,FW,22-304,11.8,10,5,0,7,3,2,7,28.6,5,13,2,11,1,11,16,0,Matches,Getafe,La-Liga
783,Alex Sola,es ESP,"MF,FW",25-337,11.4,21,14,9,12,0,9,25,36.0,16,8,0,8,7,28,11,1,Matches,Getafe,La-Liga
784,Ramón Terrats,es ESP,"MF,FW",24-206,11.1,18,9,7,6,5,8,25,32.0,17,7,1,6,5,23,14,0,Matches,Getafe,La-Liga
785,Coba da Costa,es ESP,"MF,FW",22-290,10.2,29,13,9,16,4,13,25,52.0,12,22,0,22,7,36,7,0,Matches,Getafe,La-Liga
786,Juan Berrocal,es ESP,DF,26-008,11.0,14,7,10,4,0,10,13,76.9,3,4,2,2,13,27,52,0,Matches,Getafe,La-Liga
787,Juan Bernat,es ESP,"MF,DF",32-072,7.7,18,12,8,5,5,6,11,54.5,5,9,3,6,2,20,8,0,Matches,Getafe,La-Liga
788,Allan Nyom,cm CMR,"DF,MF",37-002,7.8,13,7,5,7,1,10,12,83.3,2,4,2,2,2,15,18,0,Matches,Getafe,La-Liga
789,Juanmi,es ESP,"FW,MF",31-357,7.4,14,11,4,7,3,6,16,37.5,10,6,0,6,2,16,3,0,Matches,Getafe,La-Liga
790,Álvaro Rodríguez,uy URU,FW,20-302,8.6,9,6,0,6,3,4,9,44.4,5,22,0,22,3,12,12,0,Matches,Getafe,La-Liga
791,Borja Mayoral,es ESP,FW,28-037,10.3,4,3,1,2,1,2,7,28.6,5,3,0,3,1,5,6,0,Matches,Getafe,La-Liga
792,Carles Aleñá,es ESP,"MF,FW",27-127,5.0,6,3,2,3,1,4,13,30.8,9,9,1,8,0,6,7,0,Matches,Getafe,La-Liga
793,Jesús Santiago,es ESP,MF,20-352,3.6,14,8,6,8,0,5,9,55.6,4,5,2,3,1,15,3,0,Matches,Getafe,La-Liga
794,Nabil Aberdin,fr FRA,MF,22-262,2.9,6,4,3,3,0,1,1,100.0,0,3,0,3,0,6,5,0,Matches,Getafe,La-Liga
795,Peter González,do DOM,"MF,FW",22-291,5.2,11,6,2,5,4,6,9,66.7,3,8,0,8,2,13,5,0,Matches,Getafe,La-Liga
796,Abdoulaye Keita,es ESP,"FW,MF",22-253,1.1,2,2,0,1,1,2,4,50.0,2,1,0,1,0,2,3,0,Matches,Getafe,La-Liga
797,Alberto Risco,es ESP,"MF,FW",19-255,0.8,4,4,2,0,2,1,6,16.7,5,2,0,2,0,4,0,0,Matches,Getafe,La-Liga
798,John Joe,ie IRL,"MF,FW",21-200,0.5,0,0,0,0,0,0,0,,0,1,1,0,0,0,1,0,Matches,Getafe,La-Liga
799,Ismael Bekhoucha,ma MAR,"MF,DF",20-173,0.3,0,0,0,0,0,0,0,,0,0,0,0,2,2,0,0,Matches,Getafe,La-Liga
800,Gorka Rivera Alonso,es ESP,"DF,MF",20-284,0.2,2,0,0,2,0,2,2,100.0,0,0,0,0,0,2,0,0,Matches,Getafe,La-Liga
801,David Argüelles,es ESP,MF,23-131,0.1,0,0,0,0,0,0,0,,0,2,0,2,0,0,0,0,Matches,Getafe,La-Liga
802,Paulo Gazzaniga,ar ARG,GK,33-130,34.5,1,1,1,0,0,1,1,100.0,0,1,0,1,0,1,15,3,Matches,Girona,La-Liga
803,Miguel Gutiérrez,es ESP,"DF,MF",23-289,27.3,37,24,18,16,3,17,37,45.9,20,17,7,10,16,53,34,3,Matches,Girona,La-Liga
804,Daley Blind,nl NED,DF,35-064,27.9,41,24,23,14,4,25,39,64.1,14,29,8,21,24,65,85,1,Matches,Girona,La-Liga
805,Arnau Martinez,es ESP,"DF,MF",22-017,26.7,44,23,27,11,6,28,56,50.0,28,16,6,10,28,72,68,2,Matches,Girona,La-Liga
806,David López,es ESP,DF,35-215,26.0,31,23,21,7,3,18,31,58.1,13,22,12,10,14,45,105,1,Matches,Girona,La-Liga
807,Ladislav Krejčí,cz CZE,DF,26-022,25.1,21,15,17,4,0,12,24,50.0,12,24,19,5,32,53,86,4,Matches,Girona,La-Liga
808,Yangel Herrera,ve VEN,MF,27-118,23.3,60,37,27,26,7,29,55,52.7,26,20,4,16,29,89,45,1,Matches,Girona,La-Liga
809,Iván Martín,es ESP,MF,26-087,21.4,29,17,14,12,3,13,32,40.6,19,17,4,13,11,40,15,1,Matches,Girona,La-Liga
810,Bryan Gil,es ESP,"FW,MF",24-090,19.1,34,20,10,15,9,14,30,46.7,16,24,0,24,10,44,9,4,Matches,Girona,La-Liga
811,Viktor Tsyhankov,ua UKR,"FW,MF",27-178,18.3,17,11,3,6,8,7,16,43.8,9,5,0,5,11,28,11,1,Matches,Girona,La-Liga
812,Donny van de Beek,nl NED,MF,28-024,15.8,29,18,17,7,5,13,26,50.0,13,19,3,16,10,39,12,0,Matches,Girona,La-Liga
813,Oriol Romeu,es ESP,MF,33-230,13.8,32,22,13,16,3,12,22,54.5,10,20,7,13,11,43,18,3,Matches,Girona,La-Liga
814,Abel Ruiz,es ESP,FW,25-104,13.6,6,2,2,2,2,2,5,40.0,3,7,2,5,4,10,7,0,Matches,Girona,La-Liga
815,Arnaut Danjuma,nl NED,"FW,MF",28-101,14.6,8,6,3,3,2,2,7,28.6,5,5,1,4,2,10,4,0,Matches,Girona,La-Liga
816,Yaser Asprilla,co COL,"FW,MF",21-174,12.8,16,10,5,7,4,6,16,37.5,10,10,0,10,5,21,4,1,Matches,Girona,La-Liga
817,Bojan Miovski,mk MKD,FW,25-322,9.7,7,5,2,2,3,2,7,28.6,5,4,0,4,2,9,7,0,Matches,Girona,La-Liga
818,Alejandro Francés,es ESP,DF,22-284,10.8,30,22,16,13,1,23,32,71.9,9,12,5,7,15,45,37,0,Matches,Girona,La-Liga
819,Arthur Melo,br BRA,MF,28-273,8.3,23,10,8,12,3,13,24,54.2,11,4,1,3,7,30,9,1,Matches,Girona,La-Liga
820,Juanpe,es ESP,DF,34-012,6.8,8,5,5,3,0,6,8,75.0,2,14,9,5,8,16,46,1,Matches,Girona,La-Liga
821,Cristhian Stuani,uy URU,FW,38-212,10.0,8,7,1,6,1,4,7,57.1,3,4,1,3,5,13,9,0,Matches,Girona,La-Liga
822,Portu,es ESP,"FW,MF",32-356,7.0,11,5,5,3,3,6,9,66.7,3,7,0,7,0,11,2,0,Matches,Girona,La-Liga
823,Jhon Solis,co COL,MF,20-221,5.3,10,5,3,6,1,5,13,38.5,8,12,1,11,4,14,6,1,Matches,Girona,La-Liga
824,Silvi Clúa,es ESP,MF,20-103,1.8,8,7,4,3,1,4,6,66.7,2,1,0,1,2,10,6,0,Matches,Girona,La-Liga
825,Gabriel Osei Misehouy,nl NED,"FW,MF",19-298,2.9,1,1,0,1,0,0,1,0.0,1,0,0,0,0,1,0,0,Matches,Girona,La-Liga
826,Iker Almena,es ESP,"FW,DF",21-008,0.5,0,0,0,0,0,0,1,0.0,1,1,0,1,0,0,2,0,Matches,Girona,La-Liga
827,Papa Ba,es ESP,MF,20-242,0.5,1,1,1,0,0,0,0,,0,1,0,1,0,1,1,0,Matches,Girona,La-Liga
828,Pau López,es ESP,GK,30-150,0.5,0,0,0,0,0,0,0,,0,0,0,0,0,0,1,0,Matches,Girona,La-Liga
829,Kim Minsu,kr KOR,"MF,FW",19-113,0.2,1,0,0,1,0,0,0,,0,0,0,0,0,1,0,0,Matches,Girona,La-Liga
830,Ferrán Ruiz,es ESP,MF,22-016,0.2,0,0,0,0,0,0,0,,0,2,1,1,1,1,0,0,Matches,Girona,La-Liga
831,Alberto Moleiro,es ESP,"FW,MF",21-224,28.4,26,12,11,14,1,18,48,37.5,30,24,0,24,18,44,8,0,Matches,Las-Palmas,La-Liga
832,Álex Suárez,es ESP,DF,32-055,26.6,39,22,29,9,1,20,27,74.1,7,38,24,14,12,51,103,1,Matches,Las-Palmas,La-Liga
833,Javier Muñoz,es ESP,"MF,DF",30-073,28.5,43,34,18,15,10,15,45,33.3,30,27,4,23,31,74,39,3,Matches,Las-Palmas,La-Liga
834,Jasper Cillessen,nl NED,GK,36-020,25.9,1,0,1,0,0,1,4,25.0,3,0,0,0,0,1,11,2,Matches,Las-Palmas,La-Liga
835,Scott McKenna,sct SCO,DF,28-181,25.4,18,12,13,5,0,9,12,75.0,3,34,26,8,9,27,146,2,Matches,Las-Palmas,La-Liga
836,Mika Mármol,es ESP,DF,23-315,24.7,57,26,32,23,2,33,49,67.3,16,42,14,28,37,94,111,2,Matches,Las-Palmas,La-Liga
837,Sandro Ramírez,es ESP,"FW,MF",29-307,21.6,26,15,9,13,4,13,30,43.3,17,18,0,18,16,42,21,2,Matches,Las-Palmas,La-Liga
838,Dario Essugo,pt POR,MF,20-059,19.5,57,44,27,25,5,27,45,60.0,18,27,10,17,42,99,44,7,Matches,Las-Palmas,La-Liga
839,Fábio Silva,pt POR,FW,22-297,20.7,12,7,4,5,3,4,14,28.6,10,12,0,12,4,16,27,0,Matches,Las-Palmas,La-Liga
840,Viti,es ESP,DF,27-238,20.5,69,45,42,20,7,31,45,68.9,14,27,6,21,26,95,55,0,Matches,Las-Palmas,La-Liga
841,Kirian Rodríguez,es ESP,MF,29-068,19.5,33,17,12,18,3,22,43,51.2,21,22,4,18,10,43,21,0,Matches,Las-Palmas,La-Liga
842,Oliver McBurnie,sct SCO,FW,28-342,18.4,13,7,5,6,2,5,11,45.5,6,15,5,10,6,19,21,0,Matches,Las-Palmas,La-Liga
843,Álex Muñoz,es ESP,DF,30-286,15.2,38,29,22,15,1,20,37,54.1,17,28,11,17,16,54,68,0,Matches,Las-Palmas,La-Liga
844,José Campaña,es ESP,MF,31-346,12.4,20,15,7,11,2,10,18,55.6,8,8,0,8,18,38,19,2,Matches,Las-Palmas,La-Liga
845,Juan Herzog,es ESP,DF,21-364,11.7,11,11,11,0,0,9,14,64.3,5,14,8,6,15,26,61,0,Matches,Las-Palmas,La-Liga
846,Stefan Bajcetic,es ESP,"MF,DF",20-202,10.2,28,14,12,13,3,11,27,40.7,16,24,4,20,15,43,24,1,Matches,Las-Palmas,La-Liga
847,Dinko Horkaš,hr CRO,GK,26-063,9.1,0,0,0,0,0,0,0,,0,0,0,0,0,0,6,1,Matches,Las-Palmas,La-Liga
848,Marvin,es ESP,"DF,FW",24-313,9.4,21,10,10,7,4,9,23,39.1,14,15,5,10,10,31,25,0,Matches,Las-Palmas,La-Liga
849,Manuel Fuster,es ESP,"FW,MF",27-202,8.9,16,8,3,8,5,14,26,53.8,12,13,3,10,4,20,14,0,Matches,Las-Palmas,La-Liga
850,Enzo Loiodice,fr FRA,MF,24-166,5.6,11,4,6,5,0,3,9,33.3,6,4,1,3,5,16,7,2,Matches,Las-Palmas,La-Liga
851,Adnan Januzaj,be BEL,"MF,FW",30-096,5.3,10,6,1,6,3,5,7,71.4,2,5,0,5,0,10,2,0,Matches,Las-Palmas,La-Liga
852,Jaime Mata,es ESP,FW,36-200,6.1,8,2,2,6,0,3,9,33.3,6,5,1,4,3,11,9,0,Matches,Las-Palmas,La-Liga
853,Andy Pelmard,fr FRA,DF,25-061,2.3,5,0,3,2,0,4,5,80.0,1,3,1,2,2,7,20,0,Matches,Las-Palmas,La-Liga
854,Benito Ramírez,es ESP,"DF,MF",29-305,4.3,10,5,4,6,0,9,16,56.3,7,6,3,3,1,11,14,1,Matches,Las-Palmas,La-Liga
855,Daley Sinkgraven,nl NED,DF,29-312,1.0,5,1,3,2,0,1,3,33.3,2,1,0,1,1,6,2,0,Matches,Las-Palmas,La-Liga
856,Marc Cardona,es ESP,"FW,DF",29-308,1.2,2,1,1,1,0,0,1,0.0,1,0,0,0,0,2,0,0,Matches,Las-Palmas,La-Liga
857,Fabio González,es ESP,MF,28-089,0.6,0,0,0,0,0,0,1,0.0,1,0,0,0,0,0,0,0,Matches,Las-Palmas,La-Liga
858,Pejiño,es ESP,FW,28-287,0.2,1,1,0,1,0,1,1,100.0,0,0,0,0,0,1,0,0,Matches,Las-Palmas,La-Liga
859,Valentín Pezzolesi,es ESP,DF,18-026,0.1,0,0,0,0,0,0,0,,0,0,0,0,0,0,1,1,Matches,Las-Palmas,La-Liga
860,Aboubacar Bassinga,ci CIV,MF,19-303,0.0,0,0,0,0,0,0,0,,0,0,0,0,0,0,0,0,Matches,Las-Palmas,La-Liga
861,Sergi,es ESP,DF,33-022,31.4,38,28,22,15,1,17,31,54.8,14,35,28,7,39,77,182,2,Matches,Leganes,La-Liga
862,Marko Dmitrović,rs SRB,GK,33-108,29.0,1,1,1,0,0,1,2,50.0,1,0,0,0,0,1,26,3,Matches,Leganes,La-Liga
863,Seydouba Cissé,gn GUI,MF,24-091,24.2,50,31,17,24,9,20,41,48.8,21,23,1,22,11,61,42,1,Matches,Leganes,La-Liga
864,Valentin Rosier,fr FRA,DF,28-266,28.1,69,51,48,15,6,41,66,62.1,25,39,14,25,50,119,148,2,Matches,Leganes,La-Liga
865,Yvan Neyou,cm CMR,MF,28-129,25.0,53,33,21,26,6,22,46,47.8,24,33,5,28,26,79,38,1,Matches,Leganes,La-Liga
866,Renato Tapia,pe PER,"MF,DF",29-288,24.2,56,32,27,25,4,21,44,47.7,23,53,20,33,23,79,80,2,Matches,Leganes,La-Liga
867,Javi Hernández,es ESP,DF,27-010,23.5,25,15,16,6,3,16,42,38.1,26,22,3,19,22,47,89,0,Matches,Leganes,La-Liga
868,Juan Cruz,es ESP,"FW,MF",25-017,23.1,30,19,13,15,2,16,32,50.0,16,14,2,12,11,41,27,0,Matches,Leganes,La-Liga
869,Matija Nastasić,rs SRB,DF,32-045,22.6,24,11,21,3,0,16,24,66.7,8,39,30,9,19,43,155,0,Matches,Leganes,La-Liga
870,Dani Raba,es ESP,"FW,MF",29-195,18.9,36,22,16,15,5,16,39,41.0,23,27,3,24,14,50,16,1,Matches,Leganes,La-Liga
871,Miguel,es ESP,FW,25-251,18.6,16,7,6,4,6,4,14,28.6,10,15,4,11,4,20,23,1,Matches,Leganes,La-Liga
872,Jorge Sáenz,es ESP,DF,28-176,15.8,30,21,15,14,1,8,15,53.3,7,24,16,8,22,52,150,0,Matches,Leganes,La-Liga
873,Adrià Altimira,es ESP,"DF,FW",24-045,15.1,33,17,22,9,2,18,32,56.3,14,12,6,6,15,48,46,2,Matches,Leganes,La-Liga
874,Darko Brašanac,rs SRB,MF,33-089,17.5,26,11,5,15,6,9,17,52.9,8,24,11,13,15,41,33,0,Matches,Leganes,La-Liga
875,Óscar Rodríguez Arnaiz,es ESP,"MF,FW",26-318,14.1,32,17,10,16,6,14,31,45.2,17,9,1,8,18,50,19,0,Matches,Leganes,La-Liga
876,Diego,es ESP,"FW,MF",25-024,11.3,0,0,0,0,0,0,5,0.0,5,3,1,2,2,2,10,0,Matches,Leganes,La-Liga
877,Munir El Haddadi,ma MAR,"FW,MF",29-253,8.4,12,9,5,4,3,3,11,27.3,8,8,1,7,1,13,1,1,Matches,Leganes,La-Liga
878,Enric Franquesa,es ESP,"DF,FW",28-075,6.8,17,9,9,6,2,9,13,69.2,4,7,1,6,5,22,12,0,Matches,Leganes,La-Liga
879,Juan Soriano,es ESP,GK,27-262,6.0,1,1,1,0,0,1,1,100.0,0,0,0,0,0,1,2,0,Matches,Leganes,La-Liga
880,Sébastien Haller,ci CIV,FW,30-324,4.5,2,0,1,0,1,1,2,50.0,1,1,0,1,0,2,7,0,Matches,Leganes,La-Liga
881,Yan Diomandé,ci CIV,"FW,MF",18-179,3.6,5,2,1,3,1,2,10,20.0,8,7,0,7,5,10,2,0,Matches,Leganes,La-Liga
882,Roberto López,es ESP,MF,25-018,4.4,8,6,4,4,0,5,15,33.3,10,5,0,5,1,9,7,2,Matches,Leganes,La-Liga
883,Julián Chicco,ar ARG,"MF,DF",27-119,3.3,11,7,3,6,2,5,8,62.5,3,2,0,2,3,14,9,0,Matches,Leganes,La-Liga
884,Aritz Arambarri,es ESP,DF,27-101,2.0,1,1,1,0,0,1,1,100.0,0,2,2,0,3,4,8,0,Matches,Leganes,La-Liga
885,Duk,cv CPV,"MF,FW",25-085,1.6,7,3,2,3,2,3,5,60.0,2,3,0,3,0,7,2,0,Matches,Leganes,La-Liga
886,Borna Barišić,hr CRO,DF,32-183,0.1,0,0,0,0,0,0,0,,0,0,0,0,0,0,0,0,Matches,Leganes,La-Liga
887,Antonio Raillo,es ESP,DF,33-216,32.6,29,17,16,10,3,14,18,77.8,4,39,31,8,27,56,197,1,Matches,Mallorca,La-Liga
888,Sergi Darder,es ESP,"MF,FW",31-141,27.6,38,24,15,15,8,16,41,39.0,25,18,1,17,14,52,20,1,Matches,Mallorca,La-Liga
889,Johan Mojica,co COL,DF,32-264,29.3,34,23,26,5,3,19,40,47.5,21,11,5,6,25,59,79,3,Matches,Mallorca,La-Liga
890,Dominik Greif,sk SVK,GK,28-036,29.0,0,0,0,0,0,0,0,,0,0,0,0,0,0,10,1,Matches,Mallorca,La-Liga
891,Martin Valjent,sk SVK,DF,29-152,28.7,28,19,20,7,1,14,19,73.7,5,28,18,10,17,45,180,1,Matches,Mallorca,La-Liga
892,Samu Costa,pt POR,MF,24-166,26.6,79,38,39,38,2,29,70,41.4,41,41,13,28,30,109,77,1,Matches,Mallorca,La-Liga
893,Pablo Maffeo,es ESP,DF,27-304,25.5,58,39,41,14,3,34,46,73.9,12,31,11,20,25,83,95,1,Matches,Mallorca,La-Liga
894,Dani Rodríguez,es ESP,"MF,FW",36-340,22.7,44,27,14,20,10,13,26,50.0,13,21,2,19,12,56,23,0,Matches,Mallorca,La-Liga
895,Vedat Muriqi,xk KVX,FW,31-018,20.3,6,4,3,2,1,3,6,50.0,3,6,1,5,7,13,34,0,Matches,Mallorca,La-Liga
896,Cyle Larin,ca CAN,FW,30-025,18.3,11,5,1,5,5,2,7,28.6,5,12,3,9,1,12,16,0,Matches,Mallorca,La-Liga
897,Omar Mascarell,gq EQG,MF,32-099,20.1,24,13,11,12,1,12,30,40.0,18,28,19,9,48,72,54,3,Matches,Mallorca,La-Liga
898,Copete,es ESP,DF,25-214,16.0,27,15,16,10,1,10,11,90.9,1,23,15,8,17,44,116,2,Matches,Mallorca,La-Liga
899,Manu Morlanes,es ESP,MF,26-120,14.4,43,27,18,20,5,18,30,60.0,12,18,7,11,24,67,16,0,Matches,Mallorca,La-Liga
900,Roberto Navarro,es ESP,"MF,FW",23-030,14.2,29,22,14,11,4,9,19,47.4,10,18,0,18,19,48,12,0,Matches,Mallorca,La-Liga
901,Takuma Asano,jp JPN,"FW,MF",30-183,11.7,13,9,5,7,1,6,11,54.5,5,7,0,7,6,19,9,0,Matches,Mallorca,La-Liga
902,Antonio Sánchez,es ESP,"MF,DF",28-131,13.8,27,16,15,8,4,14,29,48.3,15,12,2,10,17,44,30,1,Matches,Mallorca,La-Liga
903,Leo Román,es ESP,GK,24-310,6.0,0,0,0,0,0,0,0,,0,0,0,0,0,0,4,0,Matches,Mallorca,La-Liga
904,Mateu Morey,es ESP,DF,25-071,5.6,14,13,8,4,2,10,17,58.8,7,8,0,8,9,23,15,1,Matches,Mallorca,La-Liga
905,Toni Lato,es ESP,DF,27-172,5.2,16,10,6,4,6,6,9,66.7,3,6,2,4,4,20,27,0,Matches,Mallorca,La-Liga
906,Abdón Prats,es ESP,"FW,MF",32-156,5.1,2,1,1,1,0,1,2,50.0,1,2,1,1,1,3,5,0,Matches,Mallorca,La-Liga
907,Marc Domenech,es ESP,"FW,MF",19-131,2.3,3,3,1,1,1,2,4,50.0,2,2,0,2,0,3,0,0,Matches,Mallorca,La-Liga
908,Valery Fernández,es ESP,"MF,FW",25-170,3.3,8,7,3,2,3,5,7,71.4,2,3,1,2,0,8,1,0,Matches,Mallorca,La-Liga
909,Chiquinho,pt POR,"MF,FW",25-096,1.6,1,0,0,1,0,0,7,0.0,7,3,0,3,2,3,0,0,Matches,Mallorca,La-Liga
910,Siebe Van Der Heyden,be BEL,"DF,MF",26-347,1.1,1,1,0,1,0,0,0,,0,1,0,1,2,3,3,0,Matches,Mallorca,La-Liga
911,David López,es ESP,DF,22-098,0.9,1,1,1,0,0,1,1,100.0,0,0,0,0,1,2,3,0,Matches,Mallorca,La-Liga
912,Javier Llabrés,es ESP,FW,22-243,0.6,0,0,0,0,0,0,0,,0,1,0,1,0,0,0,0,Matches,Mallorca,La-Liga
913,Jan Salas,es ESP,MF,19-275,0.3,2,1,1,1,0,1,1,100.0,0,0,0,0,0,2,0,0,Matches,Mallorca,La-Liga
914,Daniel Luna,co COL,MF,22-005,0.2,0,0,0,0,0,0,0,,0,1,0,1,0,0,0,0,Matches,Mallorca,La-Liga
915,Sergio Herrera,es ESP,GK,31-341,34.0,2,1,2,0,0,2,5,40.0,3,1,0,1,0,2,27,1,Matches,Osasuna,La-Liga
916,Jesús Areso,es ESP,DF,25-314,31.2,47,35,30,12,5,35,51,68.6,16,25,4,21,8,55,83,0,Matches,Osasuna,La-Liga
917,Catena,es ESP,DF,30-196,31.2,45,27,34,9,2,26,42,61.9,16,36,22,14,34,79,199,1,Matches,Osasuna,La-Liga
918,Lucas Torró,es ESP,MF,30-297,30.4,71,40,31,36,4,36,64,56.3,28,33,9,24,43,114,63,3,Matches,Osasuna,La-Liga
919,Aimar Oroz,es ESP,"MF,FW",23-166,30.0,33,18,15,12,6,14,44,31.8,30,27,2,25,18,51,7,0,Matches,Osasuna,La-Liga
920,Ante Budimir,hr CRO,FW,33-294,30.0,20,9,3,11,6,3,12,25.0,9,18,4,14,2,22,21,0,Matches,Osasuna,La-Liga
921,Enzo Boyomo,cm CMR,DF,23-217,30.2,63,39,43,16,4,27,34,79.4,7,34,19,15,39,102,121,3,Matches,Osasuna,La-Liga
922,Rubén García,es ESP,"FW,MF",31-302,25.2,48,30,19,19,10,25,54,46.3,29,33,3,30,14,62,31,1,Matches,Osasuna,La-Liga
923,Jon Moncayola,es ESP,MF,26-364,22.9,68,40,28,32,8,30,59,50.8,29,34,3,31,11,79,19,0,Matches,Osasuna,La-Liga
924,Abel,es ESP,DF,24-264,22.4,59,35,28,24,7,37,59,62.7,22,28,4,24,18,77,61,2,Matches,Osasuna,La-Liga
925,Bryan Zaragoza,es ESP,"FW,MF",24-017,17.9,14,10,9,4,1,7,22,31.8,15,10,0,10,1,15,8,0,Matches,Osasuna,La-Liga
926,Juan Cruz Armada,es ESP,DF,32-288,14.0,21,11,9,11,1,12,21,57.1,9,14,4,10,8,29,51,0,Matches,Osasuna,La-Liga
927,Jorge Herrando,es ESP,DF,24-073,15.2,17,11,9,5,3,9,15,60.0,6,20,14,6,12,29,65,2,Matches,Osasuna,La-Liga
928,Pablo Ibáñez,es ESP,MF,26-234,12.3,19,10,7,11,1,10,39,25.6,29,18,6,12,14,33,21,0,Matches,Osasuna,La-Liga
929,Moi Gómez,es ESP,"MF,FW",30-323,8.8,13,9,4,7,2,4,8,50.0,4,5,2,3,5,18,7,1,Matches,Osasuna,La-Liga
930,Rubén Peña,es ESP,"FW,DF",33-298,8.0,10,4,3,3,4,4,19,21.1,15,10,0,10,6,16,12,0,Matches,Osasuna,La-Liga
931,Raúl,es ESP,"FW,MF",24-190,7.8,11,6,3,5,3,4,9,44.4,5,4,0,4,0,11,5,0,Matches,Osasuna,La-Liga
932,Iker Muñoz,es ESP,MF,22-188,5.7,5,2,3,2,0,3,8,37.5,5,7,1,6,4,9,10,1,Matches,Osasuna,La-Liga
933,Kike Barja,es ESP,"FW,MF",28-041,3.0,5,4,1,3,1,2,3,66.7,1,5,0,5,3,8,4,0,Matches,Osasuna,La-Liga
934,José Arnaiz,es ESP,"MF,FW",30-027,1.4,7,5,3,3,1,4,7,57.1,3,2,0,2,3,10,1,0,Matches,Osasuna,La-Liga
935,Nacho Vidal,es ESP,DF,30-108,1.4,2,0,0,1,1,1,4,25.0,3,1,0,1,0,2,6,0,Matches,Osasuna,La-Liga
936,Aitor Fernández,es ESP,GK,34-009,1.0,0,0,0,0,0,0,0,,0,0,0,0,0,0,2,0,Matches,Osasuna,La-Liga
937,Unai García,es ESP,DF,33-098,0.7,0,0,0,0,0,0,0,,0,1,0,1,0,0,1,0,Matches,Osasuna,La-Liga
938,Iker Benito,es ESP,"FW,MF",22-275,0.4,0,0,0,0,0,0,1,0.0,1,0,0,0,1,1,2,0,Matches,Osasuna,La-Liga
939,Javi Martínez,es ESP,MF,25-141,0.1,0,0,0,0,0,0,0,,0,0,0,0,0,0,0,0,Matches,Osasuna,La-Liga
940,Florian Lejeune,fr FRA,DF,33-357,33.9,43,26,28,13,2,21,39,53.8,18,36,30,6,32,75,170,1,Matches,Rayo-Vallecano,La-Liga
941,Andrei Ratiu,ro ROU,DF,26-326,31.1,65,37,40,17,8,39,64,60.9,25,36,3,33,26,91,68,2,Matches,Rayo-Vallecano,La-Liga
942,Augusto Batalla,ar ARG,GK,29-012,29.0,4,2,4,0,0,4,6,66.7,2,0,0,0,0,4,12,4,Matches,Rayo-Vallecano,La-Liga
943,Jorge de Frutos,es ESP,"FW,MF",28-081,25.0,37,21,16,13,8,14,43,32.6,29,20,0,20,17,54,23,1,Matches,Rayo-Vallecano,La-Liga
944,Pep Chavarría,es ESP,"DF,FW",27-032,26.4,42,32,28,13,1,26,42,61.9,16,31,8,23,26,68,103,1,Matches,Rayo-Vallecano,La-Liga
945,Álvaro García,es ESP,"FW,MF",32-197,26.1,31,22,19,8,4,12,29,41.4,17,30,0,30,30,61,40,1,Matches,Rayo-Vallecano,La-Liga
946,Abdul Mumin,gh GHA,DF,26-340,22.4,37,25,30,7,0,17,27,63.0,10,40,29,11,23,60,125,0,Matches,Rayo-Vallecano,La-Liga
947,Isaac Palazón Camacho,es ESP,"MF,FW",30-136,21.0,22,17,10,6,6,8,31,25.8,23,19,1,18,8,30,12,1,Matches,Rayo-Vallecano,La-Liga
948,Pathé Ciss,sn SEN,"MF,DF",31-057,21.0,45,22,23,21,1,20,40,50.0,20,28,7,21,34,79,57,3,Matches,Rayo-Vallecano,La-Liga
949,Unai López,es ESP,MF,29-194,17.4,27,19,13,9,5,14,32,43.8,18,14,3,11,20,47,19,0,Matches,Rayo-Vallecano,La-Liga
950,Óscar Valentín,es ESP,MF,30-265,19.5,53,40,21,19,13,32,70,45.7,38,35,7,28,21,74,50,2,Matches,Rayo-Vallecano,La-Liga
951,Adri Embarba,es ESP,"FW,MF",33-005,17.2,38,18,15,16,7,17,43,39.5,26,17,1,16,13,51,13,1,Matches,Rayo-Vallecano,La-Liga
952,Randy Nteka,ao ANG,FW,27-157,12.5,16,5,3,9,4,5,12,41.7,7,13,2,11,4,20,20,0,Matches,Rayo-Vallecano,La-Liga
953,Sergio Camello,es ESP,FW,24-091,12.6,9,3,2,5,2,4,6,66.7,2,8,1,7,4,13,16,0,Matches,Rayo-Vallecano,La-Liga
954,Pedro Díaz,es ESP,MF,26-341,11.9,21,13,6,13,2,12,35,34.3,23,13,0,13,6,27,7,1,Matches,Rayo-Vallecano,La-Liga
955,Iván Balliu,al ALB,DF,33-131,11.0,15,12,7,5,3,6,16,37.5,10,14,3,11,10,25,35,0,Matches,Rayo-Vallecano,La-Liga
956,Aridane Hernández,es ESP,DF,36-050,9.4,11,9,7,4,0,4,6,66.7,2,7,5,2,4,15,90,2,Matches,Rayo-Vallecano,La-Liga
957,Alfonso Espino,uy URU,DF,33-127,8.3,37,20,29,6,2,23,42,54.8,19,14,6,8,11,48,30,1,Matches,Rayo-Vallecano,La-Liga
958,Gerard Gumbau,es ESP,MF,30-145,8.7,16,12,8,6,2,7,15,46.7,8,10,4,6,5,21,12,0,Matches,Rayo-Vallecano,La-Liga
959,Cárdenas,es ESP,GK,28-045,6.0,0,0,0,0,0,0,0,,0,0,0,0,0,0,3,0,Matches,Rayo-Vallecano,La-Liga
960,Óscar Trejo,ar ARG,MF,37-016,5.4,7,5,1,4,2,3,9,33.3,6,8,0,8,4,11,5,0,Matches,Rayo-Vallecano,La-Liga
961,Sergi Guardiola,es ESP,FW,33-348,4.0,5,3,0,5,0,2,3,66.7,1,1,0,1,1,6,2,0,Matches,Rayo-Vallecano,La-Liga
962,James Rodríguez,co COL,"MF,FW",33-304,1.6,3,2,1,2,0,0,2,0.0,2,2,0,2,1,4,0,0,Matches,Rayo-Vallecano,La-Liga
963,Pelayo Fernandez,es ESP,DF,22-013,1.1,0,0,0,0,0,0,0,,0,0,0,0,2,2,9,0,Matches,Rayo-Vallecano,La-Liga
964,Etienne Eto'o,cm CMR,FW,22-267,0.4,0,0,0,0,0,0,1,0.0,1,0,0,0,0,0,1,0,Matches,Rayo-Vallecano,La-Liga
965,Raúl de Tomás,es ESP,"DF,FW",30-207,0.2,2,2,1,0,1,0,0,,0,0,0,0,0,2,0,0,Matches,Rayo-Vallecano,La-Liga
966,Federico Valverde,uy URU,"MF,DF",26-294,30.7,47,28,21,21,5,26,37,70.3,11,37,7,30,53,100,51,1,Matches,Real-Madrid,La-Liga
967,Kylian Mbappé,fr FRA,FW,26-143,29.3,8,5,1,3,4,1,5,20.0,4,3,0,3,1,9,1,1,Matches,Real-Madrid,La-Liga
968,Thibaut Courtois,be BEL,GK,33-001,29.0,0,0,0,0,0,0,0,,0,0,0,0,1,1,15,1,Matches,Real-Madrid,La-Liga
969,Aurélien Tchouaméni,fr FRA,"DF,MF",25-105,28.3,43,21,23,18,2,19,38,50.0,19,33,24,9,44,87,89,1,Matches,Real-Madrid,La-Liga
970,Jude Bellingham,eng ENG,MF,21-317,25.6,57,32,17,26,14,26,39,66.7,13,33,2,31,26,83,23,1,Matches,Real-Madrid,La-Liga
971,Antonio Rüdiger,de GER,DF,32-070,25.5,20,13,14,6,0,11,15,73.3,4,22,14,8,9,29,96,1,Matches,Real-Madrid,La-Liga
972,Vinicius Júnior,br BRA,FW,24-304,24.6,21,10,7,4,10,5,18,27.8,13,7,0,7,3,24,1,2,Matches,Real-Madrid,La-Liga
973,Lucas Vázquez,es ESP,DF,33-315,23.3,56,35,32,17,7,25,46,54.3,21,22,5,17,17,73,33,1,Matches,Real-Madrid,La-Liga
974,Rodrygo,br BRA,"FW,MF",24-123,21.4,21,14,14,5,2,7,23,30.4,16,18,1,17,11,32,9,0,Matches,Real-Madrid,La-Liga
975,Fran Garcia,es ESP,DF,25-271,21.3,41,28,24,13,4,22,39,56.4,17,23,5,18,24,65,63,1,Matches,Real-Madrid,La-Liga
976,Raúl Asencio,es ESP,DF,22-088,16.9,20,14,17,3,0,9,12,75.0,3,8,5,3,12,32,82,2,Matches,Real-Madrid,La-Liga
977,Brahim Díaz,ma MAR,"FW,MF",25-282,14.8,25,19,9,13,3,7,18,38.9,11,16,1,15,4,29,2,1,Matches,Real-Madrid,La-Liga
978,Luka Modrić,hr CRO,MF,39-245,17.3,28,18,16,11,1,14,32,43.8,18,15,5,10,24,52,16,0,Matches,Real-Madrid,La-Liga
979,Dani Ceballos,es ESP,MF,28-278,11.3,35,19,15,15,5,16,29,55.2,13,15,3,12,13,48,10,2,Matches,Real-Madrid,La-Liga
980,Ferland Mendy,fr FRA,DF,29-338,11.2,17,14,7,6,4,9,12,75.0,3,11,4,7,9,26,8,1,Matches,Real-Madrid,La-Liga
981,Eduardo Camavinga,fr FRA,"MF,DF",22-183,12.2,42,26,23,16,3,19,33,57.6,14,24,8,16,18,60,23,0,Matches,Real-Madrid,La-Liga
982,Arda Güler,tr TUR,"MF,FW",20-076,11.0,23,12,9,6,8,7,18,38.9,11,15,0,15,5,28,8,0,Matches,Real-Madrid,La-Liga
983,Éder Militão,br BRA,DF,27-114,10.4,19,17,14,5,0,7,12,58.3,5,13,8,5,12,31,35,0,Matches,Real-Madrid,La-Liga
984,Dani Carvajal,es ESP,DF,33-121,6.8,12,8,7,3,2,9,12,75.0,3,8,3,5,10,22,19,1,Matches,Real-Madrid,La-Liga
985,Andriy Lunin,ua UKR,GK,26-090,5.0,0,0,0,0,0,0,0,,0,0,0,0,0,0,2,0,Matches,Real-Madrid,La-Liga
986,David Alaba,at AUT,DF,32-322,3.5,1,0,1,0,0,0,0,,0,5,5,0,6,7,7,0,Matches,Real-Madrid,La-Liga
987,Endrick,br BRA,FW,18-295,2.6,1,1,1,0,0,1,3,33.3,2,0,0,0,3,4,1,0,Matches,Real-Madrid,La-Liga
988,Fran,es ESP,GK,19-322,1.0,0,0,0,0,0,0,0,,0,0,0,0,0,0,2,0,Matches,Real-Madrid,La-Liga
989,Jacobo Ramón,es ESP,DF,20-126,0.3,2,1,2,0,0,1,1,100.0,0,0,0,0,0,2,0,0,Matches,Real-Madrid,La-Liga
990,Jesús Vallejo,es ESP,DF,28-127,0.1,0,0,0,0,0,0,0,,0,0,0,0,0,0,2,0,Matches,Real-Madrid,La-Liga
991,Chema,es ESP,MF,20-017,0.1,0,0,0,0,0,0,0,,0,0,0,0,0,0,1,0,Matches,Real-Madrid,La-Liga
992,Lorenzo Aguado,es ESP,DF,22-235,0.1,0,0,0,0,0,0,0,,0,0,0,0,0,0,2,0,Matches,Real-Madrid,La-Liga
993,Víctor Muñoz,es ESP,MF,21-303,0.0,0,0,0,0,0,0,0,,0,0,0,0,0,0,0,0,Matches,Real-Madrid,La-Liga
994,Daniel Yáñez,es ESP,FW,18-045,0.0,0,0,0,0,0,0,0,,0,0,0,0,0,0,0,0,Matches,Real-Madrid,La-Liga
995,Álex Remiro,es ESP,GK,30-049,34.0,1,0,1,0,0,1,2,50.0,1,0,0,0,0,1,17,4,Matches,Real-Sociedad,La-Liga
996,Martín Zubimendi,es ESP,MF,26-099,30.7,72,37,31,29,12,28,44,63.6,16,40,16,24,40,112,76,3,Matches,Real-Sociedad,La-Liga
997,Sergio Gómez,es ESP,"MF,DF",24-250,28.6,70,39,29,29,12,30,55,54.5,25,42,2,40,18,88,28,2,Matches,Real-Sociedad,La-Liga
998,Jon Aramburu,ve VEN,DF,22-293,25.7,94,67,55,29,10,62,95,65.3,33,35,8,27,28,122,96,0,Matches,Real-Sociedad,La-Liga
999,Mikel Oyarzabal,es ESP,"FW,MF",28-021,22.8,21,13,7,9,5,9,18,50.0,9,15,1,14,4,25,14,0,Matches,Real-Sociedad,La-Liga
1000,Igor Zubeldia,es ESP,DF,28-043,23.2,33,22,21,9,3,14,26,53.8,12,31,18,13,25,58,91,2,Matches,Real-Sociedad,La-Liga
1001,Takefusa Kubo,jp JPN,"MF,FW",23-342,23.4,30,19,10,11,9,16,37,43.2,21,33,1,32,13,43,13,1,Matches,Real-Sociedad,La-Liga
1002,Nayef Aguerd,ma MAR,DF,29-043,19.6,30,24,17,12,1,12,18,66.7,6,21,15,6,13,43,91,0,Matches,Real-Sociedad,La-Liga
1003,Javi López,es ESP,DF,23-048,20.5,39,23,22,12,5,22,36,61.1,14,21,7,14,8,47,57,1,Matches,Real-Sociedad,La-Liga
1004,Luka Sučić,hr CRO,MF,22-246,18.5,24,17,7,12,5,9,24,37.5,15,29,2,27,13,37,15,1,Matches,Real-Sociedad,La-Liga
1005,Brais Méndez,es ESP,MF,28-125,15.5,21,13,6,11,4,8,22,36.4,14,13,1,12,7,28,16,1,Matches,Real-Sociedad,La-Liga
1006,Aritz Elustondo,es ESP,DF,31-045,14.2,18,10,13,3,2,9,17,52.9,8,16,12,4,9,27,88,0,Matches,Real-Sociedad,La-Liga
1007,Ander Barrenetxea,es ESP,"MF,FW",23-136,12.8,23,16,7,11,5,5,21,23.8,16,15,0,15,11,34,15,1,Matches,Real-Sociedad,La-Liga
1008,Pablo Marín,es ESP,MF,21-313,11.6,21,14,5,11,5,7,15,46.7,8,12,3,9,4,25,13,0,Matches,Real-Sociedad,La-Liga
1009,Sheraldo Becker,sr SUR,"FW,MF",30-092,11.1,3,2,0,3,0,0,2,0.0,2,4,0,4,1,4,10,0,Matches,Real-Sociedad,La-Liga
1010,Aihen Muñoz,es ESP,DF,27-269,10.3,23,12,13,8,2,13,27,48.1,14,10,6,4,13,36,45,0,Matches,Real-Sociedad,La-Liga
1011,Beñat Turrientes,es ESP,MF,23-101,9.4,14,6,4,9,1,4,14,28.6,10,14,2,12,5,19,12,0,Matches,Real-Sociedad,La-Liga
1012,Orri Steinn Óskarsson,is ISL,FW,20-256,10.5,6,6,2,1,3,2,8,25.0,6,10,1,9,2,8,11,0,Matches,Real-Sociedad,La-Liga
1013,Jon Pacheco,es ESP,DF,24-124,8.5,13,9,10,3,0,8,10,80.0,2,8,6,2,8,21,45,2,Matches,Real-Sociedad,La-Liga
1014,Olasagasti,es ESP,MF,24-269,9.0,19,9,5,9,5,7,17,41.2,10,8,2,6,14,33,10,0,Matches,Real-Sociedad,La-Liga
1015,Hamari Traoré,ml MLI,DF,33-105,6.4,18,11,9,7,2,14,19,73.7,5,4,1,3,8,26,18,0,Matches,Real-Sociedad,La-Liga
1016,Jon Martin,es ESP,DF,19-131,9.0,10,8,6,3,1,6,9,66.7,3,12,8,4,7,17,68,1,Matches,Real-Sociedad,La-Liga
1017,Umar Sadiq,ng NGA,FW,28-099,2.5,2,1,1,1,0,1,2,50.0,1,3,1,2,1,3,2,0,Matches,Real-Sociedad,La-Liga
1018,Unai Marrero,es ESP,GK,23-215,1.0,0,0,0,0,0,0,0,,0,0,0,0,0,0,1,0,Matches,Real-Sociedad,La-Liga
1019,Arsen Zakharyan,ru RUS,"MF,FW",21-351,0.8,1,1,1,0,0,1,1,100.0,0,1,1,0,1,2,0,0,Matches,Real-Sociedad,La-Liga
1020,Urko González,es ESP,MF,24-053,0.5,0,0,0,0,0,0,0,,0,1,1,0,0,0,0,0,Matches,Real-Sociedad,La-Liga
1021,Arkaitz Mariezkurrena,es ESP,"MF,FW",20-037,1.7,1,0,1,0,0,0,4,0.0,4,1,0,1,1,2,3,0,Matches,Real-Sociedad,La-Liga
1022,Álvaro Odriozola,es ESP,DF,29-149,0.5,1,1,1,0,0,0,0,,0,0,0,0,0,1,1,0,Matches,Real-Sociedad,La-Liga
1023,Daniel Díaz,es ESP,MF,18-324,0.1,1,1,1,0,0,0,0,,0,1,0,1,0,1,0,0,Matches,Real-Sociedad,La-Liga
1024,Luken Beitia,es ESP,DF,20-316,0.1,1,1,1,0,0,1,1,100.0,0,0,0,0,0,1,2,0,Matches,Real-Sociedad,La-Liga
1025,Jon Magunazelaia,es ESP,MF,24-303,0.1,1,1,1,0,0,0,0,,0,0,0,0,0,1,0,0,Matches,Real-Sociedad,La-Liga
1026,Dodi Lukebakio,be BEL,FW,27-230,32.4,21,13,8,8,5,14,26,53.8,12,16,0,16,7,28,16,2,Matches,Sevilla,La-Liga
1027,Carmona,es ESP,DF,23-103,30.0,77,55,48,21,8,37,70,52.9,33,32,10,22,63,140,88,3,Matches,Sevilla,La-Liga
1028,Loïc Bade,fr FRA,DF,25-031,28.7,43,25,33,10,0,21,29,72.4,8,19,11,8,29,72,154,2,Matches,Sevilla,La-Liga
1029,Ørjan Nyland,no NOR,GK,34-244,27.7,3,2,3,0,0,3,5,60.0,2,0,0,0,0,3,11,4,Matches,Sevilla,La-Liga
1030,Adrià Pedrosa,es ESP,DF,26-364,24.1,55,32,33,16,6,30,53,56.6,23,40,9,31,21,76,81,0,Matches,Sevilla,La-Liga
1031,Isaac Romero,es ESP,FW,24-359,23.9,13,7,4,4,5,3,16,18.8,13,18,1,17,7,20,27,0,Matches,Sevilla,La-Liga
1032,Nemanja Gudelj,rs SRB,"DF,MF",33-177,25.3,39,21,13,22,4,20,32,62.5,12,26,10,16,25,64,85,1,Matches,Sevilla,La-Liga
1033,Kike Salas,es ESP,DF,23-019,22.4,44,26,23,15,6,24,40,60.0,16,23,12,11,31,75,133,0,Matches,Sevilla,La-Liga
1034,Djibril Sow,ch SUI,MF,28-095,20.7,21,12,11,9,1,7,16,43.8,9,15,2,13,22,43,25,1,Matches,Sevilla,La-Liga
1035,Lucien Agoume,fr FRA,MF,23-092,20.5,59,25,18,32,9,21,31,67.7,10,25,9,16,35,94,35,0,Matches,Sevilla,La-Liga
1036,Saúl Ñíguez,es ESP,MF,30-172,17.1,47,32,16,24,7,12,30,40.0,18,25,2,23,22,69,33,0,Matches,Sevilla,La-Liga
1037,Juanlu Sánchez,es ESP,"MF,DF",21-270,16.5,38,27,22,13,3,27,45,60.0,18,19,0,19,12,50,15,0,Matches,Sevilla,La-Liga
1038,Albert Sambi Lokonga,be BEL,MF,25-202,15.6,21,15,10,9,2,10,13,76.9,3,12,1,11,9,30,24,3,Matches,Sevilla,La-Liga
1039,Peque,es ESP,"MF,FW",22-220,12.1,16,5,4,10,2,7,16,43.8,9,16,0,16,8,24,5,0,Matches,Sevilla,La-Liga
1040,Chidera Ejuke,ng NGA,FW,27-130,10.7,19,13,8,9,2,9,20,45.0,11,12,0,12,5,24,8,0,Matches,Sevilla,La-Liga
1041,Ruben Vargas,ch SUI,"FW,MF",26-280,7.5,7,4,1,5,1,3,8,37.5,5,9,0,9,3,10,10,0,Matches,Sevilla,La-Liga
1042,Álvaro Fernández,es ESP,GK,27-029,7.3,0,0,0,0,0,0,1,0.0,1,0,0,0,0,0,7,0,Matches,Sevilla,La-Liga
1043,Tanguy Nianzou,fr FRA,DF,22-339,5.8,7,5,6,0,1,5,6,83.3,1,1,0,1,8,15,27,0,Matches,Sevilla,La-Liga
1044,Marcão,br BRA,DF,28-341,5.1,9,6,6,3,0,2,3,66.7,1,9,6,3,6,15,27,1,Matches,Sevilla,La-Liga
1045,Kelechi Iheanacho,ng NGA,FW,28-221,4.4,1,0,0,1,0,1,3,33.3,2,0,0,0,0,1,1,0,Matches,Sevilla,La-Liga
1046,Jesús Navas,es ESP,"FW,MF",39-172,4.7,5,2,3,0,2,0,3,0.0,3,1,0,1,4,9,6,0,Matches,Sevilla,La-Liga
1047,Valentín Barco,ar ARG,"DF,FW",20-293,3.2,15,9,8,3,4,12,15,80.0,3,0,0,0,2,17,5,0,Matches,Sevilla,La-Liga
1048,Stanis Idumbo,be BEL,"FW,MF",19-317,3.2,9,5,3,4,2,3,5,60.0,2,3,1,2,4,13,2,0,Matches,Sevilla,La-Liga
1049,Ramón Martínez,es ESP,DF,22-202,2.1,5,3,4,1,0,2,3,66.7,1,2,1,1,2,7,17,0,Matches,Sevilla,La-Liga
1050,Lucas Ocampos,ar ARG,FW,30-305,1.9,3,2,2,0,1,1,2,50.0,1,2,0,2,0,3,2,0,Matches,Sevilla,La-Liga
1051,Suso,es ESP,"FW,MF",31-174,3.9,5,3,2,3,0,2,6,33.3,4,3,0,3,2,7,0,0,Matches,Sevilla,La-Liga
1052,Álvaro Pascual,es ESP,FW,23-131,2.5,1,0,0,0,1,1,2,50.0,1,0,0,0,2,3,0,0,Matches,Sevilla,La-Liga
1053,Akor Adams,ng NGA,FW,25-103,1.5,0,0,0,0,0,0,0,,0,1,0,1,0,0,1,0,Matches,Sevilla,La-Liga
1054,Manu Bueno,es ESP,"MF,FW",20-289,1.3,4,3,0,1,3,1,2,50.0,1,0,0,0,0,4,2,0,Matches,Sevilla,La-Liga
1055,Gonzalo Montiel,ar ARG,"DF,MF",28-131,1.3,4,2,3,1,0,3,4,75.0,1,0,0,0,2,6,11,0,Matches,Sevilla,La-Liga
1056,Diego Iturralde,es ESP,FW,22-026,0.4,0,0,0,0,0,0,0,,0,0,0,0,1,1,1,0,Matches,Sevilla,La-Liga
1057,Israel Domínguez,es ESP,FW,22-005,0.2,0,0,0,0,0,0,0,,0,0,0,0,0,0,0,0,Matches,Sevilla,La-Liga
1058,Leandro Antonetti,pr PUR,FW,22-119,0.1,0,0,0,0,0,0,0,,0,0,0,0,0,0,0,0,Matches,Sevilla,La-Liga
1059,Mateo Mejía,es ESP,FW,22-042,0.1,0,0,0,0,0,0,0,,0,0,0,0,0,0,0,0,Matches,Sevilla,La-Liga
1060,Darío Fuentes,es ESP,DF,22-120,0.1,0,0,0,0,0,0,0,,0,0,0,0,0,0,0,0,Matches,Sevilla,La-Liga
1061,Cristhian Mosquera,es ESP,DF,20-319,33.9,48,30,36,11,1,27,36,75.0,9,32,22,10,34,82,120,4,Matches,Valencia,La-Liga
1062,Diego López,es ESP,"MF,FW",22-364,28.3,28,17,9,15,4,16,46,34.8,30,25,0,25,13,41,14,0,Matches,Valencia,La-Liga
1063,Giorgi Mamardashvili,ge GEO,GK,24-225,31.0,2,2,2,0,0,2,3,66.7,1,0,0,0,1,3,13,3,Matches,Valencia,La-Liga
1064,César Tárrega,es ESP,DF,23-075,30.6,47,36,31,13,3,18,29,62.1,11,38,19,19,21,68,208,2,Matches,Valencia,La-Liga
1065,Luis Rioja,es ESP,"MF,FW",31-208,29.2,31,20,13,12,6,13,40,32.5,27,29,1,28,22,53,41,0,Matches,Valencia,La-Liga
1066,Javier Guerra,es ESP,MF,22-131,26.9,46,24,16,19,11,23,50,46.0,27,14,2,12,19,65,47,2,Matches,Valencia,La-Liga
1067,Dimitri Foulquier,fr FRA,DF,32-050,25.5,48,31,29,13,6,24,36,66.7,12,21,5,16,16,64,86,1,Matches,Valencia,La-Liga
1068,Hugo Duro,es ESP,FW,25-183,22.8,12,7,4,7,1,4,12,33.3,8,11,2,9,10,22,11,0,Matches,Valencia,La-Liga
1069,Enzo Barrenechea,ar ARG,MF,23-355,21.3,52,29,21,25,6,30,42,71.4,12,25,7,18,25,77,46,1,Matches,Valencia,La-Liga
1070,Domingos André Ribeiro Almeida,pt POR,"MF,FW",24-347,20.2,46,30,17,20,9,14,34,41.2,20,19,2,17,8,54,14,1,Matches,Valencia,La-Liga
1071,José Luis Gayà,es ESP,DF,29-352,18.1,55,38,38,14,3,40,57,70.2,17,14,2,12,21,76,54,0,Matches,Valencia,La-Liga
1072,José Luis García Vayá,es ESP,MF,26-274,18.3,41,23,22,13,6,18,31,58.1,13,20,6,14,16,57,40,0,Matches,Valencia,La-Liga
1073,Yarek Gasiorowski,es ESP,DF,20-120,10.5,19,16,16,3,0,9,13,69.2,4,17,6,11,26,45,60,0,Matches,Valencia,La-Liga
1074,Jesus Vazquez,es ESP,DF,22-130,9.2,20,16,11,7,2,8,17,47.1,9,15,5,10,7,27,28,0,Matches,Valencia,La-Liga
1075,Thierry Correia,pt POR,DF,26-064,8.5,27,18,19,5,3,13,23,56.5,10,10,1,9,4,31,18,0,Matches,Valencia,La-Liga
1076,Umar Sadiq,ng NGA,FW,28-099,7.5,9,5,2,5,2,4,6,66.7,2,5,0,5,1,10,6,0,Matches,Valencia,La-Liga
1077,Dani Gómez,es ESP,FW,26-286,5.9,3,2,0,0,3,0,0,,0,1,0,1,2,5,4,0,Matches,Valencia,La-Liga
1078,Rafa Mir,es ESP,"FW,MF",27-328,7.0,10,6,6,4,0,2,8,25.0,6,4,0,4,4,14,9,0,Matches,Valencia,La-Liga
1079,Mouctar Diakhaby,gn GUI,DF,28-144,4.4,5,1,5,0,0,3,5,60.0,2,6,5,1,3,8,41,0,Matches,Valencia,La-Liga
1080,Hugo Guillamón,es ESP,MF,25-101,4.0,11,8,1,9,1,9,10,90.0,1,4,1,3,5,16,9,1,Matches,Valencia,La-Liga
1081,Stole Dimitrievski,mk MKD,GK,31-138,4.0,0,0,0,0,0,0,0,,0,0,0,0,0,0,3,1,Matches,Valencia,La-Liga
1082,Francisco Perez,es ESP,"FW,MF",22-245,5.5,16,12,7,7,2,10,16,62.5,6,8,1,7,3,19,6,0,Matches,Valencia,La-Liga
1083,Sergi Canós,es ESP,"MF,FW",28-099,4.0,11,7,3,4,4,4,10,40.0,6,5,1,4,5,16,4,0,Matches,Valencia,La-Liga
1084,Ivan Jaime Pajuelo,es ESP,MF,24-228,2.4,4,2,1,1,2,2,3,66.7,1,1,0,1,2,6,0,0,Matches,Valencia,La-Liga
1085,Germán Valera,es ESP,MF,23-057,1.6,1,1,1,0,0,0,1,0.0,1,2,0,2,4,5,2,1,Matches,Valencia,La-Liga
1086,Max Aarons,eng ENG,"DF,MF",25-128,1.2,3,3,2,1,0,3,3,100.0,0,1,0,1,0,3,3,0,Matches,Valencia,La-Liga
1087,Maximiliano Caufriez,be BEL,DF,28-085,1.0,1,1,1,0,0,1,1,100.0,0,2,1,1,1,2,4,0,Matches,Valencia,La-Liga
1088,Rodrigo Abajas,es ESP,DF,22-000,0.7,3,2,2,1,0,3,3,100.0,0,1,0,1,1,4,0,0,Matches,Valencia,La-Liga
1089,Martín Tejón,es ESP,"MF,DF",21-030,0.5,2,0,0,2,0,1,2,50.0,1,0,0,0,0,2,0,0,Matches,Valencia,La-Liga
1090,Iker Córdoba,es ESP,DF,19-182,0.2,0,0,0,0,0,0,0,,0,0,0,0,0,0,1,0,Matches,Valencia,La-Liga
1091,David Otorbi,es ESP,MF,17-208,0.2,0,0,0,0,0,0,0,,0,1,0,1,0,0,0,0,Matches,Valencia,La-Liga
1092,Alberto Marí,es ESP,FW,23-305,0.1,0,0,0,0,0,0,0,,0,0,0,0,0,0,0,0,Matches,Valencia,La-Liga
1093,Karl Jakob Hein,ee EST,GK,23-029,28.0,0,0,0,0,0,0,2,0.0,2,0,0,0,0,0,17,1,Matches,Valladolid,La-Liga
1094,Luis Pérez,es ESP,DF,30-097,27.9,38,27,23,10,5,24,40,60.0,16,26,9,17,28,66,85,0,Matches,Valladolid,La-Liga
1095,Javi Sánchez,es ESP,DF,28-059,22.5,26,16,19,6,1,17,26,65.4,9,39,28,11,22,48,111,3,Matches,Valladolid,La-Liga
1096,Raúl Moro,es ESP,"MF,FW",22-158,23.0,21,13,15,3,3,12,29,41.4,17,6,0,6,10,31,17,1,Matches,Valladolid,La-Liga
1097,Lucas Oliveira Rosa,br BRA,DF,25-039,21.0,53,33,40,11,2,35,51,68.6,16,24,9,15,28,81,69,2,Matches,Valladolid,La-Liga
1098,Stanko Jurić,hr CRO,MF,28-269,19.2,48,24,26,19,3,19,48,39.6,29,35,11,24,24,72,52,0,Matches,Valladolid,La-Liga
1099,Eray Cömert,ch SUI,"DF,MF",27-097,17.8,21,12,13,8,0,11,18,61.1,7,27,15,12,21,42,64,1,Matches,Valladolid,La-Liga
1100,Mario Martín,es ESP,MF,21-068,17.9,59,30,29,27,3,20,45,44.4,25,28,6,22,19,78,39,7,Matches,Valladolid,La-Liga
1101,Anuar,ma MAR,"MF,FW",30-117,16.8,35,24,20,10,5,13,26,50.0,13,22,7,15,15,50,19,1,Matches,Valladolid,La-Liga
1102,Selim Amallah,ma MAR,MF,28-178,14.8,29,17,10,17,2,10,18,55.6,8,22,1,21,14,43,5,1,Matches,Valladolid,La-Liga
1103,Mamadou Sylla,sn SEN,"FW,MF",31-053,16.5,6,3,2,2,2,2,8,25.0,6,6,0,6,3,9,12,1,Matches,Valladolid,La-Liga
1104,David Torres,es ESP,DF,22-068,15.4,13,8,12,1,0,7,11,63.6,4,19,17,2,10,23,74,0,Matches,Valladolid,La-Liga
1105,Kike Pérez,es ESP,MF,28-087,13.2,37,26,15,19,3,15,26,57.7,11,16,4,12,7,44,18,0,Matches,Valladolid,La-Liga
1106,Marcos André,br BRA,FW,28-204,13.2,10,6,3,5,2,5,13,38.5,8,18,2,16,3,13,10,0,Matches,Valladolid,La-Liga
1107,Iván Sánchez,es ESP,"MF,FW",32-231,14.3,35,19,17,9,9,12,27,44.4,15,18,3,15,13,48,10,0,Matches,Valladolid,La-Liga
1108,Juanmi Latasa,es ESP,FW,24-050,13.0,4,2,1,1,2,2,5,40.0,3,4,1,3,0,4,10,1,Matches,Valladolid,La-Liga
1109,Juma Bah,sl SLE,DF,19-031,9.6,10,7,7,3,0,3,5,60.0,2,15,8,7,12,22,60,0,Matches,Valladolid,La-Liga
1110,Antonio Candela,it ITA,DF,25-015,8.6,9,6,6,2,1,4,9,44.4,5,10,6,4,6,15,26,0,Matches,Valladolid,La-Liga
1111,Adam Aznou,ma MAR,DF,18-344,8.5,25,19,19,6,0,19,37,51.4,18,21,7,14,9,34,25,0,Matches,Valladolid,La-Liga
1112,Chuky san jose,es ESP,MF,21-013,7.8,8,2,3,3,2,2,9,22.2,7,4,1,3,0,8,4,0,Matches,Valladolid,La-Liga
1113,Tamás Nikitscher,hu HUN,MF,25-190,7.3,16,7,8,8,0,7,11,63.6,4,11,2,9,9,25,10,0,Matches,Valladolid,La-Liga
1114,Darwin Machís,ve VEN,"MF,FW",32-094,7.1,5,4,3,2,0,3,9,33.3,6,3,0,3,5,10,13,0,Matches,Valladolid,La-Liga
1115,André Ferreira,pt POR,GK,28-348,6.0,0,0,0,0,0,0,0,,0,0,0,0,0,0,4,2,Matches,Valladolid,La-Liga
1116,Cenk Özkacar,tr TUR,DF,24-218,5.9,7,3,6,1,0,2,7,28.6,5,6,4,2,12,19,54,1,Matches,Valladolid,La-Liga
1117,Florian Grillitsch,at AUT,MF,29-278,5.7,8,6,5,3,0,5,13,38.5,8,10,1,9,4,12,5,1,Matches,Valladolid,La-Liga
1118,Joseph Aidoo,gh GHA,DF,29-225,6.0,5,5,3,2,0,2,3,66.7,1,6,3,3,4,9,22,1,Matches,Valladolid,La-Liga
1119,Amath,sn SEN,"FW,DF",28-300,3.9,2,0,2,0,0,1,7,14.3,6,7,1,6,2,4,6,0,Matches,Valladolid,La-Liga
1120,Enzo Boyomo,cm CMR,DF,23-217,3.0,6,2,4,2,0,3,3,100.0,0,4,3,1,1,7,7,0,Matches,Valladolid,La-Liga
1121,Víctor Meseguer,es ESP,MF,25-337,4.6,10,6,4,4,2,2,10,20.0,8,3,0,3,2,12,4,1,Matches,Valladolid,La-Liga
1122,Henrique,br BRA,DF,31-017,2.2,3,2,2,1,0,0,3,0.0,3,5,0,5,2,5,5,0,Matches,Valladolid,La-Liga
1123,Raúl Chasco,es ESP,DF,21-241,1.4,4,1,3,1,0,2,4,50.0,2,1,0,1,2,6,2,0,Matches,Valladolid,La-Liga
1124,Arnau Rafús,es ESP,GK,22-015,1.0,0,0,0,0,0,0,0,,0,0,0,0,0,0,0,1,Matches,Valladolid,La-Liga
1125,Mario Maroto,es ESP,MF,21-165,0.2,0,0,0,0,0,0,1,0.0,1,0,0,0,2,2,1,0,Matches,Valladolid,La-Liga
1126,Adrian Baquerin,es ESP,FW,18-069,0.1,0,0,0,0,0,0,0,,0,0,0,0,0,0,1,0,Matches,Valladolid,La-Liga
1127,Kenedy,br BRA,"MF,FW",29-093,0.1,0,0,0,0,0,0,0,,0,1,0,1,0,0,0,0,Matches,Valladolid,La-Liga
1128,Sergi Cardona,es ESP,DF,25-308,31.5,67,45,41,19,7,46,74,62.2,28,50,7,43,35,102,116,1,Matches,Villarreal,La-Liga
1129,Santi Comesaña,es ESP,MF,28-219,27.1,84,48,43,32,9,41,71,57.7,30,50,18,32,19,103,50,1,Matches,Villarreal,La-Liga
1130,Alex Baena,es ESP,MF,23-296,26.2,27,14,6,13,8,10,34,29.4,24,28,2,26,21,48,21,2,Matches,Villarreal,La-Liga
1131,Kiko Femenía,es ESP,DF,34-099,24.7,50,34,34,14,2,33,57,57.9,24,21,10,11,40,90,62,3,Matches,Villarreal,La-Liga
1132,Logan Costa,cv CPV,DF,24-041,25.7,35,19,22,12,1,22,25,88.0,3,20,11,9,17,52,102,1,Matches,Villarreal,La-Liga
1133,Thierno Barry,fr FRA,FW,22-203,24.3,11,8,2,5,4,4,10,40.0,6,15,2,13,0,11,18,0,Matches,Villarreal,La-Liga
1134,Daniel Parejo,es ESP,MF,36-026,23.7,49,38,25,19,5,27,49,55.1,22,22,6,16,24,73,35,1,Matches,Villarreal,La-Liga
1135,Pape Gueye,sn SEN,MF,26-108,22.5,53,26,22,23,8,20,27,74.1,7,29,11,18,24,77,50,1,Matches,Villarreal,La-Liga
1136,Yeremi Pino,es ESP,MF,22-204,19.2,52,27,16,28,8,27,54,50.0,27,35,3,32,8,60,17,0,Matches,Villarreal,La-Liga
1137,Diego Conde,es ESP,GK,26-196,20.8,2,2,2,0,0,2,4,50.0,2,0,0,0,1,3,9,2,Matches,Villarreal,La-Liga
1138,Ayoze Pérez,es ESP,FW,31-287,20.5,24,12,5,15,4,6,22,27.3,16,17,0,17,7,31,14,0,Matches,Villarreal,La-Liga
1139,Juan Foyth,ar ARG,DF,27-120,14.9,24,15,15,5,4,10,15,66.7,5,22,13,9,17,41,102,3,Matches,Villarreal,La-Liga
1140,Luiz Lúcio Reis Júnior,br BRA,GK,24-118,14.2,0,0,0,0,0,0,0,,0,0,0,0,0,0,14,1,Matches,Villarreal,La-Liga
1141,Raúl Albiol,es ESP,DF,39-250,13.2,10,9,9,1,0,6,10,60.0,4,10,9,1,6,16,69,1,Matches,Villarreal,La-Liga
1142,Nicolas Pépé,ci CIV,"FW,MF",29-348,14.6,19,8,9,6,4,5,12,41.7,7,10,1,9,5,24,10,0,Matches,Villarreal,La-Liga
1143,Willy Kambwala,fr FRA,DF,20-260,10.6,14,9,11,2,1,7,8,87.5,1,7,5,2,8,22,46,1,Matches,Villarreal,La-Liga
1144,Eric Bailly,ci CIV,DF,31-030,6.9,12,4,6,6,0,3,4,75.0,1,12,6,6,6,18,29,0,Matches,Villarreal,La-Liga
1145,Ilias Akhomach,ma MAR,"MF,FW",21-026,6.5,12,7,4,4,4,6,12,50.0,6,8,0,8,3,15,13,0,Matches,Villarreal,La-Liga
1146,Gerard Moreno,es ESP,FW,33-035,7.5,7,4,3,2,2,3,11,27.3,8,0,0,0,2,9,7,0,Matches,Villarreal,La-Liga
1147,Denis Suárez,es ESP,MF,31-126,5.9,9,7,7,1,1,4,9,44.4,5,4,1,3,1,10,3,0,Matches,Villarreal,La-Liga
1148,Pau Navarro,es ESP,DF,20-017,8.0,19,14,11,6,2,16,28,57.1,12,13,6,7,3,22,33,0,Matches,Villarreal,La-Liga
1149,Tajon Buchanan,ca CAN,MF,26-093,3.3,7,4,5,2,0,5,8,62.5,3,4,0,4,1,8,1,0,Matches,Villarreal,La-Liga
1150,Arnaut Danjuma,nl NED,FW,28-101,2.2,2,1,0,1,1,0,1,0.0,1,1,0,1,0,2,0,0,Matches,Villarreal,La-Liga
1151,Alfonso Pedraza,es ESP,"DF,MF",29-033,3.3,3,2,2,0,1,2,4,50.0,2,2,1,1,4,7,11,0,Matches,Villarreal,La-Liga
1152,Juan Bernat,es ESP,"DF,MF",32-072,2.4,9,7,7,1,1,4,5,80.0,1,3,1,2,1,10,4,0,Matches,Villarreal,La-Liga
1153,Ramón Terrats,es ESP,"MF,FW",24-206,1.5,3,3,1,2,0,2,4,50.0,2,3,1,2,2,5,3,0,Matches,Villarreal,La-Liga
1154,Pau Cabanes,es ESP,"MF,FW",20-084,1.8,4,4,0,3,1,3,4,75.0,1,5,0,5,3,7,2,1,Matches,Villarreal,La-Liga
1155,Arnau Solà,es ESP,MF,22-038,0.1,0,0,0,0,0,0,2,0.0,2,1,1,0,0,0,0,0,Matches,Villarreal,La-Liga
1156,Karl Etta,cm CMR,"FW,MF",21-210,0.1,0,0,0,0,0,0,0,,0,0,0,0,0,0,0,0,Matches,Villarreal,La-Liga
1157,Thiago Ojeda,ar ARG,MF,22-120,0.1,0,0,0,0,0,0,0,,0,0,0,0,0,0,1,0,Matches,Villarreal,La-Liga
1158,Marco Carnesecchi,it ITA,GK,24-315,32.0,0,0,0,0,0,0,0,,0,1,0,1,0,0,23,2,Matches,Atalanta,Serie-A
1159,Marten de Roon,nl NED,"MF,DF",34-044,32.0,68,42,29,36,3,24,59,40.7,35,36,7,29,44,112,58,1,Matches,Atalanta,Serie-A
1160,Éderson,br BRA,MF,25-309,30.5,50,30,18,27,5,21,31,67.7,10,29,6,23,35,85,34,1,Matches,Atalanta,Serie-A
1161,Berat Djimsiti,al ALB,DF,32-082,27.3,49,30,26,22,1,28,38,73.7,10,31,18,13,36,85,113,2,Matches,Atalanta,Serie-A
1162,Mateo Retegui,it ITA,FW,26-013,23.5,14,9,0,9,5,3,15,20.0,12,6,0,6,2,16,15,0,Matches,Atalanta,Serie-A
1163,Ademola Lookman,ng NGA,"MF,FW",27-204,23.5,31,14,9,14,8,10,18,55.6,8,18,0,18,2,33,5,1,Matches,Atalanta,Serie-A
1164,Isak Hien,se SWE,DF,26-119,24.9,48,28,27,21,0,27,43,62.8,16,30,17,13,29,77,79,2,Matches,Atalanta,Serie-A
1165,Raoul Bellanova,it ITA,DF,24-360,24.6,23,13,8,12,3,12,20,60.0,8,12,3,9,18,41,42,0,Matches,Atalanta,Serie-A
1166,Davide Zappacosta,it ITA,DF,32-335,21.8,26,16,15,5,6,20,39,51.3,19,27,6,21,11,37,29,2,Matches,Atalanta,Serie-A
1167,Sead Kolašinac,ba BIH,DF,31-326,21.1,41,26,21,20,0,16,30,53.3,14,16,7,9,25,66,53,1,Matches,Atalanta,Serie-A
1168,Charles De Ketelaere,be BEL,"MF,FW",24-063,21.1,12,8,2,8,2,4,13,30.8,9,12,3,9,3,15,8,0,Matches,Atalanta,Serie-A
1169,Mario Pašalić,hr CRO,MF,30-092,20.6,24,15,10,12,2,11,25,44.0,14,19,4,15,12,36,26,1,Matches,Atalanta,Serie-A
1170,Matteo Ruggeri,it ITA,DF,22-305,17.7,38,23,15,13,10,25,35,71.4,10,27,3,24,16,54,39,1,Matches,Atalanta,Serie-A
1171,Odilon Kossounou,ci CIV,DF,24-128,9.5,12,7,7,4,1,4,9,44.4,5,12,3,9,9,21,15,0,Matches,Atalanta,Serie-A
1172,Marco Brescianini,it ITA,MF,25-112,9.6,16,10,4,8,4,7,9,77.8,2,14,1,13,2,18,5,0,Matches,Atalanta,Serie-A
1173,Juan Cuadrado,co COL,"DF,MF",36-351,9.0,19,9,9,6,4,11,23,47.8,12,14,2,12,7,26,9,0,Matches,Atalanta,Serie-A
1174,Lazar Samardzic,rs SRB,"MF,FW",23-077,11.7,18,12,4,6,8,10,21,47.6,11,8,1,7,2,20,6,0,Matches,Atalanta,Serie-A
1175,Stefan Posch,at AUT,DF,27-363,3.8,14,10,5,6,3,7,8,87.5,1,5,1,4,4,18,13,0,Matches,Atalanta,Serie-A
1176,Giorgio Scalvini,it ITA,DF,21-152,3.0,8,4,5,3,0,5,9,55.6,4,0,0,0,4,12,7,0,Matches,Atalanta,Serie-A
1177,Rafael Tolói,it ITA,DF,34-214,5.2,10,5,3,5,2,4,11,36.4,7,8,2,6,8,18,11,0,Matches,Atalanta,Serie-A
1178,Rui Patrício,pt POR,GK,37-086,2.0,0,0,0,0,0,0,0,,0,0,0,0,0,0,3,0,Matches,Atalanta,Serie-A
1179,Ibrahim Sulemana,gh GHA,MF,21-355,1.4,5,2,2,3,0,1,3,33.3,2,1,0,1,0,5,1,0,Matches,Atalanta,Serie-A
1180,Juan Musso,ar ARG,GK,31-006,1.0,0,0,0,0,0,0,0,,0,0,0,0,0,0,0,0,Matches,Atalanta,Serie-A
1181,Nicolò Zaniolo,it ITA,"FW,MF",25-314,4.0,0,0,0,0,0,0,2,0.0,2,0,0,0,1,1,0,0,Matches,Atalanta,Serie-A
1182,Daniel Maldini,it ITA,"FW,MF",23-213,1.5,1,1,0,0,1,1,2,50.0,1,1,0,1,0,1,0,0,Matches,Atalanta,Serie-A
1183,Marco Palestra,it ITA,DF,20-070,1.2,5,4,3,2,0,3,3,100.0,0,2,0,2,0,5,3,0,Matches,Atalanta,Serie-A
1184,Vanja Vlahović,rs SRB,"FW,MF",21-050,0.7,1,1,0,0,1,0,0,,0,0,0,0,0,1,0,0,Matches,Atalanta,Serie-A
1185,Ben Godfrey,eng ENG,DF,27-117,0.3,0,0,0,0,0,0,1,0.0,1,1,1,0,0,0,0,0,Matches,Atalanta,Serie-A
1186,Mitchel Bakker,nl NED,MF,24-326,0.2,1,0,1,0,0,1,1,100.0,0,0,0,0,0,1,0,0,Matches,Atalanta,Serie-A
1187,Federico Cassa,it ITA,"MF,FW",19-100,0.2,0,0,0,0,0,0,0,,0,1,0,1,0,0,0,0,Matches,Atalanta,Serie-A
1188,Alberto Manzoni,it ITA,MF,19-321,0.1,0,0,0,0,0,0,0,,0,0,0,0,0,0,0,0,Matches,Atalanta,Serie-A
1189,Gianluca Scamacca,it ITA,FW,26-131,0.1,0,0,0,0,0,0,0,,0,0,0,0,0,0,0,0,Matches,Atalanta,Serie-A
1190,Remo Freuler,ch SUI,MF,33-027,33.8,77,40,28,40,9,33,78,42.3,45,37,4,33,38,115,56,1,Matches,Bologna,Serie-A
1191,Sam Beukema,nl NED,DF,26-176,33.5,54,29,27,24,3,22,41,53.7,19,36,21,15,30,84,111,0,Matches,Bologna,Serie-A
1192,Jhon Lucumí,co COL,DF,26-320,27.0,48,28,22,26,0,27,39,69.2,12,32,14,18,24,72,87,7,Matches,Bologna,Serie-A
1193,Łukasz Skorupski,pl POL,GK,34-007,25.3,1,0,1,0,0,1,3,33.3,2,0,0,0,0,1,11,2,Matches,Bologna,Serie-A
1194,Santiago Castro,ar ARG,FW,20-225,24.4,18,10,4,9,5,6,17,35.3,11,13,2,11,3,21,19,0,Matches,Bologna,Serie-A
1195,Juan Miranda,es ESP,DF,25-113,24.3,32,18,11,14,7,14,30,46.7,16,21,3,18,21,53,47,1,Matches,Bologna,Serie-A
1196,Dan Ndoye,ch SUI,FW,24-199,21.8,22,16,8,6,8,13,23,56.5,10,19,0,19,8,30,4,0,Matches,Bologna,Serie-A
1197,Jens Odgaard,dk DEN,"MF,FW",26-042,21.7,20,14,3,12,5,6,21,28.6,15,19,2,17,9,29,12,1,Matches,Bologna,Serie-A
1198,Riccardo Orsolini,it ITA,FW,28-108,19.5,14,12,5,5,4,4,10,40.0,6,25,0,25,8,22,10,1,Matches,Bologna,Serie-A
1199,Benjamín Domínguez,ar ARG,FW,21-235,13.8,18,7,2,11,5,6,20,30.0,14,15,1,14,4,22,7,0,Matches,Bologna,Serie-A
1200,Nikola Moro,hr CRO,MF,27-061,13.3,35,27,7,21,7,22,33,66.7,11,18,7,11,13,48,18,0,Matches,Bologna,Serie-A
1201,Tommaso Pobega,it ITA,MF,25-301,12.6,32,19,12,14,6,21,29,72.4,8,15,4,11,13,45,16,0,Matches,Bologna,Serie-A
1202,Lorenzo De Silvestri,it ITA,DF,36-354,11.3,11,6,7,1,3,7,16,43.8,9,12,4,8,10,21,31,0,Matches,Bologna,Serie-A
1203,Thijs Dallinga,nl NED,FW,24-282,12.3,10,5,0,4,6,3,3,100.0,0,10,1,9,1,11,13,1,Matches,Bologna,Serie-A
1204,Emil Holm,se SWE,DF,24-364,12.0,34,21,17,14,3,20,30,66.7,10,19,4,15,10,44,50,1,Matches,Bologna,Serie-A
1205,Charalambos Lykogiannis,gr GRE,DF,31-202,10.8,21,12,13,7,1,10,20,50.0,10,9,5,4,10,31,34,1,Matches,Bologna,Serie-A
1206,Federico Ravaglia,it ITA,GK,25-182,10.7,0,0,0,0,0,0,0,,0,0,0,0,0,0,7,0,Matches,Bologna,Serie-A
1207,Giovanni Fabbian,it ITA,MF,22-118,10.6,10,6,1,3,6,7,13,53.8,6,7,2,5,2,12,4,0,Matches,Bologna,Serie-A
1208,Lewis Ferguson,sct SCO,MF,25-261,8.9,20,10,3,12,5,7,13,53.8,6,7,2,5,4,24,9,0,Matches,Bologna,Serie-A
1209,Michel Aebischer,ch SUI,MF,28-126,7.5,17,12,7,7,3,9,13,69.2,4,4,1,3,6,23,6,0,Matches,Bologna,Serie-A
1210,Nicolò Casale,it ITA,DF,27-087,8.0,7,4,4,3,0,3,7,42.9,4,11,7,4,13,20,40,2,Matches,Bologna,Serie-A
1211,Stefan Posch,at AUT,DF,27-363,7.9,26,15,12,9,5,15,25,60.0,10,19,4,15,5,31,22,0,Matches,Bologna,Serie-A
1212,Davide Calabria,it ITA,DF,28-157,6.0,12,8,5,5,2,5,11,45.5,6,3,0,3,1,13,19,1,Matches,Bologna,Serie-A
1213,Martin Erlic,hr CRO,DF,27-108,3.7,2,0,0,2,0,1,2,50.0,1,5,4,1,2,4,9,0,Matches,Bologna,Serie-A
1214,Nicolò Cambiaghi,it ITA,FW,24-135,5.9,15,9,5,7,3,4,9,44.4,5,8,0,8,2,17,2,0,Matches,Bologna,Serie-A
1215,Jesper Karlsson,se SWE,FW,26-291,3.3,1,0,0,0,1,0,2,0.0,2,4,0,4,0,1,3,0,Matches,Bologna,Serie-A
1216,Kacper Urbanski,pl POL,MF,20-247,2.7,5,2,4,0,1,4,6,66.7,2,5,1,4,2,7,5,0,Matches,Bologna,Serie-A
1217,Samuel Iling-Junior,eng ENG,"FW,MF",21-220,1.3,3,2,1,1,1,0,1,0.0,1,1,0,1,2,5,2,0,Matches,Bologna,Serie-A
1218,Oussama El Azzouzi,ma MAR,MF,23-348,0.2,0,0,0,0,0,0,0,,0,0,0,0,2,2,0,0,Matches,Bologna,Serie-A
1219,Estanis,es ESP,FW,21-261,0.1,0,0,0,0,0,0,0,,0,0,0,0,0,0,0,0,Matches,Bologna,Serie-A
1220,Roberto Piccoli,it ITA,FW,24-105,32.7,13,9,2,6,5,3,9,33.3,6,12,4,8,3,16,29,0,Matches,Cagliari,Serie-A
1221,Sebastiano Luperto,it ITA,DF,28-248,34.0,45,24,29,15,1,16,26,61.5,10,27,13,14,31,76,152,1,Matches,Cagliari,Serie-A
1222,Gabriele Zappa,it ITA,DF,25-141,32.0,37,21,19,16,2,16,31,51.6,15,39,21,18,23,60,85,1,Matches,Cagliari,Serie-A
1223,Nadir Zortea,it ITA,"DF,MF",25-327,28.6,29,13,15,12,2,13,34,38.2,21,10,0,10,17,46,44,2,Matches,Cagliari,Serie-A
1224,Yerry Mina,co COL,DF,30-231,26.5,59,27,38,19,2,36,47,76.6,11,54,31,23,33,92,155,3,Matches,Cagliari,Serie-A
1225,Tommaso Augello,it ITA,DF,30-255,28.3,48,27,27,17,4,29,41,70.7,12,22,7,15,16,64,101,1,Matches,Cagliari,Serie-A
1226,Michel Ndary Adopo,fr FRA,MF,24-297,24.8,52,31,15,29,8,14,26,53.8,12,20,5,15,26,78,22,0,Matches,Cagliari,Serie-A
1227,Antoine Makoumbou,cg CGO,MF,26-298,22.5,39,23,27,9,3,18,24,75.0,6,25,4,21,14,53,25,0,Matches,Cagliari,Serie-A
1228,Zito Luvumbo,ao ANG,"FW,MF",23-064,17.2,10,6,4,3,3,6,19,31.6,13,5,0,5,4,14,4,0,Matches,Cagliari,Serie-A
1229,Elia Caprile,it ITA,GK,23-260,17.0,0,0,0,0,0,0,2,0.0,2,0,0,0,0,0,9,1,Matches,Cagliari,Serie-A
1230,Nicolas Viola,it ITA,"FW,MF",35-212,13.4,14,7,6,7,1,1,10,10.0,9,4,0,4,3,17,5,0,Matches,Cagliari,Serie-A
1231,Alessandro Deiola,it ITA,MF,29-284,14.1,27,17,7,17,3,9,29,31.0,20,25,12,13,12,39,34,0,Matches,Cagliari,Serie-A
1232,Răzvan Marin,ro ROU,MF,28-354,15.1,21,12,8,11,2,13,25,52.0,12,6,0,6,2,23,20,2,Matches,Cagliari,Serie-A
1233,Simone Scuffet,it ITA,GK,28-346,13.0,0,0,0,0,0,0,1,0.0,1,0,0,0,0,0,8,2,Matches,Cagliari,Serie-A
1234,Adam Obert,sk SVK,DF,22-262,11.8,30,17,12,17,1,15,26,57.7,11,19,7,12,23,53,48,2,Matches,Cagliari,Serie-A
1235,José Luis Palomino,ar ARG,DF,35-127,11.6,27,15,16,9,2,15,20,75.0,5,20,10,10,22,49,46,0,Matches,Cagliari,Serie-A
1236,Mattia Felici,it ITA,"MF,FW",24-025,10.3,17,12,8,7,2,4,11,36.4,7,10,0,10,7,24,7,1,Matches,Cagliari,Serie-A
1237,Gianluca Gaetano,it ITA,"MF,FW",25-007,10.8,9,6,3,5,1,4,14,28.6,10,8,0,8,5,14,8,0,Matches,Cagliari,Serie-A
1238,Matteo Prati,it ITA,MF,21-135,6.1,10,4,2,7,1,3,11,27.3,8,5,2,3,7,17,10,1,Matches,Cagliari,Serie-A
1239,Alen Sherri,al ALB,GK,27-148,6.0,1,0,1,0,0,1,2,50.0,1,0,0,0,0,1,1,0,Matches,Cagliari,Serie-A
1240,Paulo Azzi,br BRA,DF,30-301,4.7,11,9,3,6,2,5,9,55.6,4,5,2,3,5,16,11,0,Matches,Cagliari,Serie-A
1241,Florinel Coman,ro ROU,"FW,MF",27-032,2.9,5,3,3,1,1,2,2,100.0,0,2,0,2,1,6,3,0,Matches,Cagliari,Serie-A
1242,Leonardo Pavoletti,it ITA,"FW,MF",36-167,4.9,1,0,0,1,0,0,0,,0,4,1,3,0,1,3,0,Matches,Cagliari,Serie-A
1243,Gianluca Lapadula,pe PER,"FW,MF",35-094,3.4,2,0,1,0,1,0,1,0.0,1,0,0,0,0,2,1,0,Matches,Cagliari,Serie-A
1244,Mateusz Wieteska,pl POL,DF,28-090,2.0,1,0,0,1,0,1,1,100.0,0,3,2,1,7,8,6,0,Matches,Cagliari,Serie-A
1245,Kingstone Mutandwa,zm ZAM,"MF,FW",22-127,1.0,0,0,0,0,0,0,0,,0,0,0,0,0,0,0,0,Matches,Cagliari,Serie-A
1246,Gabriel Strefezza,br BRA,"FW,MF",28-024,27.1,56,39,20,20,16,21,54,38.9,33,24,2,22,13,69,23,0,Matches,Como,Serie-A
1247,Marc-Oliver Kempf,de GER,DF,30-104,28.1,30,20,15,14,1,13,24,54.2,11,31,22,9,32,62,129,3,Matches,Como,Serie-A
1248,Nicolás Paz,ar ARG,"MF,FW",20-246,28.0,50,32,18,25,7,24,49,49.0,25,45,3,42,19,69,15,0,Matches,Como,Serie-A
1249,Lucas Da Cunha,fr FRA,MF,23-337,27.0,40,21,14,17,9,18,34,52.9,16,16,3,13,15,55,29,1,Matches,Como,Serie-A
1250,Edoardo Goldaniga,it ITA,DF,31-191,27.1,33,20,20,8,5,12,17,70.6,5,19,9,10,29,62,97,3,Matches,Como,Serie-A
1251,Patrick Cutrone,it ITA,FW,27-129,22.0,16,11,0,10,6,7,14,50.0,7,11,0,11,4,20,7,0,Matches,Como,Serie-A
1252,Alberto Dossena,it ITA,DF,26-211,20.3,33,20,23,8,2,16,28,57.1,12,22,11,11,22,55,89,1,Matches,Como,Serie-A
1253,Alberto Moreno,es ESP,DF,32-311,18.3,24,11,16,8,0,12,25,48.0,13,12,3,9,14,38,36,2,Matches,Como,Serie-A
1254,Alieu Fadera,gm GAM,"FW,DF",23-190,18.3,64,47,25,27,12,20,45,44.4,25,18,1,17,12,76,10,0,Matches,Como,Serie-A
1255,Máximo Perrone,ar ARG,MF,22-125,19.1,36,25,18,13,5,12,37,32.4,25,13,1,12,18,54,38,0,Matches,Como,Serie-A
1256,Jean Butez,fr FRA,GK,29-338,17.0,0,0,0,0,0,0,2,0.0,2,0,0,0,0,0,16,1,Matches,Como,Serie-A
1257,Assane Diao,sn SEN,"FW,MF",19-247,13.9,25,14,9,10,6,12,28,42.9,16,8,1,7,3,28,19,0,Matches,Como,Serie-A
1258,Maxence Caqueret,fr FRA,MF,25-086,10.9,33,18,13,18,2,18,34,52.9,16,13,1,12,6,39,4,1,Matches,Como,Serie-A
1259,Ignace Van Der Brempt,be BEL,DF,23-041,12.4,39,31,27,10,2,23,31,74.2,8,11,5,6,16,55,31,0,Matches,Como,Serie-A
1260,Yannik Engelhardt,de GER,"MF,DF",24-094,12.5,28,11,12,13,3,15,26,57.7,11,12,5,7,11,39,27,0,Matches,Como,Serie-A
1261,Pepe Reina,es ESP,GK,42-254,11.0,0,0,0,0,0,0,1,0.0,1,0,0,0,0,0,3,2,Matches,Como,Serie-A
1262,Álex Valle,es ESP,DF,21-017,10.3,24,12,10,12,2,14,19,73.7,5,12,2,10,7,31,39,0,Matches,Como,Serie-A
1263,Emil Audero,id IDN,GK,28-114,8.0,0,0,0,0,0,0,1,0.0,1,0,0,0,0,0,4,1,Matches,Como,Serie-A
1264,Sergi Roberto,es ESP,MF,33-094,7.7,14,8,5,5,4,5,7,71.4,2,7,1,6,9,23,14,0,Matches,Como,Serie-A
1265,Mërgim Vojvoda,xk KVX,DF,30-100,6.6,7,5,3,4,0,6,8,75.0,2,6,4,2,2,9,16,0,Matches,Como,Serie-A
1266,Andrea Belotti,it ITA,FW,31-143,6.6,7,5,1,4,2,1,4,25.0,3,4,0,4,1,8,8,0,Matches,Como,Serie-A
1267,Ivan Smolčić,hr CRO,DF,24-268,6.0,15,9,8,6,1,9,12,75.0,3,8,2,6,10,25,22,0,Matches,Como,Serie-A
1268,Jonathan Ikone,fr FRA,FW,27-010,5.6,15,9,4,3,8,6,11,54.5,5,5,1,4,0,15,1,1,Matches,Como,Serie-A
1269,Federico Barba,it ITA,DF,31-253,4.8,2,2,1,1,0,1,4,25.0,3,2,2,0,4,6,15,0,Matches,Como,Serie-A
1270,Anastasios Douvikas,gr GRE,FW,25-283,5.2,3,2,0,3,0,1,3,33.3,2,3,0,3,1,4,2,0,Matches,Como,Serie-A
1271,Alessio Iovine,it ITA,"DF,FW",34-100,4.2,5,2,2,3,0,4,10,40.0,6,7,1,6,3,8,21,1,Matches,Como,Serie-A
1272,Luca Mazzitelli,it ITA,MF,29-178,3.7,9,6,4,5,0,5,7,71.4,2,5,2,3,3,12,10,0,Matches,Como,Serie-A
1273,Matthias Braunöder,at AUT,MF,23-046,3.0,10,4,6,3,1,7,11,63.6,4,3,0,3,2,12,4,1,Matches,Como,Serie-A
1274,Marco Sala,it ITA,DF,25-342,2.9,9,6,5,3,1,5,8,62.5,3,2,0,2,1,10,9,0,Matches,Como,Serie-A
1275,Fellipe Jack,br BRA,DF,19-120,1.9,9,4,8,1,0,3,5,60.0,2,2,2,0,4,13,5,0,Matches,Como,Serie-A
1276,Daniele Baselli,it ITA,MF,33-061,0.2,0,0,0,0,0,0,0,,0,0,0,0,1,1,1,0,Matches,Como,Serie-A
1277,Alessandro Gabrielloni,it ITA,"FW,MF",30-306,1.6,0,0,0,0,0,0,3,0.0,3,0,0,0,0,0,1,0,Matches,Como,Serie-A
1278,Simone Verdi,it ITA,"MF,FW",32-304,1.3,2,2,0,1,1,0,2,0.0,2,2,0,2,0,2,2,0,Matches,Como,Serie-A
1279,Alberto Cerri,it ITA,FW,29-026,1.0,0,0,0,0,0,0,0,,0,2,0,2,0,0,1,0,Matches,Como,Serie-A
1280,Ben Lhassine Kone,ci CIV,MF,25-059,0.6,2,2,1,0,1,2,3,66.7,1,0,0,0,1,3,1,0,Matches,Como,Serie-A
1281,Ali Jasim,iq IRQ,"FW,DF",21-112,0.1,1,0,1,0,0,1,1,100.0,0,0,0,0,0,1,0,0,Matches,Como,Serie-A
1282,Dele Alli,eng ENG,MF,29-031,0.1,0,0,0,0,0,0,0,,0,0,0,0,0,0,0,0,Matches,Como,Serie-A
1283,Oliver Abildgaard,dk DEN,MF,28-336,0.1,0,0,0,0,0,0,0,,0,1,0,1,0,0,0,0,Matches,Como,Serie-A
1284,Emmanuel Gyasi,gh GHA,"DF,FW",31-121,33.9,51,28,31,14,6,24,36,66.7,12,23,8,15,11,62,76,0,Matches,Empoli,Serie-A
1285,Giuseppe Pezzella,it ITA,"DF,FW",27-164,30.0,53,30,28,17,8,28,55,50.9,27,31,8,23,15,68,106,1,Matches,Empoli,Serie-A
1286,Devis Vásquez,co COL,GK,27-000,30.0,0,0,0,0,0,0,0,,0,0,0,0,0,0,20,4,Matches,Empoli,Serie-A
1287,Saba Goglichidze,ge GEO,DF,20-321,26.8,63,37,35,25,3,25,50,50.0,25,34,16,18,33,96,92,3,Matches,Empoli,Serie-A
1288,Mattia Viti,it ITA,DF,23-108,26.6,62,43,41,18,3,33,50,66.0,17,38,17,21,47,109,115,4,Matches,Empoli,Serie-A
1289,Ardian Ismajli,al ALB,DF,28-224,25.9,27,21,20,7,0,14,17,82.4,3,31,22,9,51,78,232,3,Matches,Empoli,Serie-A
1290,Lorenzo Colombo,it ITA,"FW,MF",23-065,24.0,29,13,7,15,7,6,20,30.0,14,32,2,30,2,31,16,1,Matches,Empoli,Serie-A
1291,Liam Henderson,sct SCO,MF,29-017,24.8,41,21,17,21,3,21,51,41.2,30,19,5,14,15,56,41,0,Matches,Empoli,Serie-A
1292,Sebastiano Esposito,it ITA,"FW,MF",22-314,24.2,54,28,15,29,10,15,31,48.4,16,20,2,18,12,66,14,0,Matches,Empoli,Serie-A
1293,Alberto Grassi,it ITA,MF,30-066,22.5,39,21,16,18,5,14,21,66.7,7,22,12,10,32,71,43,1,Matches,Empoli,Serie-A
1294,Liberato Cacace,nz NZL,"DF,MF",24-227,23.1,36,24,20,12,4,22,31,71.0,9,25,8,17,22,58,57,0,Matches,Empoli,Serie-A
1295,Youssef Maleh,ma MAR,MF,26-263,16.8,45,23,17,23,5,17,34,50.0,17,25,6,19,16,61,25,0,Matches,Empoli,Serie-A
1296,Jacopo Fazzini,it ITA,MF,22-057,13.5,32,19,11,16,5,13,22,59.1,9,12,1,11,6,38,23,0,Matches,Empoli,Serie-A
1297,Faustino Anjorin,eng ENG,MF,23-170,11.8,27,12,7,14,6,9,18,50.0,9,17,3,14,11,38,20,0,Matches,Empoli,Serie-A
1298,Luca Marianucci,it ITA,DF,20-293,11.4,28,12,17,11,0,11,19,57.9,8,15,8,7,18,46,62,1,Matches,Empoli,Serie-A
1299,Ola Solbakken,no NOR,"MF,FW",26-247,8.3,7,4,0,6,1,3,6,50.0,3,0,0,0,2,9,8,0,Matches,Empoli,Serie-A
1300,Mattia De Sciglio,it ITA,DF,32-204,8.5,18,13,10,8,0,14,17,82.4,3,10,3,7,8,26,35,1,Matches,Empoli,Serie-A
1301,Christian Kouamé,ci CIV,"FW,MF",27-157,5.6,5,4,0,3,2,2,4,50.0,2,4,2,2,0,5,4,0,Matches,Empoli,Serie-A
1302,Marco Silvestri,it ITA,GK,34-071,5.0,0,0,0,0,0,0,2,0.0,2,0,0,0,0,0,3,1,Matches,Empoli,Serie-A
1303,Pietro Pellegri,it ITA,FW,24-056,4.6,7,2,0,6,1,2,4,50.0,2,2,0,2,0,7,3,0,Matches,Empoli,Serie-A
1304,Junior Sambia,fr FRA,"DF,FW",28-247,4.2,13,9,3,5,5,10,10,100.0,0,3,0,3,2,15,5,0,Matches,Empoli,Serie-A
1305,Nicolas Haas,ch SUI,MF,29-109,3.2,11,8,4,5,2,5,9,55.6,4,2,1,1,4,15,6,0,Matches,Empoli,Serie-A
1306,Sebastian Walukiewicz,pl POL,DF,25-037,2.0,1,0,1,0,0,0,1,0.0,1,3,3,0,1,2,15,0,Matches,Empoli,Serie-A
1307,Jacopo Seghetti,it ITA,GK,20-084,1.0,0,0,0,0,0,0,0,,0,0,0,0,0,0,0,0,Matches,Empoli,Serie-A
1308,Emmanuel Ekong,se SWE,"MF,FW",22-321,2.1,4,3,0,2,2,3,3,100.0,0,2,1,1,1,5,1,0,Matches,Empoli,Serie-A
1309,Ismael Konate,ci CIV,"FW,MF",19-044,1.2,4,2,4,0,0,2,3,66.7,1,3,2,1,0,4,1,0,Matches,Empoli,Serie-A
1310,Szymon Żurkowski,pl POL,MF,27-229,1.2,6,4,2,4,0,4,4,100.0,0,3,0,3,1,7,2,0,Matches,Empoli,Serie-A
1311,Viktor Kovalenko,ua UKR,MF,29-087,0.9,2,1,0,2,0,0,1,0.0,1,0,0,0,0,2,0,0,Matches,Empoli,Serie-A
1312,Tyronne Ebuehi,ng NGA,"DF,MF",29-147,0.7,2,1,0,2,0,1,1,100.0,0,1,0,1,2,4,0,0,Matches,Empoli,Serie-A
1313,Jacopo Bacci,it ITA,MF,19-327,0.3,1,0,1,0,0,1,1,100.0,0,0,0,0,1,2,1,0,Matches,Empoli,Serie-A
1314,Thomas Campaniello,it ITA,FW,17-072,0.3,0,0,0,0,0,0,2,0.0,2,0,0,0,0,0,0,0,Matches,Empoli,Serie-A
1315,Francesco Caputo,it ITA,FW,37-279,0.1,0,0,0,0,0,0,0,,0,0,0,0,0,0,0,0,Matches,Empoli,Serie-A
1316,Petar Stojanović,si SVN,MF,29-217,0.0,0,0,0,0,0,0,0,,0,0,0,0,0,0,0,0,Matches,Empoli,Serie-A
1317,Lorenzo Tosto,it ITA,DF,19-103,0.0,0,0,0,0,0,0,0,,0,0,0,0,0,0,0,0,Matches,Empoli,Serie-A
1318,David de Gea,es ESP,GK,34-186,32.0,1,0,1,0,0,1,1,100.0,0,0,0,0,0,1,12,0,Matches,Fiorentina,Serie-A
1319,Dodô,br BRA,DF,26-176,31.6,41,28,23,10,8,23,45,51.1,22,21,5,16,33,74,56,2,Matches,Fiorentina,Serie-A
1320,Luca Ranieri,it ITA,DF,26-019,31.1,37,21,26,9,2,18,22,81.8,4,43,31,12,25,62,142,1,Matches,Fiorentina,Serie-A
1321,Moise Kean,it ITA,FW,25-073,28.0,7,5,1,2,4,3,4,75.0,1,12,0,12,5,12,24,1,Matches,Fiorentina,Serie-A
1322,Robin Gosens,de GER,DF,30-311,25.1,53,31,30,15,8,25,42,59.5,17,29,9,20,16,69,88,0,Matches,Fiorentina,Serie-A
1323,Danilo Cataldi,it ITA,MF,30-279,19.2,25,16,13,10,2,14,27,51.9,13,17,8,9,22,47,35,0,Matches,Fiorentina,Serie-A
1324,Pietro Comuzzo,it ITA,DF,20-081,23.2,41,20,27,11,3,21,27,77.8,6,33,20,13,27,68,107,4,Matches,Fiorentina,Serie-A
1325,Lucas Beltrán,ar ARG,"MF,FW",24-044,19.8,20,10,8,7,5,6,19,31.6,13,15,2,13,4,24,14,0,Matches,Fiorentina,Serie-A
1326,Rolando Mandragora,it ITA,MF,27-317,18.5,20,11,9,9,2,12,28,42.9,16,22,7,15,13,33,53,1,Matches,Fiorentina,Serie-A
1327,Andrea Colpani,it ITA,"FW,MF",26-001,15.9,15,9,5,7,3,4,12,33.3,8,6,0,6,9,24,10,0,Matches,Fiorentina,Serie-A
1328,Albert Guðmundsson,is ISL,"FW,MF",27-331,13.9,9,5,2,4,3,7,17,41.2,10,5,0,5,6,15,9,1,Matches,Fiorentina,Serie-A
1329,Yacine Adli,fr FRA,MF,24-287,13.4,32,19,11,16,5,17,38,44.7,21,12,1,11,6,38,19,0,Matches,Fiorentina,Serie-A
1330,Marin Pongračić,hr CRO,DF,27-243,13.7,17,12,13,3,1,7,10,70.0,3,14,6,8,11,28,65,2,Matches,Fiorentina,Serie-A
1331,Edoardo Bove,it ITA,"MF,FW",22-361,9.5,24,17,7,14,3,14,28,50.0,14,12,0,12,6,30,8,0,Matches,Fiorentina,Serie-A
1332,Fabiano Parisi,it ITA,"DF,MF",24-184,11.4,26,16,11,11,4,11,19,57.9,8,14,2,12,15,41,15,0,Matches,Fiorentina,Serie-A
1333,Pablo Marí,es ESP,DF,31-254,9.2,9,4,8,1,0,4,9,44.4,5,13,9,4,19,28,78,0,Matches,Fiorentina,Serie-A
1334,Riccardo Sottil,it ITA,"FW,MF",25-343,9.3,5,4,3,1,1,3,4,75.0,1,1,0,1,4,9,3,0,Matches,Fiorentina,Serie-A
1335,Amir Richardson,ma MAR,MF,23-108,9.7,24,11,12,10,2,9,19,47.4,10,11,1,10,5,29,27,1,Matches,Fiorentina,Serie-A
1336,Nicolò Fagioli,it ITA,MF,24-089,7.7,16,9,8,7,1,8,21,38.1,13,7,1,6,4,20,9,2,Matches,Fiorentina,Serie-A
1337,Michael Folorunsho,it ITA,"FW,MF",27-094,6.9,19,12,9,6,4,8,20,40.0,12,9,1,8,4,23,10,0,Matches,Fiorentina,Serie-A
1338,Christian Kouamé,ci CIV,"FW,MF",27-157,6.9,13,8,4,4,5,0,3,0.0,3,3,1,2,2,15,10,0,Matches,Fiorentina,Serie-A
1339,Cristiano Biraghi,it ITA,DF,32-253,4.8,4,4,1,3,0,2,7,28.6,5,2,0,2,4,8,11,0,Matches,Fiorentina,Serie-A
1340,Lucas Martínez Quarta,ar ARG,DF,29-002,3.9,12,7,9,3,0,8,13,61.5,5,5,2,3,3,15,25,1,Matches,Fiorentina,Serie-A
1341,Nicolò Zaniolo,it ITA,FW,25-314,3.8,3,1,1,2,0,0,4,0.0,4,2,1,1,0,3,2,0,Matches,Fiorentina,Serie-A
1342,Cher Ndour,it ITA,"MF,DF",20-289,3.7,3,0,2,1,0,1,8,12.5,7,4,1,3,2,5,7,1,Matches,Fiorentina,Serie-A
1343,Pietro Terracciano,it ITA,GK,35-065,3.0,0,0,0,0,0,0,0,,0,0,0,0,0,0,0,0,Matches,Fiorentina,Serie-A
1344,Sofyan Amrabat,ma MAR,MF,28-264,2.0,3,2,1,2,0,2,2,100.0,0,1,1,0,0,3,2,0,Matches,Fiorentina,Serie-A
1345,Matias Moreno,ar ARG,DF,21-230,1.6,8,8,5,3,0,4,4,100.0,0,5,1,4,1,9,9,0,Matches,Fiorentina,Serie-A
1346,Jonathan Ikone,fr FRA,"FW,MF",27-010,3.7,5,2,3,2,0,2,4,50.0,2,3,0,3,1,6,1,0,Matches,Fiorentina,Serie-A
1347,Michael Kayode,it ITA,"DF,FW",20-306,1.4,1,1,1,0,0,0,0,,0,3,1,2,2,3,7,0,Matches,Fiorentina,Serie-A
1348,Antonín Barák,cz CZE,MF,30-160,0.6,2,0,0,2,0,0,2,0.0,2,1,1,0,0,2,0,0,Matches,Fiorentina,Serie-A
1349,Alessandro Bianco,it ITA,MF,22-223,0.2,0,0,0,0,0,0,1,0.0,1,0,0,0,0,0,0,0,Matches,Fiorentina,Serie-A
1350,Maat Daniel Caprini,it ITA,FW,19-090,0.1,0,0,0,0,0,0,0,,0,0,0,0,0,0,0,0,Matches,Fiorentina,Serie-A
1351,Tommaso Rubino,it ITA,MF,18-183,0.1,0,0,0,0,0,0,1,0.0,1,0,0,0,0,0,0,0,Matches,Fiorentina,Serie-A
1352,Morten Frendrup,dk DEN,MF,24-035,33.5,102,61,23,52,27,34,77,44.2,43,61,16,45,47,149,56,0,Matches,Genoa,Serie-A
1353,Johan Vásquez,mx MEX,DF,26-202,33.4,54,29,23,26,5,25,43,58.1,18,59,31,28,49,103,147,1,Matches,Genoa,Serie-A
1354,Aarón Martín,es ESP,DF,28-020,32.3,70,46,40,26,4,32,48,66.7,16,31,10,21,19,89,68,1,Matches,Genoa,Serie-A
1355,Andrea Pinamonti,it ITA,FW,25-358,30.8,9,5,0,7,2,1,7,14.3,6,16,4,12,1,10,28,2,Matches,Genoa,Serie-A
1356,Nicola Leali,it ITA,GK,32-084,28.0,0,0,0,0,0,0,0,,0,0,0,0,0,0,14,1,Matches,Genoa,Serie-A
1357,Koni De Winter,be BEL,DF,22-334,22.1,33,19,21,8,4,17,24,70.8,7,10,6,4,23,56,106,3,Matches,Genoa,Serie-A
1358,Stefano Sabelli,it ITA,DF,32-119,21.8,56,30,26,25,5,19,52,36.5,33,28,7,21,21,77,62,0,Matches,Genoa,Serie-A
1359,Morten Thorsby,no NOR,MF,29-007,20.9,47,30,18,19,10,15,27,55.6,12,22,1,21,5,52,28,0,Matches,Genoa,Serie-A
1360,Fabio Miretti,it ITA,"MF,FW",21-282,18.6,28,15,6,14,8,18,33,54.5,15,20,1,19,7,35,13,2,Matches,Genoa,Serie-A
1361,Milan Badelj,hr CRO,MF,36-076,15.6,28,15,14,9,5,15,35,42.9,20,18,6,12,18,46,42,0,Matches,Genoa,Serie-A
1362,Alessandro Zanoli,it ITA,"FW,DF",24-221,18.7,28,20,11,13,4,9,22,40.9,13,20,3,17,12,40,40,0,Matches,Genoa,Serie-A
1363,Mattia Bani,it ITA,DF,31-153,15.1,18,9,11,5,2,7,11,63.6,4,12,8,4,19,37,77,2,Matches,Genoa,Serie-A
1364,Patrizio Masini,it ITA,MF,24-105,15.1,49,27,18,22,9,17,37,45.9,20,22,7,15,13,62,37,0,Matches,Genoa,Serie-A
1365,Vitinha,pt POR,"FW,MF",25-058,13.2,20,5,11,4,5,10,28,35.7,18,13,2,11,11,31,20,0,Matches,Genoa,Serie-A
1366,Alan Matturro,uy URU,DF,20-213,10.0,11,6,6,5,0,3,14,21.4,11,10,3,7,14,25,38,0,Matches,Genoa,Serie-A
1367,Alessandro Vogliacco,it ITA,DF,26-240,7.9,15,3,7,7,1,10,12,83.3,2,11,7,4,9,24,20,0,Matches,Genoa,Serie-A
1368,Junior Messias,br BRA,"MF,FW",33-364,8.4,12,7,6,5,1,3,8,37.5,5,7,2,5,6,18,15,0,Matches,Genoa,Serie-A
1369,Pierluigi Gollini,it ITA,GK,30-055,7.0,0,0,0,0,0,0,0,,0,1,0,1,0,0,2,1,Matches,Genoa,Serie-A
1370,Jeff Ekhator,it ITA,"FW,MF",18-182,8.2,7,4,4,1,2,4,8,50.0,4,10,1,9,2,9,5,0,Matches,Genoa,Serie-A
1371,Brooke Norton-Cuffy,eng ENG,"DF,FW",21-120,6.1,11,6,8,3,0,8,9,88.9,1,9,0,9,3,14,12,0,Matches,Genoa,Serie-A
1372,Ruslan Malinovskyi,ua UKR,"MF,FW",32-008,4.3,12,8,4,7,1,3,6,50.0,3,2,0,2,1,13,4,0,Matches,Genoa,Serie-A
1373,Caleb Ekuban,gh GHA,FW,31-050,5.7,3,3,1,1,1,1,1,100.0,0,4,1,3,1,4,5,0,Matches,Genoa,Serie-A
1374,Honest Ahanor,it ITA,"DF,MF",17-078,3.0,6,4,2,2,2,6,9,66.7,3,3,0,3,1,7,8,0,Matches,Genoa,Serie-A
1375,Maxwel Cornet,ci CIV,"FW,MF",28-227,2.6,2,1,1,0,1,0,1,0.0,1,1,1,0,2,4,1,0,Matches,Genoa,Serie-A
1376,Lior Kasa,il ISR,"MF,FW",19-227,2.6,4,4,2,2,0,2,5,40.0,3,4,1,3,3,7,5,0,Matches,Genoa,Serie-A
1377,Sebastian Otoa,dk DEN,DF,20-364,1.0,0,0,0,0,0,0,1,0.0,1,0,0,0,1,1,5,0,Matches,Genoa,Serie-A
1378,Jean Onana,cm CMR,MF,25-124,2.1,9,6,2,7,0,4,7,57.1,3,3,0,3,2,11,8,1,Matches,Genoa,Serie-A
1379,Emil Bohinen,no NOR,MF,26-061,1.8,4,4,3,0,1,2,5,40.0,3,2,0,2,1,5,6,0,Matches,Genoa,Serie-A
1380,Benjamin Siegrist,ch SUI,GK,33-101,1.0,0,0,0,0,0,0,0,,0,0,0,0,0,0,1,0,Matches,Genoa,Serie-A
1381,Filippo Melegoni,it ITA,"MF,FW",26-083,1.0,1,1,1,0,0,0,4,0.0,4,0,0,0,0,1,2,0,Matches,Genoa,Serie-A
1382,Alessandro Marcandalli,it ITA,DF,22-229,0.5,1,0,1,0,0,0,0,,0,0,0,0,0,1,2,0,Matches,Genoa,Serie-A
1383,Lorenzo Venturino,it ITA,"FW,MF",18-324,1.2,3,2,2,0,1,1,3,33.3,2,1,0,1,0,3,3,0,Matches,Genoa,Serie-A
1384,Mario Balotelli,it ITA,"FW,MF",34-273,0.7,0,0,0,0,0,0,0,,0,0,0,0,0,0,1,0,Matches,Genoa,Serie-A
1385,David Akpan Ankeye,ng NGA,"FW,MF",23-087,0.5,0,0,0,0,0,0,1,0.0,1,0,0,0,0,0,1,0,Matches,Genoa,Serie-A
1386,Gastón Pereiro,uy URU,MF,29-335,0.3,1,0,0,1,0,1,1,100.0,0,0,0,0,0,1,1,0,Matches,Genoa,Serie-A
1387,Federico Accornero,it ITA,MF,21-096,0.1,0,0,0,0,0,0,0,,0,0,0,0,0,0,0,0,Matches,Genoa,Serie-A
1388,Lorenzo Montipò,it ITA,GK,29-081,35.0,1,0,1,0,0,1,4,25.0,3,0,0,0,0,1,21,4,Matches,Hellas-Verona,Serie-A
1389,Jackson Tchatchoua,cm CMR,"DF,MF",23-240,33.2,49,31,34,12,3,27,42,64.3,15,20,9,11,12,61,69,2,Matches,Hellas-Verona,Serie-A
1390,Diego Coppola,it ITA,DF,21-135,30.5,65,35,47,14,4,27,39,69.2,12,41,24,17,69,134,170,2,Matches,Hellas-Verona,Serie-A
1391,Ondrej Duda,sk SVK,MF,30-158,25.6,44,26,20,21,3,30,63,47.6,33,26,8,18,31,75,30,4,Matches,Hellas-Verona,Serie-A
1392,Tomáš Suslov,sk SVK,"MF,FW",22-339,22.5,52,36,21,24,7,21,69,30.4,48,29,2,27,18,70,17,1,Matches,Hellas-Verona,Serie-A
1393,Amin Sarr,se SWE,FW,24-062,19.6,21,12,3,8,10,5,9,55.6,4,17,3,14,3,24,14,0,Matches,Hellas-Verona,Serie-A
1394,Domagoj Bradarić,hr CRO,DF,25-153,19.6,32,24,20,8,4,16,26,61.5,10,17,4,13,14,46,46,1,Matches,Hellas-Verona,Serie-A
1395,Paweł Dawidowicz,pl POL,"DF,MF",29-357,18.7,42,22,19,20,3,18,27,66.7,9,15,5,10,20,62,62,2,Matches,Hellas-Verona,Serie-A
1396,Daniele Ghilardi,it ITA,DF,22-126,20.5,39,24,25,14,0,23,39,59.0,16,25,12,13,26,65,93,0,Matches,Hellas-Verona,Serie-A
1397,Casper Tengstedt,dk DEN,FW,24-345,16.2,7,5,0,5,2,4,9,44.4,5,5,1,4,3,10,28,0,Matches,Hellas-Verona,Serie-A
1398,Reda Belahyane,ma MAR,MF,20-345,18.4,36,26,16,13,7,13,17,76.5,4,20,9,11,10,46,22,1,Matches,Hellas-Verona,Serie-A
1399,Darko Lazović,rs SRB,"DF,FW",34-239,15.9,20,10,5,13,2,11,28,39.3,17,19,3,16,11,31,39,0,Matches,Hellas-Verona,Serie-A
1400,Suat Serdar,de GER,MF,28-031,13.4,30,18,10,17,3,9,22,40.9,13,15,4,11,8,38,18,0,Matches,Hellas-Verona,Serie-A
1401,Daniel Mosquera,co COL,FW,25-204,14.6,10,7,3,4,3,1,14,7.1,13,11,1,10,2,12,9,0,Matches,Hellas-Verona,Serie-A
1402,Giangiacomo Magnani,it ITA,DF,29-220,11.8,20,15,14,6,0,7,7,100.0,0,16,9,7,17,37,73,1,Matches,Hellas-Verona,Serie-A
1403,Nicolás Valentini,ar ARG,DF,24-036,10.5,28,19,17,10,1,17,25,68.0,8,12,6,6,12,40,78,0,Matches,Hellas-Verona,Serie-A
1404,Flavius Daniliuc,at AUT,DF,24-015,11.2,26,21,14,9,3,15,24,62.5,9,10,3,7,7,33,27,0,Matches,Hellas-Verona,Serie-A
1405,Dailon Livramento,cv CPV,"FW,MF",24-008,10.1,13,9,2,5,6,6,12,50.0,6,9,2,7,3,16,8,0,Matches,Hellas-Verona,Serie-A
1406,Grigoris Kastanos,cy CYP,"MF,FW",27-102,9.6,23,16,8,7,8,9,21,42.9,12,16,2,14,7,30,8,0,Matches,Hellas-Verona,Serie-A
1407,Cheikh Tidiane Niasse,sn SEN,MF,25-113,8.2,16,13,5,11,0,8,17,47.1,9,17,4,13,17,33,17,2,Matches,Hellas-Verona,Serie-A
1408,Antoine Bernede,fr FRA,MF,25-351,5.8,14,7,4,8,2,9,15,60.0,6,6,1,5,5,19,3,0,Matches,Hellas-Verona,Serie-A
1409,Martin Frese,dk DEN,DF,27-128,6.0,16,10,6,10,0,5,10,50.0,5,5,1,4,8,24,16,1,Matches,Hellas-Verona,Serie-A
1410,Abdou Harroui,nl NED,"MF,FW",27-119,5.1,9,6,6,3,0,4,4,100.0,0,5,0,5,2,11,5,0,Matches,Hellas-Verona,Serie-A
1411,Daniel Bandeira,pt POR,MF,25-031,4.5,4,0,1,3,0,3,6,50.0,3,2,1,1,6,10,8,0,Matches,Hellas-Verona,Serie-A
1412,Davide Faraoni,it ITA,DF,33-199,2.9,10,9,5,5,0,3,9,33.3,6,7,3,4,2,12,12,1,Matches,Hellas-Verona,Serie-A
1413,Simone Perilli,it ITA,GK,30-125,1.0,0,0,0,0,0,0,0,,0,0,0,0,0,0,1,0,Matches,Hellas-Verona,Serie-A
1414,Daniel Oyegoke,eng ENG,DF,22-129,1.1,2,2,1,0,1,1,1,100.0,0,1,0,1,1,3,7,0,Matches,Hellas-Verona,Serie-A
1415,Mathis Lambourde,fr FRA,"FW,MF",19-123,1.0,3,1,2,1,0,1,3,33.3,2,3,0,3,0,3,1,0,Matches,Hellas-Verona,Serie-A
1416,Faride Alidou,de GER,"FW,MF",23-298,0.8,0,0,0,0,0,0,0,,0,1,0,1,1,1,3,1,Matches,Hellas-Verona,Serie-A
1417,Junior Ajayi,ci CIV,FW,20-213,0.1,0,0,0,0,0,0,0,,0,0,0,0,0,0,0,0,Matches,Hellas-Verona,Serie-A
1418,Alphadjo Cissè,it ITA,"FW,MF",18-202,0.1,0,0,0,0,0,0,0,,0,0,0,0,0,0,0,0,Matches,Hellas-Verona,Serie-A
1419,Yllan Okou,fr FRA,DF,22-140,0.0,0,0,0,0,0,0,0,,0,1,0,1,0,0,0,0,Matches,Hellas-Verona,Serie-A
1420,Yann Sommer,ch SUI,GK,36-146,31.0,0,0,0,0,0,0,0,,0,0,0,0,0,0,11,1,Matches,Internazionale,Serie-A
1421,Lautaro Martínez,ar ARG,FW,27-263,28.5,30,16,10,12,8,13,25,52.0,12,21,3,18,10,40,15,0,Matches,Internazionale,Serie-A
1422,Alessandro Bastoni,it ITA,DF,26-029,25.7,42,22,22,14,6,18,28,64.3,10,25,13,12,22,64,51,1,Matches,Internazionale,Serie-A
1423,Henrikh Mkhitaryan,am ARM,MF,36-111,25.6,40,23,16,16,8,19,44,43.2,25,29,5,24,17,57,41,0,Matches,Internazionale,Serie-A
1424,Nicolò Barella,it ITA,MF,28-094,26.4,48,30,18,19,11,25,57,43.9,32,24,3,21,10,58,15,1,Matches,Internazionale,Serie-A
1425,Federico Dimarco,it ITA,"DF,FW",27-183,22.8,23,13,9,11,3,8,17,47.1,9,21,3,18,14,37,33,2,Matches,Internazionale,Serie-A
1426,Marcus Thuram,fr FRA,FW,27-279,24.4,18,10,7,5,6,3,14,21.4,11,15,3,12,3,21,15,0,Matches,Internazionale,Serie-A
1427,Hakan Çalhanoğlu,tr TUR,MF,31-093,20.0,41,21,7,23,11,19,34,55.9,15,13,6,7,18,59,22,0,Matches,Internazionale,Serie-A
1428,Denzel Dumfries,nl NED,"DF,FW",29-024,20.4,26,19,13,9,4,15,26,57.7,11,28,8,20,6,32,25,1,Matches,Internazionale,Serie-A
1429,Matteo Darmian,it ITA,DF,35-161,18.8,27,16,12,11,4,13,24,54.2,11,13,5,8,10,37,38,0,Matches,Internazionale,Serie-A
1430,Francesco Acerbi,it ITA,DF,37-091,17.7,23,19,16,7,0,11,17,64.7,6,21,15,6,26,49,77,0,Matches,Internazionale,Serie-A
1431,Benjamin Pavard,fr FRA,DF,29-045,17.6,29,16,12,12,5,18,25,72.0,7,16,12,4,16,45,52,0,Matches,Internazionale,Serie-A
1432,Stefan de Vrij,nl NED,DF,33-096,18.2,17,11,12,4,1,9,12,75.0,3,19,11,8,21,38,85,0,Matches,Internazionale,Serie-A
1433,Yann Aurel Bisseck,de GER,DF,24-164,16.6,15,11,9,4,2,10,14,71.4,4,16,8,8,16,31,60,1,Matches,Internazionale,Serie-A
1434,Carlos Augusto,br BRA,DF,26-125,17.5,28,13,12,11,5,12,18,66.7,6,20,9,11,8,36,45,0,Matches,Internazionale,Serie-A
1435,Davide Frattesi,it ITA,MF,25-202,13.6,17,8,6,10,1,10,18,55.6,8,12,4,8,5,22,14,1,Matches,Internazionale,Serie-A
1436,Kristjan Asllani,al ALB,MF,23-064,10.0,13,2,8,4,1,7,21,33.3,14,8,1,7,8,21,13,1,Matches,Internazionale,Serie-A
1437,Piotr Zieliński,pl POL,MF,30-357,10.9,14,10,6,7,1,6,13,46.2,7,10,5,5,6,20,12,1,Matches,Internazionale,Serie-A
1438,Mehdi Taremi,ir IRN,FW,32-298,7.7,5,1,1,2,2,0,2,0.0,2,9,1,8,0,5,11,0,Matches,Internazionale,Serie-A
1439,Joaquín Correa,ar ARG,"FW,MF",30-272,6.7,10,4,4,6,0,3,10,30.0,7,2,0,2,0,10,5,0,Matches,Internazionale,Serie-A
1440,Marko Arnautović,at AUT,FW,36-023,5.9,7,6,1,3,3,3,5,60.0,2,3,0,3,1,8,1,0,Matches,Internazionale,Serie-A
1441,Josep Martinez,es ESP,GK,26-350,5.0,0,0,0,0,0,0,0,,0,0,0,0,0,0,0,0,Matches,Internazionale,Serie-A
1442,Nicola Zalewski,pl POL,"DF,MF",23-109,3.9,4,2,3,1,0,2,5,40.0,3,3,1,2,2,6,4,1,Matches,Internazionale,Serie-A
1443,Tajon Buchanan,ca CAN,"DF,FW",26-093,1.1,3,0,2,0,1,1,2,50.0,1,0,0,0,0,3,3,0,Matches,Internazionale,Serie-A
1444,Tomás Palacios,ar ARG,DF,22-014,0.1,0,0,0,0,0,0,0,,0,0,0,0,1,1,0,0,Matches,Internazionale,Serie-A
1445,Manuel Locatelli,it ITA,MF,27-124,29.4,69,47,28,34,7,30,50,60.0,20,52,18,34,23,92,74,0,Matches,Juventus,Serie-A
1446,Michele Di Gregorio,it ITA,GK,27-289,31.0,0,0,0,0,0,0,0,,0,0,0,0,0,0,14,0,Matches,Juventus,Serie-A
1447,Kenan Yıldız,tr TUR,"FW,MF",20-008,24.7,51,28,11,25,15,16,28,57.1,12,24,0,24,5,56,11,3,Matches,Juventus,Serie-A
1448,Weston McKennie,us USA,"MF,DF",26-257,24.6,33,12,18,11,4,13,22,59.1,9,28,8,20,12,45,36,0,Matches,Juventus,Serie-A
1449,Federico Gatti,it ITA,DF,26-322,24.3,28,23,18,8,2,14,24,58.3,10,27,18,9,18,46,74,2,Matches,Juventus,Serie-A
1450,Pierre Kalulu,fr FRA,DF,24-341,26.0,41,25,29,9,3,18,24,75.0,6,27,15,12,17,58,68,1,Matches,Juventus,Serie-A
1451,Khéphren Thuram,fr FRA,MF,24-047,24.8,39,18,13,22,4,18,30,60.0,12,31,9,22,12,51,37,1,Matches,Juventus,Serie-A
1452,Andrea Cambiaso,it ITA,"DF,FW",25-081,23.1,41,26,24,11,6,25,41,61.0,16,23,4,19,14,55,30,5,Matches,Juventus,Serie-A
1453,Teun Koopmeiners,nl NED,"MF,FW",27-073,22.2,32,16,6,19,7,10,30,33.3,20,36,14,22,8,40,26,2,Matches,Juventus,Serie-A
1454,Dušan Vlahović,rs SRB,FW,25-104,19.5,3,1,0,1,2,1,5,20.0,4,7,3,4,1,4,9,3,Matches,Juventus,Serie-A
1455,Nicolás González,ar ARG,"FW,MF",27-036,17.6,23,13,10,8,5,9,24,37.5,15,15,4,11,7,30,27,2,Matches,Juventus,Serie-A
1456,Nicolò Savona,it ITA,DF,22-054,18.2,29,13,19,9,1,13,24,54.2,11,10,2,8,10,39,33,0,Matches,Juventus,Serie-A
1457,Timothy Weah,us USA,"DF,FW",25-079,17.9,35,19,15,12,8,14,25,56.0,11,25,4,21,14,49,26,2,Matches,Juventus,Serie-A
1458,Randal Kolo Muani,fr FRA,FW,26-158,11.3,11,7,3,5,3,4,5,80.0,1,7,0,7,2,13,2,0,Matches,Juventus,Serie-A
1459,Renato Veiga,pt POR,DF,21-287,10.6,16,11,6,9,1,9,13,69.2,4,16,13,3,15,31,68,0,Matches,Juventus,Serie-A
1460,Francisco Conceição,pt POR,"FW,MF",22-149,13.0,18,10,5,7,6,10,27,37.0,17,7,0,7,5,23,6,0,Matches,Juventus,Serie-A
1461,Lloyd Kelly,eng ENG,DF,26-218,9.3,10,8,3,6,1,7,9,77.8,2,10,6,4,1,11,41,3,Matches,Juventus,Serie-A
1462,Samuel Mbangula,be BEL,FW,21-116,7.9,15,10,7,6,2,7,13,53.8,6,7,0,7,3,18,4,0,Matches,Juventus,Serie-A
1463,Danilo,br BRA,DF,33-301,6.5,10,4,7,2,1,5,10,50.0,5,4,3,1,9,19,21,1,Matches,Juventus,Serie-A
1464,Gleison Bremer,br BRA,DF,28-055,6.0,15,7,9,5,1,4,5,80.0,1,15,11,4,6,21,16,0,Matches,Juventus,Serie-A
1465,Juan David Cabal,co COL,DF,24-124,5.1,10,4,7,3,0,8,12,66.7,4,2,0,2,2,12,14,1,Matches,Juventus,Serie-A
1466,Nicolò Fagioli,it ITA,MF,24-089,6.3,14,10,7,6,1,6,9,66.7,3,4,0,4,2,16,5,0,Matches,Juventus,Serie-A
1467,Mattia Perin,it ITA,GK,32-183,5.0,0,0,0,0,0,0,0,,0,0,0,0,0,0,2,0,Matches,Juventus,Serie-A
1468,Douglas Luiz,br BRA,MF,27-003,5.8,12,8,7,4,1,6,9,66.7,3,5,2,3,2,14,5,0,Matches,Juventus,Serie-A
1469,Alberto costa,pt POR,DF,21-225,2.5,11,7,6,4,1,5,7,71.4,2,4,0,4,2,13,8,0,Matches,Juventus,Serie-A
1470,Jonas Rouhi,se SWE,DF,21-125,2.3,4,1,1,3,0,0,1,0.0,1,2,0,2,3,7,2,0,Matches,Juventus,Serie-A
1471,Vasilije Adžić,me MNE,"MF,FW",19-000,0.5,2,2,0,1,1,0,1,0.0,1,0,0,0,0,2,0,0,Matches,Juventus,Serie-A
1472,Diego Pugno,it ITA,FW,18-309,0.1,0,0,0,0,0,0,0,,0,0,0,0,0,0,0,0,Matches,Juventus,Serie-A
1473,Lorenzo Anghelè,it ITA,FW,20-075,0.1,0,0,0,0,0,0,0,,0,0,0,0,0,0,0,0,Matches,Juventus,Serie-A
1474,Mattéo Guendouzi,fr FRA,MF,26-028,34.3,36,20,12,19,5,20,45,44.4,25,33,9,24,30,66,48,2,Matches,Lazio,Serie-A
1475,Mattia Zaccagni,it ITA,FW,29-330,29.0,37,26,13,20,4,15,30,50.0,15,17,1,16,29,66,21,2,Matches,Lazio,Serie-A
1476,Ivan Provedel,it ITA,GK,31-056,29.0,0,0,0,0,0,0,0,,0,1,0,1,1,1,12,3,Matches,Lazio,Serie-A
1477,Mario Gila,es ESP,DF,24-256,28.5,53,36,33,18,2,36,53,67.9,17,19,13,6,28,81,106,3,Matches,Lazio,Serie-A
1478,Nicolò Rovella,it ITA,MF,23-159,28.4,81,47,38,36,7,39,74,52.7,35,19,4,15,45,126,43,3,Matches,Lazio,Serie-A
1479,Alessio Romagnoli,it ITA,DF,30-120,27.7,44,28,17,25,2,21,26,80.8,5,30,15,15,23,67,111,1,Matches,Lazio,Serie-A
1480,Gustav Isaksen,dk DEN,FW,24-023,23.5,15,8,6,8,1,6,27,22.2,21,21,2,19,9,24,19,1,Matches,Lazio,Serie-A
1481,Valentín Castellanos,ar ARG,FW,26-221,24.5,13,6,2,4,7,1,10,10.0,9,16,2,14,5,18,24,0,Matches,Lazio,Serie-A
1482,Boulaye Dia,sn SEN,"MF,FW",28-177,22.2,21,9,5,11,5,7,16,43.8,9,12,1,11,5,26,13,1,Matches,Lazio,Serie-A
1483,Adam Marušić,me MNE,DF,32-207,24.5,29,19,16,11,2,16,28,57.1,12,17,7,10,14,43,56,0,Matches,Lazio,Serie-A
1484,Nuno Tavares,pt POR,DF,25-106,17.2,28,21,15,8,5,14,32,43.8,18,18,2,16,19,47,39,1,Matches,Lazio,Serie-A
1485,Manuel Lazzari,it ITA,DF,31-164,15.6,26,16,13,11,2,14,24,58.3,10,9,5,4,10,36,19,0,Matches,Lazio,Serie-A
1486,Fisayo Dele-Bashiru,ng NGA,"MF,FW",24-095,10.5,10,6,3,3,4,2,6,33.3,4,10,2,8,4,14,5,0,Matches,Lazio,Serie-A
1487,Luca Pellegrini,it ITA,DF,26-066,11.7,22,11,10,10,2,16,31,51.6,15,10,3,7,19,41,31,0,Matches,Lazio,Serie-A
1488,Tijjani Noslin,nl NED,"FW,MF",25-309,9.4,6,5,2,1,3,1,8,12.5,7,15,1,14,1,7,7,0,Matches,Lazio,Serie-A
1489,Samuel Gigot,fr FRA,DF,31-212,7.6,4,3,1,3,0,0,1,0.0,1,8,6,2,13,17,36,0,Matches,Lazio,Serie-A
1490,Christos Mandas,gr GRE,GK,23-237,7.0,0,0,0,0,0,0,0,,0,0,0,0,0,0,3,0,Matches,Lazio,Serie-A
1491,Pedro,es ESP,"FW,MF",37-288,11.3,18,13,5,8,5,10,21,47.6,11,10,0,10,3,21,3,1,Matches,Lazio,Serie-A
1492,Matías Vecino,uy URU,MF,33-261,8.6,13,7,3,9,1,4,18,22.2,14,7,3,4,5,18,11,0,Matches,Lazio,Serie-A
1493,Loum Tchaouna,fr FRA,"FW,MF",21-246,7.3,8,4,2,2,4,3,9,33.3,6,5,1,4,4,12,14,2,Matches,Lazio,Serie-A
1494,Patric,es ESP,DF,32-025,6.7,9,6,6,3,0,6,10,60.0,4,3,2,1,3,12,22,1,Matches,Lazio,Serie-A
1495,Elseid Hysaj,al ALB,DF,31-081,3.9,11,6,6,5,0,3,3,100.0,0,3,2,1,4,15,19,0,Matches,Lazio,Serie-A
1496,Nicolò Casale,it ITA,DF,27-087,1.5,5,3,4,1,0,0,0,,0,4,3,1,1,6,2,0,Matches,Lazio,Serie-A
1497,Reda Belahyane,ma MAR,MF,20-345,2.2,8,6,8,0,0,6,6,100.0,0,3,2,1,1,9,5,0,Matches,Lazio,Serie-A
1498,Gaetano Castrovilli,it ITA,"MF,FW",28-084,1.6,5,2,3,1,1,2,4,50.0,2,3,0,3,3,8,1,0,Matches,Lazio,Serie-A
1499,Oliver Nielsen,dk DEN,DF,21-342,0.4,0,0,0,0,0,0,0,,0,1,0,1,1,1,2,0,Matches,Lazio,Serie-A
1500,Arijon Ibrahimović,de GER,MF,19-152,0.1,0,0,0,0,0,0,0,,0,0,0,0,0,0,0,0,Matches,Lazio,Serie-A
1501,Federico Baschirotto,it ITA,DF,28-234,36.0,37,25,30,5,2,22,28,78.6,6,44,32,12,23,60,216,2,Matches,Lecce,Serie-A
1502,Wladimiro Falcone,it ITA,GK,30-030,36.0,0,0,0,0,0,0,0,,0,0,0,0,0,0,28,3,Matches,Lecce,Serie-A
1503,Nikola Krstović,me MNE,FW,25-037,32.4,17,8,4,6,7,6,15,40.0,9,10,6,4,7,24,22,0,Matches,Lecce,Serie-A
1504,Antonino Gallo,it ITA,DF,25-127,27.0,63,41,44,15,4,32,59,54.2,27,30,4,26,20,83,117,0,Matches,Lecce,Serie-A
1505,Frederic Guilbert,fr FRA,DF,30-139,25.1,64,35,29,29,6,35,54,64.8,19,25,8,17,44,108,104,3,Matches,Lecce,Serie-A
1506,Lassana Coulibaly,ml MLI,MF,29-032,27.6,45,27,16,26,3,23,60,38.3,37,42,12,30,16,61,42,1,Matches,Lecce,Serie-A
1507,Kialonda,ao ANG,DF,27-227,21.8,34,12,24,10,0,12,16,75.0,4,41,26,15,27,61,113,1,Matches,Lecce,Serie-A
1508,Tete Morente,es ESP,"FW,MF",28-159,21.5,26,16,10,10,6,10,35,28.6,25,16,1,15,13,39,31,1,Matches,Lecce,Serie-A
1509,Santiago Pierotti,ar ARG,FW,24-039,20.5,45,24,21,18,6,22,46,47.8,24,26,5,21,13,58,28,0,Matches,Lecce,Serie-A
1510,Patrick Dorgu,dk DEN,"DF,FW",20-198,20.4,45,27,21,19,5,23,45,51.1,22,24,6,18,18,63,42,2,Matches,Lecce,Serie-A
1511,Ylber Ramadani,al ALB,MF,29-030,18.8,51,28,24,27,0,33,50,66.0,17,26,9,17,24,75,23,3,Matches,Lecce,Serie-A
1512,Balthazar Pierret,fr FRA,MF,24-362,18.7,50,30,24,23,3,13,30,43.3,17,18,4,14,19,69,31,1,Matches,Lecce,Serie-A
1513,Gaby Jean,fr FRA,DF,25-082,15.4,14,7,8,5,1,6,11,54.5,5,13,10,3,9,23,71,1,Matches,Lecce,Serie-A
1514,Hamza Rafia,tn TUN,MF,26-040,11.8,44,27,14,25,5,15,32,46.9,17,7,2,5,4,48,18,1,Matches,Lecce,Serie-A
1515,Þórir Jóhann Helgason,is ISL,MF,24-226,12.0,10,7,3,6,1,7,12,58.3,5,7,2,5,5,15,10,2,Matches,Lecce,Serie-A
1516,Ante Rebić,hr CRO,"FW,MF",31-233,8.3,10,8,5,3,2,2,8,25.0,6,6,1,5,2,12,4,1,Matches,Lecce,Serie-A
1517,Medon Berisha,al ALB,MF,21-203,7.3,12,8,7,3,2,4,8,50.0,4,6,0,6,10,22,4,2,Matches,Lecce,Serie-A
1518,Lameck Banda,zm ZAM,"FW,MF",24-103,6.8,8,5,4,2,2,3,12,25.0,9,7,0,7,2,10,8,1,Matches,Lecce,Serie-A
1519,Jesper Karlsson,se SWE,FW,26-291,4.9,3,2,3,0,0,2,8,25.0,6,1,0,1,0,3,3,0,Matches,Lecce,Serie-A
1520,Remi Oudin,fr FRA,"MF,FW",28-175,3.3,3,1,1,1,1,2,4,50.0,2,6,2,4,2,5,1,0,Matches,Lecce,Serie-A
1521,Mohamed Kaba,fr FRA,MF,23-197,4.3,12,7,6,5,1,7,8,87.5,1,10,3,7,4,16,9,1,Matches,Lecce,Serie-A
1522,Danilo Veiga,pt POR,DF,22-229,3.9,8,6,4,4,0,6,12,50.0,6,5,0,5,4,12,9,0,Matches,Lecce,Serie-A
1523,Valentin Gendrey,fr FRA,DF,24-325,2.0,2,2,1,0,1,1,1,100.0,0,3,1,2,2,4,1,0,Matches,Lecce,Serie-A
1524,Konan N'dri,ci CIV,"FW,MF",24-197,2.9,2,2,0,0,2,2,3,66.7,1,2,0,2,1,3,0,0,Matches,Lecce,Serie-A
1525,Andy Pelmard,fr FRA,DF,25-061,1.4,6,6,5,1,0,4,4,100.0,0,1,0,1,0,6,5,0,Matches,Lecce,Serie-A
1526,Tiago Gabriel,pt POR,DF,20-137,1.1,0,0,0,0,0,0,0,,0,4,2,2,0,0,11,0,Matches,Lecce,Serie-A
1527,Marco Sala,it ITA,DF,25-342,0.8,1,0,0,1,0,0,1,0.0,1,1,0,1,0,1,0,0,Matches,Lecce,Serie-A
1528,Kevin Bonifazi,it ITA,DF,28-358,0.7,1,1,1,0,0,1,1,100.0,0,1,1,0,2,3,3,0,Matches,Lecce,Serie-A
1529,Nicola Sansone,it ITA,"MF,FW",33-244,0.7,0,0,0,0,0,0,0,,0,0,0,0,0,0,0,0,Matches,Lecce,Serie-A
1530,Rareș-Cătălin Burnete,ro ROU,FW,21-101,0.3,0,0,0,0,0,0,1,0.0,1,0,0,0,0,0,0,0,Matches,Lecce,Serie-A
1531,Filip Marchwiński,pl POL,MF,23-122,0.2,0,0,0,0,0,0,0,,0,0,0,0,0,0,0,0,Matches,Lecce,Serie-A
1532,Mike Maignan,fr FRA,GK,29-313,34.6,0,0,0,0,0,0,1,0.0,1,1,0,1,0,0,18,3,Matches,Milan,Serie-A
1533,Tijjani Reijnders,nl NED,MF,26-287,32.8,23,13,6,12,5,9,25,36.0,16,22,4,18,35,58,27,2,Matches,Milan,Serie-A
1534,Theo Hernández,fr FRA,DF,27-218,30.0,36,28,23,10,3,21,39,53.8,18,25,10,15,17,53,75,3,Matches,Milan,Serie-A
1535,Youssouf Fofana,fr FRA,MF,26-122,27.4,56,34,20,31,5,26,51,51.0,25,32,9,23,19,75,23,3,Matches,Milan,Serie-A
1536,Christian Pulisic,us USA,"FW,MF",26-236,25.6,39,25,14,13,12,14,35,40.0,21,24,2,22,5,44,13,2,Matches,Milan,Serie-A
1537,Rafael Leão,pt POR,FW,25-336,25.5,14,9,2,8,4,9,27,33.3,18,15,1,14,6,20,3,0,Matches,Milan,Serie-A
1538,Matteo Gabbia,it ITA,DF,25-203,22.0,20,14,12,7,1,8,10,80.0,2,23,18,5,13,33,94,1,Matches,Milan,Serie-A
1539,Malick Thiaw,de GER,DF,23-277,20.1,24,17,15,6,3,6,10,60.0,4,14,12,2,15,39,76,1,Matches,Milan,Serie-A
1540,Strahinja Pavlović,rs SRB,DF,23-353,18.7,48,30,29,19,0,26,46,56.5,20,13,6,7,16,64,71,0,Matches,Milan,Serie-A
1541,Yunus Musah,us USA,"MF,FW",22-164,16.0,25,18,11,9,5,10,15,66.7,5,8,1,7,7,32,8,3,Matches,Milan,Serie-A
1542,Fikayo Tomori,eng ENG,DF,27-144,15.7,36,22,18,16,2,14,22,63.6,8,14,10,4,17,53,55,2,Matches,Milan,Serie-A
1543,Emerson,br BRA,DF,26-118,15.3,45,28,24,16,5,16,34,47.1,18,13,2,11,14,59,56,0,Matches,Milan,Serie-A
1544,Alejandro Jiménez,es ESP,"DF,FW",20-004,13.0,22,13,8,13,1,10,22,45.5,12,22,3,19,15,37,21,0,Matches,Milan,Serie-A
1545,Álvaro Morata,es ESP,"FW,MF",32-201,12.2,16,10,5,8,3,5,8,62.5,3,7,2,5,5,21,5,0,Matches,Milan,Serie-A
1546,Tammy Abraham,eng ENG,FW,27-222,13.1,17,11,2,10,5,6,8,75.0,2,13,0,13,2,19,16,0,Matches,Milan,Serie-A
1547,Samuel Chukwueze,ng NGA,"FW,MF",25-355,9.8,16,10,7,5,4,5,18,27.8,13,3,0,3,2,18,9,0,Matches,Milan,Serie-A
1548,Ruben Loftus-Cheek,eng ENG,MF,29-109,9.8,16,7,4,8,4,5,10,50.0,5,2,0,2,3,19,15,0,Matches,Milan,Serie-A
1549,Kyle Walker,eng ENG,DF,34-349,7.3,17,9,12,4,1,13,17,76.5,4,9,5,4,9,26,15,1,Matches,Milan,Serie-A
1550,Santiago Giménez,mx MEX,FW,24-024,7.2,5,3,0,4,1,3,4,75.0,1,3,1,2,1,6,13,0,Matches,Milan,Serie-A
1551,João Félix,pt POR,MF,25-183,6.8,6,6,3,2,1,4,13,30.8,9,2,0,2,0,6,9,0,Matches,Milan,Serie-A
1552,Filippo Terracciano,it ITA,"DF,MF",22-093,6.0,9,6,1,6,2,5,10,50.0,5,1,0,1,6,15,11,0,Matches,Milan,Serie-A
1553,Luka Jović,rs SRB,"FW,MF",27-140,5.4,0,0,0,0,0,0,0,,0,2,1,1,1,1,3,0,Matches,Milan,Serie-A
1554,Noah Okafor,ch SUI,FW,24-353,4.6,2,1,0,0,2,0,1,0.0,1,1,0,1,2,4,1,0,Matches,Milan,Serie-A
1555,Davide Calabria,it ITA,DF,28-157,3.5,10,7,10,0,0,4,7,57.1,3,1,0,1,8,18,8,0,Matches,Milan,Serie-A
1556,Ismaël Bennacer,dz ALG,MF,27-162,3.3,5,4,1,3,1,1,7,14.3,6,5,3,2,3,8,1,0,Matches,Milan,Serie-A
1557,Warren Bondo,fr FRA,MF,21-239,1.8,5,3,4,1,0,3,3,100.0,0,1,0,1,0,5,2,0,Matches,Milan,Serie-A
1558,Francesco Camarda,it ITA,"FW,MF",17-063,1.8,5,2,0,2,3,2,6,33.3,4,1,1,0,0,5,3,0,Matches,Milan,Serie-A
1559,Marco Sportiello,it ITA,GK,33-002,1.4,0,0,0,0,0,0,0,,0,0,0,0,0,0,1,0,Matches,Milan,Serie-A
1560,Riccardo Sottil,it ITA,"FW,MF",25-343,1.3,1,1,1,0,0,0,0,,0,0,0,0,0,1,0,0,Matches,Milan,Serie-A
1561,Alexis Saelemaekers,be BEL,"DF,FW",25-319,1.0,1,1,0,0,1,1,1,100.0,0,0,0,0,1,2,0,0,Matches,Milan,Serie-A
1562,Mattia Liberali,it ITA,MF,18-036,0.7,2,1,0,1,1,2,2,100.0,0,0,0,0,0,2,0,0,Matches,Milan,Serie-A
1563,Davide Bartesaghi,it ITA,"DF,MF",19-134,0.6,2,1,1,1,0,2,2,100.0,0,1,1,0,2,4,1,0,Matches,Milan,Serie-A
1564,Kevin Zeroli,it ITA,MF,20-121,0.1,1,1,0,1,0,0,0,,0,0,0,0,0,1,0,0,Matches,Milan,Serie-A
1565,Bob Murphy Omoregbe,it ITA,MF,21-188,0.0,0,0,0,0,0,0,0,,0,0,0,0,0,0,0,0,Matches,Milan,Serie-A
1566,Giorgos Kyriakopoulos,gr GRE,DF,29-096,29.6,40,26,19,17,4,27,57,47.4,30,28,10,18,22,62,72,0,Matches,Monza,Serie-A
1567,Pedro Pereira,pt POR,DF,27-110,28.6,53,32,30,18,5,35,55,63.6,20,25,11,14,18,71,83,4,Matches,Monza,Serie-A
1568,Stefano Turati,it ITA,GK,23-249,29.7,0,0,0,0,0,0,1,0.0,1,0,0,0,0,0,21,2,Matches,Monza,Serie-A
1569,Armando Izzo,it ITA,DF,33-071,26.9,40,15,30,9,1,18,36,50.0,18,38,28,10,45,85,100,0,Matches,Monza,Serie-A
1570,Alessandro Bianco,it ITA,MF,22-223,27.0,47,26,23,16,8,25,38,65.8,13,39,14,25,20,67,52,4,Matches,Monza,Serie-A
1571,Dany Mota,pt POR,"FW,MF",27-010,23.0,13,3,2,3,8,4,8,50.0,4,18,1,17,9,22,26,3,Matches,Monza,Serie-A
1572,Andrea Carboni,it ITA,DF,24-097,22.3,57,32,37,16,4,32,50,64.0,18,26,14,12,27,84,99,4,Matches,Monza,Serie-A
1573,Pablo Marí,es ESP,DF,31-254,18.1,26,15,14,12,0,11,21,52.4,10,24,21,3,37,63,85,2,Matches,Monza,Serie-A
1574,Warren Bondo,fr FRA,MF,21-239,18.0,35,24,19,12,4,13,19,68.4,6,16,6,10,5,40,8,4,Matches,Monza,Serie-A
1575,Gianluca Caprari,it ITA,"MF,FW",31-286,16.8,19,11,8,8,3,7,13,53.8,6,14,0,14,7,26,2,1,Matches,Monza,Serie-A
1576,Daniel Maldini,it ITA,"MF,FW",23-213,14.5,14,6,5,9,0,6,13,46.2,7,8,2,6,4,18,12,2,Matches,Monza,Serie-A
1577,Samuele Birindelli,it ITA,DF,25-297,14.3,18,14,9,4,5,5,12,41.7,7,13,2,11,9,27,30,1,Matches,Monza,Serie-A
1578,Milan Đurić,ba BIH,FW,34-355,14.1,1,1,0,1,0,0,3,0.0,3,6,0,6,2,3,17,0,Matches,Monza,Serie-A
1579,Danilo D'Ambrosio,it ITA,DF,36-245,12.2,28,15,17,10,1,14,23,60.9,9,12,8,4,15,43,36,2,Matches,Monza,Serie-A
1580,Patrick Ciurria,it ITA,"MF,DF",30-092,11.3,22,14,11,7,4,4,11,36.4,7,13,3,10,6,28,19,0,Matches,Monza,Serie-A
1581,Matteo Pessina,it ITA,MF,28-021,9.5,15,4,3,11,1,9,14,64.3,5,6,0,6,12,27,7,0,Matches,Monza,Serie-A
1582,Jean-Daniel Akpa-Akpro,ci CIV,"MF,DF",32-213,8.7,26,16,13,12,1,9,18,50.0,9,19,6,13,11,37,13,1,Matches,Monza,Serie-A
1583,Luca Caldirola,it ITA,DF,34-100,8.5,9,5,7,2,0,3,6,50.0,3,8,6,2,10,19,39,0,Matches,Monza,Serie-A
1584,Gaetano Castrovilli,it ITA,MF,28-084,6.4,12,7,10,2,0,4,11,36.4,7,8,2,6,2,14,9,0,Matches,Monza,Serie-A
1585,Semuel Pizzignacco,it ITA,GK,23-253,6.3,0,0,0,0,0,0,1,0.0,1,0,0,0,0,0,5,0,Matches,Monza,Serie-A
1586,Kacper Urbanski,pl POL,MF,20-247,5.6,5,3,1,2,2,4,7,57.1,3,7,2,5,2,7,9,0,Matches,Monza,Serie-A
1587,Keita Baldé,sn SEN,FW,30-065,5.4,1,1,0,1,0,1,2,50.0,1,3,0,3,2,3,0,0,Matches,Monza,Serie-A
1588,Tomás Palacios,ar ARG,DF,22-014,4.4,11,5,9,2,0,9,13,69.2,4,6,2,4,7,18,12,2,Matches,Monza,Serie-A
1589,Silvère Ganvoula M'Boussy,cg CGO,FW,28-324,3.6,0,0,0,0,0,0,1,0.0,1,1,0,1,1,1,5,0,Matches,Monza,Serie-A
1590,Samuele Vignato,it ITA,MF,21-077,5.2,6,3,0,4,2,3,7,42.9,4,1,0,1,0,6,6,0,Matches,Monza,Serie-A
1591,Stefan Lekovic,rs SRB,DF,21-123,4.1,9,4,6,2,1,5,13,38.5,8,4,4,0,7,16,5,0,Matches,Monza,Serie-A
1592,Kevin Zeroli,it ITA,MF,20-121,3.8,5,1,2,3,0,0,1,0.0,1,6,1,5,2,7,8,0,Matches,Monza,Serie-A
1593,Andrea Petagna,it ITA,FW,29-316,3.4,2,1,0,1,1,1,2,50.0,1,0,0,0,1,3,2,0,Matches,Monza,Serie-A
1594,Arvid Brorsson,se SWE,DF,26-004,3.0,4,3,2,2,0,2,5,40.0,3,9,8,1,2,6,31,1,Matches,Monza,Serie-A
1595,Stefano Sensi,it ITA,MF,29-280,2.7,8,5,4,4,0,5,6,83.3,1,3,2,1,3,11,3,1,Matches,Monza,Serie-A
1596,Omari Forson,eng ENG,"MF,FW",20-296,2.5,3,3,1,2,0,1,3,33.3,2,3,0,3,1,4,1,0,Matches,Monza,Serie-A
1597,Kevin Martins,it ITA,"MF,DF",20-101,2.0,5,4,3,2,0,3,6,50.0,3,1,0,1,1,6,4,1,Matches,Monza,Serie-A
1598,Mirko Marić,hr CRO,"FW,MF",29-361,1.2,1,0,1,0,0,1,2,50.0,1,1,1,0,1,2,1,0,Matches,Monza,Serie-A
1599,Roberto Gagliardini,it ITA,"MF,DF",31-035,2.0,3,2,1,2,0,1,4,25.0,3,1,0,1,2,5,4,0,Matches,Monza,Serie-A
1600,Mattia Valoti,it ITA,MF,31-248,0.4,3,3,3,0,0,0,2,0.0,2,2,0,2,0,3,2,0,Matches,Monza,Serie-A
1601,Amir Rrahmani,xk KVX,DF,31-077,35.8,36,28,18,17,1,15,24,62.5,9,42,25,17,27,63,171,2,Matches,Napoli,Serie-A
1602,Giovanni Di Lorenzo,it ITA,DF,31-281,35.0,65,43,34,25,6,41,63,65.1,22,18,6,12,30,95,78,1,Matches,Napoli,Serie-A
1603,Romelu Lukaku,be BEL,FW,31-364,29.9,4,2,0,2,2,1,4,25.0,3,7,2,5,1,5,16,0,Matches,Napoli,Serie-A
1604,Alex Meret,it ITA,GK,28-051,31.4,0,0,0,0,0,0,0,,0,1,0,1,0,0,16,0,Matches,Napoli,Serie-A
1605,Matteo Politano,it ITA,"FW,MF",31-282,29.6,29,15,17,11,1,15,43,34.9,28,20,1,19,12,41,49,1,Matches,Napoli,Serie-A
1606,Scott McTominay,sct SCO,MF,28-155,30.6,41,23,12,25,4,18,36,50.0,18,21,4,17,23,64,50,0,Matches,Napoli,Serie-A
1607,Stanislav Lobotka,sk SVK,MF,30-168,29.3,47,30,16,21,10,19,31,61.3,12,29,11,18,21,68,57,1,Matches,Napoli,Serie-A
1608,Andre-Frank Zambo Anguissa,cm CMR,MF,29-177,29.8,40,25,7,28,5,14,33,42.4,19,19,6,13,34,74,37,1,Matches,Napoli,Serie-A
1609,Mathías Olivera,uy URU,DF,27-193,24.3,61,33,31,24,6,31,50,62.0,19,34,10,24,28,89,65,1,Matches,Napoli,Serie-A
1610,Alessandro Buongiorno,it ITA,DF,25-340,21.4,39,23,26,12,1,24,32,75.0,8,30,18,12,35,74,73,2,Matches,Napoli,Serie-A
1611,Leonardo Spinazzola,it ITA,"DF,FW",32-048,15.0,15,10,6,7,2,10,23,43.5,13,10,1,9,8,23,30,1,Matches,Napoli,Serie-A
1612,Khvicha Kvaratskhelia,ge GEO,"FW,MF",24-089,13.1,15,9,4,10,1,4,15,26.7,11,13,0,13,4,19,7,0,Matches,Napoli,Serie-A
1613,David Neres,br BRA,FW,28-070,13.7,18,10,7,4,7,8,13,61.5,5,6,0,6,7,25,4,0,Matches,Napoli,Serie-A
1614,Juan Jesus,br BRA,DF,33-336,11.9,25,14,16,9,0,12,20,60.0,8,15,3,12,9,34,42,0,Matches,Napoli,Serie-A
1615,Billy Gilmour,sct SCO,MF,23-335,11.3,21,13,8,8,5,10,18,55.6,8,6,1,5,8,29,19,0,Matches,Napoli,Serie-A
1616,Giacomo Raspadori,it ITA,"FW,MF",25-083,10.6,17,8,6,10,1,8,12,66.7,4,10,2,8,3,20,10,0,Matches,Napoli,Serie-A
1617,Pasquale Mazzocchi,it ITA,"DF,FW",29-289,7.7,15,7,7,5,3,8,15,53.3,7,5,2,3,5,20,24,0,Matches,Napoli,Serie-A
1618,Elia Caprile,it ITA,GK,23-260,3.6,0,0,0,0,0,0,0,,0,0,0,0,0,0,2,0,Matches,Napoli,Serie-A
1619,Giovanni Simeone,ar ARG,FW,29-311,4.4,2,0,0,1,1,1,6,16.7,5,9,2,7,1,3,6,0,Matches,Napoli,Serie-A
1620,Cyril Ngonge,be BEL,FW,24-351,2.2,8,5,4,4,0,4,6,66.7,2,3,0,3,1,9,4,0,Matches,Napoli,Serie-A
1621,Philip Billing,dk DEN,MF,28-335,1.9,9,6,4,4,1,1,2,50.0,1,4,1,3,4,13,5,0,Matches,Napoli,Serie-A
1622,Rafa Marín,es ESP,DF,22-358,1.6,1,0,1,0,0,1,2,50.0,1,1,1,0,1,2,4,0,Matches,Napoli,Serie-A
1623,Simone Scuffet,it ITA,GK,28-346,1.0,0,0,0,0,0,0,0,,0,0,0,0,0,0,2,0,Matches,Napoli,Serie-A
1624,Noah Okafor,ch SUI,"FW,MF",24-353,0.4,3,2,3,0,0,2,2,100.0,0,0,0,0,0,3,1,0,Matches,Napoli,Serie-A
1625,Michael Folorunsho,it ITA,"FW,MF",27-094,0.4,3,2,0,3,0,2,4,50.0,2,0,0,0,1,4,1,1,Matches,Napoli,Serie-A
1626,Walid Cheddira,ma MAR,FW,27-110,0.1,0,0,0,0,0,0,0,,0,0,0,0,0,0,0,0,Matches,Napoli,Serie-A
1627,Alessio Zerbin,it ITA,"FW,DF",26-070,0.0,2,1,2,0,0,1,1,100.0,0,0,0,0,0,2,0,0,Matches,Napoli,Serie-A
1628,Zion Suzuki,jp JPN,GK,22-264,34.8,1,0,1,0,0,1,2,50.0,1,0,0,0,0,1,31,4,Matches,Parma,Serie-A
1629,Simon Sohm,ch SUI,MF,24-031,31.4,27,16,10,13,4,15,33,45.5,18,9,2,7,25,52,33,0,Matches,Parma,Serie-A
1630,Emanuele Valeri,it ITA,DF,26-156,30.5,50,30,32,15,3,30,60,50.0,30,29,10,19,27,77,100,4,Matches,Parma,Serie-A
1631,Enrico Del Prato,it ITA,DF,25-183,30.7,31,17,22,8,1,19,25,76.0,6,68,34,34,18,49,126,2,Matches,Parma,Serie-A
1632,Ange-Yoan Bonny,fr FRA,FW,21-199,26.2,34,16,4,23,7,8,14,57.1,6,17,2,15,3,37,16,0,Matches,Parma,Serie-A
1633,Dennis Man,ro ROU,"FW,MF",26-259,22.2,13,6,7,3,3,6,24,25.0,18,15,3,12,8,21,11,0,Matches,Parma,Serie-A
1634,Mandela Keita,be BEL,MF,23-002,19.2,43,24,12,25,6,18,35,51.4,17,16,6,10,20,63,25,2,Matches,Parma,Serie-A
1635,Botond Balogh,hu HUN,DF,22-340,20.8,28,11,18,10,0,16,22,72.7,6,32,24,8,24,52,130,2,Matches,Parma,Serie-A
1636,Matteo Cancellieri,it ITA,"FW,MF",23-089,15.8,26,16,15,9,2,11,32,34.4,21,15,1,14,13,39,30,0,Matches,Parma,Serie-A
1637,Adrian Bernabe,es ESP,MF,23-351,15.1,28,18,16,8,4,14,30,46.7,16,22,9,13,6,34,24,1,Matches,Parma,Serie-A
1638,Lautaro Valenti,ar ARG,DF,26-118,16.3,16,12,12,3,1,6,6,100.0,0,24,12,12,11,27,93,1,Matches,Parma,Serie-A
1639,Valentin Mihaila,ro ROU,"FW,MF",25-099,14.3,29,15,8,13,8,9,22,40.9,13,18,0,18,8,37,6,0,Matches,Parma,Serie-A
1640,Hernani,br BRA,MF,31-046,13.4,41,22,22,15,4,23,43,53.5,20,25,6,19,18,59,11,1,Matches,Parma,Serie-A
1641,Giovanni Leoni,it ITA,DF,18-142,12.6,13,5,9,4,0,4,8,50.0,4,19,10,9,15,28,57,1,Matches,Parma,Serie-A
1642,Woyo Coulibaly,fr FRA,DF,25-357,12.0,13,10,9,2,2,5,11,45.5,6,19,2,17,8,21,25,0,Matches,Parma,Serie-A
1643,Antoine Hainaut,fr FRA,"DF,MF",23-083,12.6,25,14,14,8,3,9,13,69.2,4,16,4,12,14,39,57,0,Matches,Parma,Serie-A
1644,Pontus Almqvist,se SWE,"FW,MF",25-306,12.4,17,13,7,7,3,8,17,47.1,9,13,0,13,19,36,8,0,Matches,Parma,Serie-A
1645,Alessandro Vogliacco,it ITA,DF,26-240,8.6,5,2,5,0,0,3,5,60.0,2,15,10,5,3,8,37,0,Matches,Parma,Serie-A
1646,Nahuel Estévez,ar ARG,MF,29-179,7.2,14,5,6,7,1,5,14,35.7,9,9,2,7,3,17,25,0,Matches,Parma,Serie-A
1647,Mateo Pellegrino,ar ARG,FW,24-072,6.3,2,1,1,1,0,1,3,33.3,2,4,1,3,0,2,6,0,Matches,Parma,Serie-A
1648,Alessandro Circati,au AUS,DF,21-214,4.0,4,2,3,1,0,1,1,100.0,0,5,4,1,2,6,29,1,Matches,Parma,Serie-A
1649,Mohamed Haj,tn TUN,MF,20-047,5.0,3,1,2,1,0,1,2,50.0,1,3,1,2,4,7,5,0,Matches,Parma,Serie-A
1650,Jacob Ondrejka,se SWE,"MF,FW",22-252,4.1,12,6,5,7,0,10,12,83.3,2,2,0,2,7,19,2,0,Matches,Parma,Serie-A
1651,Milan Đurić,ba BIH,FW,34-355,2.9,0,0,0,0,0,0,2,0.0,2,3,0,3,0,0,2,0,Matches,Parma,Serie-A
1652,Adrian Benedyczak,pl POL,"FW,MF",24-169,2.4,0,0,0,0,0,0,1,0.0,1,3,1,2,0,0,8,0,Matches,Parma,Serie-A
1653,Yordan Osorio,ve VEN,DF,31-002,1.9,5,3,4,1,0,2,2,100.0,0,3,1,2,4,9,6,1,Matches,Parma,Serie-A
1654,Drissa Camara,ci CIV,"MF,FW",23-083,5.0,9,7,2,6,1,1,10,10.0,9,8,0,8,3,12,1,0,Matches,Parma,Serie-A
1655,Leandro Chichizola,ar ARG,GK,35-046,1.0,0,0,0,0,0,0,0,,0,0,0,0,0,0,2,0,Matches,Parma,Serie-A
1656,Mateusz Kowalski,pl POL,MF,19-295,0.6,0,0,0,0,0,0,0,,0,1,0,1,0,0,1,0,Matches,Parma,Serie-A
1657,Gabriel Charpentier,cg CGO,FW,25-360,3.0,4,3,2,1,1,3,4,75.0,1,3,0,3,0,4,9,0,Matches,Parma,Serie-A
1658,Mathias Løvik,no NOR,"DF,FW",21-157,1.0,1,0,0,1,0,1,2,50.0,1,1,1,0,2,3,3,0,Matches,Parma,Serie-A
1659,Wylan Cyprien,fr FRA,MF,30-104,0.3,0,0,0,0,0,0,1,0.0,1,1,0,1,1,1,0,0,Matches,Parma,Serie-A
1660,Obite N'Dicka,ci CIV,DF,25-265,35.0,30,24,15,15,0,12,18,66.7,6,42,27,15,32,62,140,1,Matches,Roma,Serie-A
1661,Mile Svilar,rs SRB,GK,25-258,35.0,0,0,0,0,0,0,0,,0,0,0,0,0,0,11,2,Matches,Roma,Serie-A
1662,Angeliño,es ESP,DF,28-128,32.3,45,23,19,24,2,17,34,50.0,17,32,9,23,26,71,92,0,Matches,Roma,Serie-A
1663,Gianluca Mancini,it ITA,DF,29-025,31.9,39,23,22,15,2,19,32,59.4,13,19,13,6,34,73,89,0,Matches,Roma,Serie-A
1664,Manu Koné,fr FRA,MF,23-360,25.6,36,22,15,15,6,17,38,44.7,21,24,4,20,19,55,23,0,Matches,Roma,Serie-A
1665,Artem Dovbyk,ua UKR,FW,27-325,25.9,4,2,0,1,3,0,4,0.0,4,9,3,6,2,6,12,0,Matches,Roma,Serie-A
1666,Zeki Çelik,tr TUR,DF,28-084,22.1,56,34,20,28,8,21,38,55.3,17,24,6,18,12,68,77,2,Matches,Roma,Serie-A
1667,Bryan Cristante,it ITA,MF,30-070,19.7,43,26,15,22,6,14,25,56.0,11,17,9,8,16,59,31,1,Matches,Roma,Serie-A
1668,Lorenzo Pellegrini,it ITA,MF,28-327,18.1,24,16,5,13,6,8,19,42.1,11,8,1,7,6,30,22,0,Matches,Roma,Serie-A
1669,Matìas Soulé,ar ARG,"MF,FW",22-027,16.9,23,15,10,6,7,9,21,42.9,12,24,3,21,8,31,22,0,Matches,Roma,Serie-A
1670,Paulo Dybala,ar ARG,"FW,MF",31-178,15.7,17,7,3,9,5,8,19,42.1,11,12,1,11,2,19,2,0,Matches,Roma,Serie-A
1671,Alexis Saelemaekers,be BEL,"DF,FW",25-319,13.5,30,17,21,6,3,16,30,53.3,14,12,1,11,7,37,8,1,Matches,Roma,Serie-A
1672,Leandro Paredes,ar ARG,MF,30-317,13.4,25,14,9,11,5,15,29,51.7,14,13,4,9,19,44,29,1,Matches,Roma,Serie-A
1673,Stephan El Shaarawy,it ITA,"DF,MF",32-197,11.8,16,12,4,6,6,6,12,50.0,6,4,0,4,10,26,13,0,Matches,Roma,Serie-A
1674,Niccolò Pisilli,it ITA,MF,20-231,13.5,23,10,10,8,5,12,22,54.5,10,14,3,11,11,34,16,0,Matches,Roma,Serie-A
1675,Mats Hummels,de GER,DF,36-147,10.2,30,15,16,14,0,11,18,61.1,7,12,4,8,26,56,43,0,Matches,Roma,Serie-A
1676,Eldor Shomurodov,uz UZB,"FW,MF",29-317,9.5,11,4,2,6,3,3,5,60.0,2,8,0,8,2,13,2,0,Matches,Roma,Serie-A
1677,Tommaso Baldanzi,it ITA,"MF,FW",22-050,9.1,12,4,5,4,3,4,12,33.3,8,4,0,4,6,18,8,0,Matches,Roma,Serie-A
1678,Nicola Zalewski,pl POL,"DF,FW",23-109,5.9,8,6,3,2,3,2,7,28.6,5,7,2,5,4,12,8,2,Matches,Roma,Serie-A
1679,Devyne Rensch,nl NED,DF,22-114,4.2,15,11,7,7,1,9,10,90.0,1,4,2,2,5,20,10,1,Matches,Roma,Serie-A
1680,Enzo Le Fée,fr FRA,MF,25-098,3.5,7,4,5,2,0,2,6,33.3,4,9,3,6,5,12,2,0,Matches,Roma,Serie-A
1681,Mario Hermoso,es ESP,DF,29-328,2.8,2,1,2,0,0,0,1,0.0,1,1,1,0,4,6,13,0,Matches,Roma,Serie-A
1682,Lucas Gourna-Douath,fr FRA,MF,21-280,2.4,9,4,5,4,0,2,6,33.3,4,1,1,0,0,9,2,0,Matches,Roma,Serie-A
1683,Saud Abdulhamid,sa KSA,DF,25-298,2.3,3,2,2,0,1,1,1,100.0,0,2,0,2,2,5,0,0,Matches,Roma,Serie-A
1684,Anass Salah-Eddine,nl NED,DF,23-114,1.7,1,1,1,0,0,0,0,,0,0,0,0,1,2,2,2,Matches,Roma,Serie-A
1685,Victor Nelsson,dk DEN,DF,26-210,2.1,5,4,3,1,1,3,5,60.0,2,1,0,1,2,7,9,0,Matches,Roma,Serie-A
1686,Samuel Dahl,se SWE,"DF,MF",25-069,0.5,2,2,0,2,0,1,2,50.0,1,2,0,2,0,2,0,0,Matches,Roma,Serie-A
1687,Tammy Abraham,eng ENG,FW,27-222,0.0,0,0,0,0,0,0,1,0.0,1,0,0,0,0,0,0,0,Matches,Roma,Serie-A
1688,Vanja Milinković-Savić,rs SRB,GK,28-081,35.0,1,0,1,0,0,1,3,33.3,2,0,0,0,0,1,17,4,Matches,Torino,Serie-A
1689,Saúl Coco,gq EQG,DF,26-092,31.6,46,26,31,14,1,19,30,63.3,11,49,31,18,38,84,157,4,Matches,Torino,Serie-A
1690,Samuele Ricci,it ITA,MF,23-264,29.8,33,18,15,13,5,19,27,70.4,8,21,9,12,25,58,49,2,Matches,Torino,Serie-A
1691,Che Adams,sct SCO,FW,28-303,27.5,10,5,1,4,5,0,4,0.0,4,11,5,6,2,12,18,0,Matches,Torino,Serie-A
1692,Guillermo Maripán,cl CHI,DF,31-006,24.0,36,21,22,13,1,19,31,61.3,12,26,12,14,38,74,133,1,Matches,Torino,Serie-A
1693,Valentino Lazaro,at AUT,"DF,FW",29-049,23.9,25,11,10,12,3,15,28,53.6,13,28,5,23,11,36,38,1,Matches,Torino,Serie-A
1694,Nikola Vlašić,hr CRO,"MF,FW",27-220,21.7,35,18,10,16,9,12,30,40.0,18,14,3,11,9,44,14,0,Matches,Torino,Serie-A
1695,Sebastian Walukiewicz,pl POL,DF,25-037,18.2,38,20,18,16,4,23,31,74.2,8,21,8,13,18,56,58,0,Matches,Torino,Serie-A
1696,Adam Masina,ma MAR,DF,31-130,19.5,33,15,22,10,1,23,39,59.0,16,26,15,11,25,58,86,2,Matches,Torino,Serie-A
1697,Karol Linetty,pl POL,MF,30-099,16.9,39,23,17,19,3,20,41,48.8,21,14,5,9,12,51,31,1,Matches,Torino,Serie-A
1698,Antonio Sanabria,py PAR,FW,29-069,14.4,3,3,1,1,1,1,4,25.0,3,6,1,5,1,4,13,0,Matches,Torino,Serie-A
1699,Marcus Pedersen,no NOR,DF,24-300,15.1,12,8,6,5,1,9,15,60.0,6,11,2,9,13,25,34,1,Matches,Torino,Serie-A
1700,Gvidas Gineitis,lt LTU,MF,21-027,14.9,24,14,8,10,6,13,25,52.0,12,16,6,10,16,40,29,0,Matches,Torino,Serie-A
1701,Borna Sosa,hr CRO,DF,27-111,13.1,26,19,14,7,5,16,25,64.0,9,13,6,7,14,40,33,0,Matches,Torino,Serie-A
1702,Mërgim Vojvoda,xk KVX,DF,30-100,12.3,18,10,5,9,4,7,14,50.0,7,13,3,10,7,25,24,1,Matches,Torino,Serie-A
1703,Cristiano Biraghi,it ITA,DF,32-253,10.9,14,10,8,2,4,9,15,60.0,6,13,3,10,8,22,37,0,Matches,Torino,Serie-A
1704,Elif Elmas,mk MKD,"FW,MF",25-230,10.5,8,5,3,5,0,4,9,44.4,5,7,2,5,6,14,5,2,Matches,Torino,Serie-A
1705,Cesare Casadei,it ITA,MF,22-122,9.7,10,4,4,6,0,5,9,55.6,4,3,2,1,5,15,20,0,Matches,Torino,Serie-A
1706,Yann Karamoh,fr FRA,"MF,FW",26-308,11.6,5,2,2,1,2,4,9,44.4,5,10,2,8,3,8,5,0,Matches,Torino,Serie-A
1707,Ivan Ilić,rs SRB,MF,24-056,10.0,5,2,0,4,1,2,7,28.6,5,0,0,0,5,10,9,0,Matches,Torino,Serie-A
1708,Adrien Tameze,cm CMR,"MF,DF",31-097,7.2,5,2,2,3,0,1,10,10.0,9,8,5,3,10,15,8,1,Matches,Torino,Serie-A
1709,Duván Zapata,co COL,FW,34-041,6.5,7,5,2,0,5,0,3,0.0,3,2,1,1,2,9,7,0,Matches,Torino,Serie-A
1710,Ali Dembélé,fr FRA,DF,21-127,2.7,6,4,3,3,0,4,4,100.0,0,3,1,2,0,6,9,1,Matches,Torino,Serie-A
1711,Alberto Paleari,it ITA,GK,32-256,1.0,0,0,0,0,0,0,0,,0,0,0,0,0,0,2,0,Matches,Torino,Serie-A
1712,Raoul Bellanova,it ITA,DF,24-360,1.0,0,0,0,0,0,0,1,0.0,1,0,0,0,0,0,4,0,Matches,Torino,Serie-A
1713,Eybi Nije,se SWE,"FW,MF",19-363,4.4,5,1,3,1,1,0,3,0.0,3,5,1,4,0,5,1,0,Matches,Torino,Serie-A
1714,Sergiu Perciun,md MDA,"FW,MF",19-019,1.0,0,0,0,0,0,0,0,,0,2,0,2,1,1,2,0,Matches,Torino,Serie-A
1715,Alessio Cacciamani,it ITA,DF,17-317,0.1,0,0,0,0,0,0,0,,0,0,0,0,0,0,0,0,Matches,Torino,Serie-A
1716,Saba Sazonov,ge GEO,DF,23-100,0.0,0,0,0,0,0,0,0,,0,1,1,0,0,0,0,0,Matches,Torino,Serie-A
1717,Aaron Ciammaglichella,it ITA,MF,20-106,0.0,0,0,0,0,0,0,0,,0,0,0,0,0,0,0,0,Matches,Torino,Serie-A
1718,Jesper Karlström,se SWE,MF,29-325,33.4,60,33,31,21,8,25,50,50.0,25,28,11,17,34,94,78,4,Matches,Udinese,Serie-A
1719,Jaka Bijol,si SVN,DF,26-096,32.5,43,25,32,10,1,21,39,53.8,18,37,18,19,38,81,179,1,Matches,Udinese,Serie-A
1720,Sandi Lovrić,si SVN,MF,27-045,25.0,45,29,24,17,4,22,44,50.0,22,33,5,28,22,67,26,1,Matches,Udinese,Serie-A
1721,Kingsley Ehizibue,nl NED,DF,29-352,25.8,52,33,30,18,4,25,39,64.1,14,36,11,25,21,73,62,5,Matches,Udinese,Serie-A
1722,Lorenzo Lucca,it ITA,FW,24-244,25.3,9,6,2,2,5,4,10,40.0,6,18,1,17,6,15,24,0,Matches,Udinese,Serie-A
1723,Hassane Kamara,ci CIV,DF,31-068,21.9,34,24,19,11,4,15,27,55.6,12,23,5,18,26,60,47,1,Matches,Udinese,Serie-A
1724,Florian Thauvin,fr FRA,"FW,MF",32-106,21.7,20,14,9,8,3,10,25,40.0,15,6,0,6,7,27,10,0,Matches,Udinese,Serie-A
1725,Maduka Okoye,ng NGA,GK,25-257,23.0,0,0,0,0,0,0,0,,0,0,0,0,0,0,11,1,Matches,Udinese,Serie-A
1726,Jurgen Ekkelenkamp,nl NED,MF,25-037,19.2,35,24,10,21,4,17,32,53.1,15,25,4,21,12,47,22,0,Matches,Udinese,Serie-A
1727,Thomas Kristensen,dk DEN,DF,23-115,18.5,30,20,15,11,4,19,29,65.5,10,17,13,4,18,48,72,2,Matches,Udinese,Serie-A
1728,Oumar Solet,fr FRA,DF,25-094,16.6,32,18,17,13,2,20,28,71.4,8,27,15,12,17,49,66,3,Matches,Udinese,Serie-A
1729,Martín Payero,ar ARG,MF,26-243,15.3,24,16,4,14,6,8,16,50.0,8,16,2,14,13,37,13,0,Matches,Udinese,Serie-A
1730,Jordan Zemura,zw ZIM,DF,25-179,14.0,25,13,13,9,3,13,24,54.2,11,16,3,13,15,40,37,0,Matches,Udinese,Serie-A
1731,Razvan Sava,ro ROU,GK,22-325,12.0,0,0,0,0,0,0,0,,0,0,0,0,0,0,6,2,Matches,Udinese,Serie-A
1732,Arthur Atta,fr FRA,"MF,FW",22-118,13.1,20,12,9,10,1,10,15,66.7,5,7,4,3,7,27,15,1,Matches,Udinese,Serie-A
1733,Lautaro Gianetti,ar ARG,DF,31-180,9.6,22,10,16,5,1,14,20,70.0,6,20,10,10,15,37,46,1,Matches,Udinese,Serie-A
1734,Souleymane Touré,fr FRA,DF,22-045,8.1,7,6,4,3,0,4,5,80.0,1,15,6,9,9,16,17,1,Matches,Udinese,Serie-A
1735,Christian Kabasele,be BEL,DF,34-077,11.1,13,8,6,7,0,7,9,77.8,2,10,4,6,11,24,53,1,Matches,Udinese,Serie-A
1736,Keinan Davis,eng ENG,FW,27-088,10.7,9,4,1,4,4,3,6,50.0,3,2,1,1,1,10,5,0,Matches,Udinese,Serie-A
1737,Oier Zarraga,es ESP,MF,26-128,8.5,15,9,7,8,0,8,19,42.1,11,6,3,3,2,17,7,0,Matches,Udinese,Serie-A
1738,Brenner,br BRA,"MF,FW",25-116,4.3,6,4,2,3,1,3,8,37.5,5,4,0,4,1,7,6,0,Matches,Udinese,Serie-A
1739,Alexis Sánchez,cl CHI,FW,36-144,4.1,3,1,0,2,1,1,5,20.0,4,4,0,4,3,6,0,1,Matches,Udinese,Serie-A
1740,Iker Bravo,es ESP,"FW,MF",20-119,7.4,9,5,2,5,2,4,8,50.0,4,3,0,3,1,10,4,0,Matches,Udinese,Serie-A
1741,Rui Modesto,ao ANG,"DF,MF",25-217,6.4,16,12,4,9,3,7,9,77.8,2,9,0,9,8,24,12,0,Matches,Udinese,Serie-A
1742,Nehuén Pérez,ar ARG,DF,24-322,2.0,1,1,0,0,1,0,1,0.0,1,2,2,0,1,2,7,0,Matches,Udinese,Serie-A
1743,Daniele Padelli,it ITA,GK,39-199,1.0,0,0,0,0,0,0,1,0.0,1,0,0,0,0,0,0,0,Matches,Udinese,Serie-A
1744,Simone Pafundi,it ITA,"MF,DF",19-087,1.3,3,3,2,0,1,1,4,25.0,3,0,0,0,0,3,1,0,Matches,Udinese,Serie-A
1745,Enzo Ebosse,cm CMR,DF,26-062,1.0,0,0,0,0,0,0,2,0.0,2,3,3,0,1,1,1,0,Matches,Udinese,Serie-A
1746,James Abankwah,ie IRL,"DF,MF",21-116,1.0,4,2,4,0,0,2,3,66.7,1,2,1,1,1,5,3,0,Matches,Udinese,Serie-A
1747,Damián Pizarro,cl CHI,"FW,MF",20-045,0.2,0,0,0,0,0,0,0,,0,0,0,0,0,0,0,0,Matches,Udinese,Serie-A
1748,Jay Idzes,id IDN,DF,24-344,32.7,45,29,24,17,4,17,32,53.1,15,49,29,20,30,75,153,0,Matches,Venezia,Serie-A
1749,Hans Nicolussi Caviglia,it ITA,MF,24-328,28.8,43,26,14,21,8,28,62,45.2,34,37,11,26,27,70,53,2,Matches,Venezia,Serie-A
1750,Gaetano Oristanio,it ITA,"FW,MF",22-226,24.3,17,13,5,8,4,7,15,46.7,8,16,0,16,6,23,6,1,Matches,Venezia,Serie-A
1751,Gianluca Busio,us USA,MF,22-349,26.0,45,31,24,12,9,20,47,42.6,27,32,8,24,18,63,49,0,Matches,Venezia,Serie-A
1752,Mikael Ellertsson,is ISL,"DF,MF",23-062,24.7,51,24,33,11,7,29,54,53.7,25,39,4,35,13,64,71,0,Matches,Venezia,Serie-A
1753,Joel Pohjanpalo,fi FIN,FW,30-241,17.8,3,3,1,2,0,0,4,0.0,4,7,4,3,4,7,24,0,Matches,Venezia,Serie-A
1754,Francesco Zampano,it ITA,DF,31-224,17.9,30,20,19,9,2,14,28,50.0,14,20,0,20,6,36,28,2,Matches,Venezia,Serie-A
1755,Filip Stankovic,rs SRB,GK,23-076,15.2,0,0,0,0,0,0,0,,0,0,0,0,0,0,11,2,Matches,Venezia,Serie-A
1756,Michael Svoboda,at AUT,DF,26-209,14.6,26,14,19,6,1,8,19,42.1,11,19,11,8,22,48,66,2,Matches,Venezia,Serie-A
1757,Fali Candé,gw GNB,DF,27-108,14.0,21,17,12,8,1,13,19,68.4,6,15,10,5,12,33,72,2,Matches,Venezia,Serie-A
1758,Alessio Zerbin,it ITA,DF,26-070,14.0,49,28,28,12,9,27,49,55.1,22,26,3,23,13,62,22,0,Matches,Venezia,Serie-A
1759,Ridgeciano Haps,sr SUR,DF,31-334,14.2,26,15,18,6,2,11,18,61.1,7,16,3,13,6,32,45,0,Matches,Venezia,Serie-A
1760,Ionuț Radu,ro ROU,GK,27-349,12.0,0,0,0,0,0,0,0,,0,0,0,0,0,0,7,0,Matches,Venezia,Serie-A
1761,Antonio Candela,it ITA,DF,25-015,11.2,31,21,13,11,7,18,26,69.2,8,7,5,2,8,39,22,2,Matches,Venezia,Serie-A
1762,Alfred Duncan,gh GHA,MF,32-063,10.6,17,8,4,11,2,5,14,35.7,9,7,2,5,8,25,8,0,Matches,Venezia,Serie-A
1763,Marin Šverko,hr CRO,DF,27-097,11.6,17,6,11,6,0,8,10,80.0,2,9,4,5,16,33,42,3,Matches,Venezia,Serie-A
1764,Kike Pérez,es ESP,MF,28-087,10.4,36,21,16,10,10,17,41,41.5,24,12,1,11,8,44,12,0,Matches,Venezia,Serie-A
1765,Joël Schingtienne,be BEL,DF,22-273,9.7,20,12,15,4,1,10,16,62.5,6,15,7,8,11,31,18,3,Matches,Venezia,Serie-A
1766,Issa Doumbia,ci CIV,MF,21-208,9.3,13,8,5,7,1,7,15,46.7,8,15,4,11,7,20,13,0,Matches,Venezia,Serie-A
1767,John Yeboah,ec ECU,"FW,MF",24-323,11.0,4,3,1,2,1,0,9,0.0,9,4,0,4,4,8,2,0,Matches,Venezia,Serie-A
1768,Giorgio Altare,it ITA,DF,26-276,8.4,13,12,8,3,2,8,15,53.3,7,21,11,10,17,30,49,0,Matches,Venezia,Serie-A
1769,Jesse Joronen,fi FIN,GK,32-052,7.8,0,0,0,0,0,0,0,,0,0,0,0,0,0,4,1,Matches,Venezia,Serie-A
1770,Magnus Kofod Andersen,dk DEN,MF,26-002,7.7,13,4,3,9,1,4,10,40.0,6,7,2,5,6,19,12,0,Matches,Venezia,Serie-A
1771,Christian Gytkjær,dk DEN,FW,35-006,7.5,6,4,2,2,2,1,2,50.0,1,2,1,1,0,6,8,0,Matches,Venezia,Serie-A
1772,Daniel Fila,cz CZE,FW,22-264,4.7,2,0,0,1,1,0,2,0.0,2,5,0,5,0,2,5,0,Matches,Venezia,Serie-A
1773,Alessandro Marcandalli,it ITA,DF,22-229,3.8,7,5,5,2,0,2,5,40.0,3,6,3,3,2,9,26,0,Matches,Venezia,Serie-A
1774,Mirko Marić,hr CRO,FW,29-361,3.5,2,2,2,0,0,0,3,0.0,3,2,0,2,1,3,10,0,Matches,Venezia,Serie-A
1775,Franco Carboni,it ITA,DF,22-038,2.5,5,3,5,0,0,5,8,62.5,3,1,1,0,0,5,11,0,Matches,Venezia,Serie-A
1776,Richie Sagrado,be BEL,DF,21-102,1.6,2,2,1,1,0,1,1,100.0,0,1,0,1,3,5,4,0,Matches,Venezia,Serie-A
1777,Bjarki Bjarkason,is ISL,"DF,MF",25-001,1.8,3,2,2,1,0,1,2,50.0,1,1,0,1,2,5,4,0,Matches,Venezia,Serie-A
1778,Cheick Oumar Conde,gn GUI,MF,24-290,1.6,6,5,3,2,1,2,5,40.0,3,7,2,5,4,10,3,0,Matches,Venezia,Serie-A
1779,Domen Črnigoj,si SVN,MF,29-175,1.5,4,2,0,1,3,1,2,50.0,1,5,2,3,4,8,4,0,Matches,Venezia,Serie-A
1780,Antonio Raimondo,it ITA,"FW,DF",21-055,1.0,2,1,1,1,0,0,0,,0,0,0,0,0,2,0,1,Matches,Venezia,Serie-A
1781,Nicholas Pierini,it ITA,MF,26-279,0.9,0,0,0,0,0,0,1,0.0,1,2,0,2,0,0,0,0,Matches,Venezia,Serie-A
1782,Saad El Haddad,ma MAR,MF,19-292,0.3,0,0,0,0,0,0,0,,0,0,0,0,0,0,0,0,Matches,Venezia,Serie-A
1783,Nunzio Lella,it ITA,MF,24-288,0.1,0,0,0,0,0,0,0,,0,0,0,0,0,0,0,0,Matches,Venezia,Serie-A
1784,Yahia Fofana,ci CIV,GK,24-264,33.0,0,0,0,0,0,0,2,0.0,2,0,0,0,1,1,25,2,Matches,Angers,Ligue-1
1785,Jordan Lefort,fr FRA,DF,31-276,33.0,52,30,42,9,1,30,44,68.2,14,54,35,19,31,83,203,3,Matches,Angers,Ligue-1
1786,Himad Abdelli,dz ALG,"MF,FW",25-176,30.6,47,31,12,20,15,14,47,29.8,33,22,1,21,25,72,27,2,Matches,Angers,Ligue-1
1787,Florent Hanin,dz ALG,DF,35-097,28.7,67,48,43,17,7,37,68,54.4,31,30,10,20,47,114,94,2,Matches,Angers,Ligue-1
1788,Jean-Eudes Aholou,ci CIV,MF,31-053,21.8,56,36,26,20,10,22,48,45.8,26,34,14,20,33,89,32,0,Matches,Angers,Ligue-1
1789,Carlens Arcus,ht HAI,DF,28-318,21.7,50,34,30,15,5,32,54,59.3,22,23,4,19,26,76,77,3,Matches,Angers,Ligue-1
1790,Jim Allevinah,ga GAB,FW,30-074,19.4,19,11,6,9,4,5,28,17.9,23,10,0,10,12,31,17,0,Matches,Angers,Ligue-1
1791,Farid El Melali,dz ALG,FW,28-007,20.7,28,16,15,6,7,13,33,39.4,20,18,1,17,16,44,12,1,Matches,Angers,Ligue-1
1792,Haris Belkebla,dz ALG,MF,31-104,19.9,56,38,38,15,3,26,45,57.8,19,30,9,21,35,91,46,1,Matches,Angers,Ligue-1
1793,Esteban Lepaul,fr FRA,FW,25-024,17.2,11,6,2,6,3,4,16,25.0,12,14,2,12,3,14,10,0,Matches,Angers,Ligue-1
1794,Yassin Belkhdim,fr FRA,MF,23-087,16.9,53,27,26,21,6,27,58,46.6,31,23,6,17,21,74,41,1,Matches,Angers,Ligue-1
1795,Abdoulaye Bamba,ci CIV,DF,35-017,16.8,22,12,17,4,1,14,19,73.7,5,14,8,6,19,41,79,0,Matches,Angers,Ligue-1
1796,Emmanuel Biumla,fr FRA,DF,20-004,14.6,19,12,14,5,0,12,18,66.7,6,18,8,10,8,27,83,1,Matches,Angers,Ligue-1
1797,Lilian Raolisoa,fr FRA,"DF,FW",24-330,13.7,39,23,24,13,2,17,37,45.9,20,11,2,9,15,54,44,0,Matches,Angers,Ligue-1
1798,Ibrahima Niane,sn SEN,FW,26-062,10.5,7,3,3,2,2,3,3,100.0,0,6,1,5,2,9,6,2,Matches,Angers,Ligue-1
1799,Zinedine Ferhat,dz ALG,"FW,MF",32-072,9.4,9,7,1,5,3,4,13,30.8,9,9,0,9,10,19,12,0,Matches,Angers,Ligue-1
1800,Jacques Ekomie,ga GAB,DF,21-266,7.1,21,14,9,9,3,7,11,63.6,4,15,4,11,4,25,14,0,Matches,Angers,Ligue-1
1801,Bamba Dieng,sn SEN,FW,25-050,5.9,4,1,1,2,1,0,2,0.0,2,2,0,2,0,4,3,0,Matches,Angers,Ligue-1
1802,Pierrick Capelle,fr FRA,MF,38-027,5.4,24,17,10,9,5,9,18,50.0,9,4,1,3,11,35,5,1,Matches,Angers,Ligue-1
1803,Sidiki Cherif,fr FRA,FW,18-148,3.6,5,5,1,3,1,3,4,75.0,1,4,1,3,0,5,0,1,Matches,Angers,Ligue-1
1804,Zinédine Ould Khaled,fr FRA,MF,25-118,3.1,9,7,5,3,1,2,12,16.7,10,5,0,5,2,11,9,0,Matches,Angers,Ligue-1
1805,Cédric Hountondji,bj BEN,DF,31-113,3.0,6,4,4,2,0,3,7,42.9,4,3,3,0,4,10,14,0,Matches,Angers,Ligue-1
1806,Marius Courcoul,fr FRA,"MF,DF",18-131,2.4,3,1,2,1,0,1,3,33.3,2,2,0,2,4,7,8,0,Matches,Angers,Ligue-1
1807,Ousmane Camara,fr FRA,DF,22-067,2.0,2,1,1,1,0,1,1,100.0,0,0,0,0,0,2,14,0,Matches,Angers,Ligue-1
1808,Justin-Noël Kalumba,fr FRA,"FW,MF",20-138,0.3,0,0,0,0,0,0,0,,0,0,0,0,1,1,1,0,Matches,Angers,Ligue-1
1809,Lois Diony,fr FRA,FW,32-143,0.2,0,0,0,0,0,0,0,,0,0,0,0,0,0,0,0,Matches,Angers,Ligue-1
1810,Prosper Peter,ng NGA,MF,17-276,0.2,2,1,0,2,0,0,0,,0,0,0,0,0,2,0,0,Matches,Angers,Ligue-1
1811,Enzo Caumont,fr FRA,MF,21-060,0.1,1,1,0,1,0,1,1,100.0,0,1,1,0,1,2,1,0,Matches,Angers,Ligue-1
1812,Lanroy Machine,fr FRA,FW,19-211,0.0,0,0,0,0,0,0,0,,0,0,0,0,0,0,0,0,Matches,Angers,Ligue-1
1813,Donovan Léon,gf GUF,GK,32-190,31.0,0,0,0,0,0,0,2,0.0,2,2,0,2,0,0,22,1,Matches,Auxerre,Ligue-1
1814,Jubal,br BRA,DF,31-256,29.3,60,39,46,13,1,28,40,70.0,12,61,36,25,25,85,201,1,Matches,Auxerre,Ligue-1
1815,Gaëtan Perrin,fr FRA,"MF,FW",28-339,29.0,49,26,22,12,15,21,46,45.7,25,10,0,10,12,61,4,1,Matches,Auxerre,Ligue-1
1816,Clément Akpa,ci CIV,DF,23-169,26.8,54,34,35,12,7,31,46,67.4,15,38,14,24,40,94,140,2,Matches,Auxerre,Ligue-1
1817,Elisha Owusu,gh GHA,MF,27-186,25.0,72,40,28,39,5,31,47,66.0,16,33,9,24,41,113,34,1,Matches,Auxerre,Ligue-1
1818,Ki-Jana Hoever,nl NED,DF,23-114,23.6,51,38,26,16,9,30,54,55.6,24,33,3,30,21,72,70,1,Matches,Auxerre,Ligue-1
1819,Gideon Mensah,gh GHA,DF,26-298,24.3,62,41,31,21,10,29,58,50.0,29,26,4,22,48,110,80,0,Matches,Auxerre,Ligue-1
1820,Hamed Junior Traorè,ci CIV,MF,25-085,22.5,41,20,11,17,13,16,53,30.2,37,14,0,14,6,47,11,0,Matches,Auxerre,Ligue-1
1821,Lassine Sinayoko,ml MLI,"FW,MF",25-155,24.6,33,20,10,14,9,11,22,50.0,11,16,2,14,12,45,38,0,Matches,Auxerre,Ligue-1
1822,Sinaly Diomande,ci CIV,DF,24-033,20.6,36,18,17,18,1,25,35,71.4,10,36,18,18,28,64,96,2,Matches,Auxerre,Ligue-1
1823,Gabriel Osho,ng NGA,DF,26-271,17.4,22,14,16,3,3,12,19,63.2,7,30,17,13,12,34,79,0,Matches,Auxerre,Ligue-1
1824,Kévin Danois,fr FRA,MF,20-318,16.2,49,30,20,22,7,20,46,43.5,26,17,3,14,20,69,20,0,Matches,Auxerre,Ligue-1
1825,Theo Bair,ca CAN,FW,25-258,10.4,4,3,1,2,1,0,2,0.0,2,6,2,4,3,7,10,0,Matches,Auxerre,Ligue-1
1826,Han-Noah Massengo,fr FRA,MF,23-309,10.7,17,11,5,8,4,8,11,72.7,3,10,4,6,15,32,9,2,Matches,Auxerre,Ligue-1
1827,Ado Onaiwu,jp JPN,"MF,FW",29-185,10.4,10,7,2,5,3,4,14,28.6,10,12,0,12,3,13,12,0,Matches,Auxerre,Ligue-1
1828,Paul Joly,fr FRA,DF,24-339,10.2,48,31,29,17,2,27,43,62.8,16,17,1,16,24,72,30,5,Matches,Auxerre,Ligue-1
1829,Rayan Raveloson,mg MAD,"MF,DF",28-116,8.0,6,5,2,4,0,5,15,33.3,10,8,7,1,5,11,22,0,Matches,Auxerre,Ligue-1
1830,Assane Dioussé,sn SEN,MF,27-234,7.3,15,7,9,5,1,5,14,35.7,9,6,2,4,12,27,15,0,Matches,Auxerre,Ligue-1
1831,Florian Ayé,fr FRA,FW,28-113,6.3,2,2,0,0,2,0,2,0.0,2,7,0,7,7,9,6,0,Matches,Auxerre,Ligue-1
1832,Fredrik Oppegard,no NOR,DF,22-278,2.8,6,4,4,1,1,3,7,42.9,4,2,1,1,1,7,12,1,Matches,Auxerre,Ligue-1
1833,Théo De Percin,mq MTQ,GK,24-099,2.0,0,0,0,0,0,0,1,0.0,1,0,0,0,0,0,3,0,Matches,Auxerre,Ligue-1
1834,Rudy Matondo,fr FRA,MF,17-060,0.7,1,1,1,0,0,0,1,0.0,1,0,0,0,0,1,2,0,Matches,Auxerre,Ligue-1
1835,Théo Pellenard,fr FRA,DF,31-069,0.5,3,2,2,1,0,1,3,33.3,2,1,0,1,0,3,3,0,Matches,Auxerre,Ligue-1
1836,Lasso Coulibaly,gh GHA,"FW,MF",22-205,0.4,0,0,0,0,0,0,0,,0,0,0,0,0,0,0,0,Matches,Auxerre,Ligue-1
1837,Aristide Zossou,ci CIV,MF,19-332,0.2,0,0,0,0,0,0,0,,0,0,0,0,0,0,0,0,Matches,Auxerre,Ligue-1
1838,Eros Maddy,nl NED,DF,24-096,0.2,0,0,0,0,0,0,0,,0,0,0,0,0,0,0,0,Matches,Auxerre,Ligue-1
1839,Loïc N'Gatta,fr FRA,DF,21-152,0.1,1,1,0,1,0,1,2,50.0,1,1,0,1,0,1,1,0,Matches,Auxerre,Ligue-1
1840,Yoann Cissé,fr FRA,MF,20-150,0.1,0,0,0,0,0,0,0,,0,0,0,0,1,1,0,0,Matches,Auxerre,Ligue-1
1841,Ben Viadere,fr FRA,MF,19-252,0.1,0,0,0,0,0,0,0,,0,0,0,0,0,0,0,0,Matches,Auxerre,Ligue-1
1842,Marco Bizot,nl NED,GK,34-063,31.0,2,1,2,0,0,1,1,100.0,0,0,0,0,0,2,30,0,Matches,Brest,Ligue-1
1843,Mahdi Camara,fr FRA,"MF,FW",26-316,28.5,69,38,14,38,17,23,45,51.1,22,40,5,35,32,101,29,0,Matches,Brest,Ligue-1
1844,Kenny Lala,mg MAD,DF,33-221,28.8,65,41,36,23,6,37,56,66.1,19,25,9,16,25,90,74,1,Matches,Brest,Ligue-1
1845,Ludovic Ajorque,fr FRA,FW,31-076,26.8,25,18,3,11,11,9,31,29.0,22,20,5,15,6,31,25,0,Matches,Brest,Ligue-1
1846,Brendan Chardonnet,fr FRA,DF,30-141,26.8,45,33,28,14,3,25,40,62.5,15,45,28,17,29,74,169,2,Matches,Brest,Ligue-1
1847,Hugo Magnetti,fr FRA,MF,26-347,24.8,45,27,17,24,4,20,46,43.5,26,20,3,17,17,62,37,0,Matches,Brest,Ligue-1
1848,Massadio Haïdara,ml MLI,DF,32-161,18.5,27,16,16,9,2,13,29,44.8,16,17,2,15,26,53,73,0,Matches,Brest,Ligue-1
1849,Abdoulaye Niakhate Ndiaye,sn SEN,DF,23-032,18.0,44,30,33,11,0,21,31,67.7,10,28,17,11,10,54,141,3,Matches,Brest,Ligue-1
1850,Mathias Pereira Lage,pt POR,"FW,MF",28-163,16.8,36,24,16,13,7,17,36,47.2,19,16,2,14,20,56,19,2,Matches,Brest,Ligue-1
1851,Pierre Lees-Melou,fr FRA,MF,31-352,16.1,48,33,20,19,9,25,53,47.2,28,17,3,14,10,58,23,0,Matches,Brest,Ligue-1
1852,Julien Le Cardinal,fr FRA,DF,27-282,15.3,27,15,16,8,3,11,16,68.8,5,18,14,4,33,60,75,0,Matches,Brest,Ligue-1
1853,Romain Del Castillo,fr FRA,FW,29-044,13.7,29,21,9,12,8,18,31,58.1,13,16,0,16,6,35,5,0,Matches,Brest,Ligue-1
1854,Abdallah Sima,sn SEN,"FW,MF",23-329,13.5,15,11,2,5,8,4,10,40.0,6,8,0,8,1,16,9,0,Matches,Brest,Ligue-1
1855,Kamory Doumbia,ml MLI,"MF,FW",22-083,14.0,37,25,16,17,4,13,30,43.3,17,15,1,14,26,63,13,1,Matches,Brest,Ligue-1
1856,Mama Samba Baldé,gw GNB,FW,29-187,12.7,12,8,4,3,5,3,14,21.4,11,8,0,8,6,18,14,0,Matches,Brest,Ligue-1
1857,Edimilson Fernandes,ch SUI,"MF,DF",29-027,11.3,9,7,3,6,0,7,12,58.3,5,13,5,8,19,28,36,1,Matches,Brest,Ligue-1
1858,Romain Faivre,fr FRA,"MF,FW",26-302,10.0,13,10,4,5,4,5,10,50.0,5,8,0,8,4,17,3,1,Matches,Brest,Ligue-1
1859,Jordan Amavi,fr FRA,DF,31-064,8.8,24,17,10,11,3,15,21,71.4,6,10,2,8,7,31,18,0,Matches,Brest,Ligue-1
1860,Luc Zogbé,ci CIV,DF,20-049,7.1,32,18,17,11,4,18,26,69.2,8,11,2,9,14,46,22,1,Matches,Brest,Ligue-1
1861,Jonas Martin,fr FRA,MF,35-033,5.5,13,7,10,2,1,6,11,54.5,5,4,1,3,8,21,12,1,Matches,Brest,Ligue-1
1862,Soumaïla Coulibaly,fr FRA,DF,21-210,4.9,4,2,2,2,0,1,1,100.0,0,7,2,5,5,9,26,0,Matches,Brest,Ligue-1
1863,Ibrahim Salah,ma MAR,FW,23-255,4.0,4,2,1,1,2,1,6,16.7,5,2,0,2,2,6,0,0,Matches,Brest,Ligue-1
1864,Grégoire Coudert,fr FRA,GK,26-039,2.0,0,0,0,0,0,0,0,,0,0,0,0,0,0,1,0,Matches,Brest,Ligue-1
1865,Justin Bourgault,fr FRA,DF,19-240,1.4,2,1,1,1,0,0,0,,0,0,0,0,0,2,1,0,Matches,Brest,Ligue-1
1866,Jérémy Le Douaron,fr FRA,FW,27-021,1.1,1,0,0,0,1,0,1,0.0,1,1,0,1,0,1,0,0,Matches,Brest,Ligue-1
1867,Axel Camblan,fr FRA,"MF,FW",21-255,0.3,1,1,0,0,1,1,2,50.0,1,1,0,1,0,1,0,0,Matches,Brest,Ligue-1
1868,Hamidou Makalou,ml MLI,"FW,MF",18-301,0.2,0,0,0,0,0,0,0,,0,0,0,0,0,0,0,0,Matches,Brest,Ligue-1
1869,Hianga Mananga Mbock,fr FRA,MF,25-135,0.2,0,0,0,0,0,0,0,,0,0,0,0,1,1,0,0,Matches,Brest,Ligue-1
1870,Bradley Locko,fr FRA,DF,23-006,0.2,1,1,1,0,0,1,1,100.0,0,1,1,0,0,1,1,0,Matches,Brest,Ligue-1
1871,Sérigné Diop,sn SEN,FW,20-000,0.0,1,0,0,1,0,0,0,,0,1,0,1,0,1,0,0,Matches,Brest,Ligue-1
1872,Gautier Lloris,fr FRA,DF,29-298,29.8,67,43,51,16,0,38,53,71.7,15,33,21,12,31,98,186,0,Matches,Le-Havre,Ligue-1
1873,Loïc Nego,hu HUN,"DF,FW",34-117,26.3,57,34,36,16,5,41,64,64.1,23,17,3,14,28,85,81,0,Matches,Le-Havre,Ligue-1
1874,Abdoulaye Touré,gn GUI,MF,31-070,24.8,61,34,31,21,9,33,57,57.9,24,36,19,17,31,92,40,5,Matches,Le-Havre,Ligue-1
1875,Etienne Youte Kinkoue,fr FRA,DF,23-118,24.8,19,10,11,7,1,13,19,68.4,6,36,23,13,28,47,157,3,Matches,Le-Havre,Ligue-1
1876,Yassine Kechta,ma MAR,"MF,FW",23-076,22.3,57,33,30,20,7,31,74,41.9,43,25,2,23,24,81,29,2,Matches,Le-Havre,Ligue-1
1877,Josué Casimir,fr FRA,"FW,MF",23-230,21.2,37,26,15,15,7,9,17,52.9,8,19,0,19,7,44,35,1,Matches,Le-Havre,Ligue-1
1878,Issa Soumaré,sn SEN,"FW,MF",24-214,20.1,23,12,8,10,5,11,43,25.6,32,17,4,13,16,39,30,0,Matches,Le-Havre,Ligue-1
1879,Arthur Desmas,fr FRA,GK,31-035,18.0,0,0,0,0,0,0,1,0.0,1,0,0,0,0,0,9,1,Matches,Le-Havre,Ligue-1
1880,Mathieu Gorgelin,fr FRA,GK,34-280,15.0,2,2,2,0,0,2,3,66.7,1,0,0,0,0,2,8,2,Matches,Le-Havre,Ligue-1
1881,Arouna Sangante,sn SEN,DF,23-030,13.1,21,14,10,11,0,9,16,56.3,7,11,5,6,21,42,62,3,Matches,Le-Havre,Ligue-1
1882,André Ayew,gh GHA,FW,35-146,15.4,18,10,3,7,8,7,13,53.8,6,9,2,7,3,21,21,1,Matches,Le-Havre,Ligue-1
1883,Christopher Operi,ci CIV,"DF,FW",28-013,13.0,13,9,6,2,5,7,12,58.3,5,20,6,14,14,27,30,0,Matches,Le-Havre,Ligue-1
1884,Timothee Pembele,fr FRA,DF,22-245,12.1,30,22,17,9,4,14,23,60.9,9,16,5,11,11,41,42,0,Matches,Le-Havre,Ligue-1
1885,Oussama Targhalline,ma MAR,MF,22-357,11.0,19,14,12,3,4,5,12,41.7,7,14,7,7,19,38,14,2,Matches,Le-Havre,Ligue-1
1886,Rassoul Ndiaye,sn SEN,MF,23-152,11.8,35,25,19,12,4,11,25,44.0,14,15,4,11,12,47,24,0,Matches,Le-Havre,Ligue-1
1887,Junior Mwanga,fr FRA,MF,22-001,10.6,26,16,10,13,3,11,19,57.9,8,10,3,7,8,34,18,2,Matches,Le-Havre,Ligue-1
1888,Koka,eg EGY,FW,32-068,9.1,4,1,1,3,0,0,4,0.0,4,2,0,2,3,7,6,1,Matches,Le-Havre,Ligue-1
1889,Yanis Zouaoui,dz ALG,"DF,FW",30-306,10.8,20,10,10,8,2,11,15,73.3,4,15,2,13,8,28,43,0,Matches,Le-Havre,Ligue-1
1890,Antoine Joujou,fr FRA,"MF,FW",22-061,10.4,16,11,10,4,2,9,15,60.0,6,15,3,12,9,25,19,0,Matches,Le-Havre,Ligue-1
1891,Yoann Salmier,gf GUF,DF,32-172,8.9,14,7,9,4,1,10,13,76.9,3,12,8,4,10,24,59,0,Matches,Le-Havre,Ligue-1
1892,Fodé Ballo-Touré,sn SEN,DF,28-129,5.7,8,7,3,4,1,5,8,62.5,3,8,3,5,3,11,25,0,Matches,Le-Havre,Ligue-1
1893,Emmanuel Sabbi,us USA,"FW,MF",27-139,7.3,14,7,7,4,3,5,8,62.5,3,2,0,2,3,17,4,0,Matches,Le-Havre,Ligue-1
1894,Daler Kuzyaev,ru RUS,MF,32-117,6.3,13,8,7,4,2,2,9,22.2,7,7,4,3,9,22,8,0,Matches,Le-Havre,Ligue-1
1895,Mahamadou Diawara,fr FRA,MF,20-084,6.3,20,12,10,8,2,8,13,61.5,5,13,6,7,13,33,11,1,Matches,Le-Havre,Ligue-1
1896,Ilyes Housni,fr FRA,"FW,MF",19-363,2.6,7,5,2,3,2,2,4,50.0,2,2,0,2,1,8,2,0,Matches,Le-Havre,Ligue-1
1897,Steve Ngoura,fr FRA,FW,20-079,3.2,4,2,1,1,2,3,3,100.0,0,2,1,1,0,4,2,0,Matches,Le-Havre,Ligue-1
1898,Samuel Grandsir,fr FRA,"MF,FW",28-271,0.9,5,5,0,3,2,2,3,66.7,1,2,0,2,0,5,0,0,Matches,Le-Havre,Ligue-1
1899,Elysée Logbo,fr FRA,FW,21-006,0.3,0,0,0,0,0,0,0,,0,0,0,0,0,0,0,0,Matches,Le-Havre,Ligue-1
1900,Mathéo Bodmer,fr FRA,MF,21-006,0.1,0,0,0,0,0,0,0,,0,0,0,0,0,0,1,0,Matches,Le-Havre,Ligue-1
1901,Kandet Diawara,gn GUI,FW,25-091,0.0,0,0,0,0,0,0,0,,0,1,0,1,0,0,1,0,Matches,Le-Havre,Ligue-1
1902,Alois Confais,fr FRA,MF,28-247,0.0,0,0,0,0,0,0,0,,0,0,0,0,0,0,0,0,Matches,Le-Havre,Ligue-1
1903,Adrien Thomasson,fr FRA,MF,31-153,28.1,87,46,42,24,21,51,93,54.8,42,46,3,43,19,106,28,2,Matches,Lens,Ligue-1
1904,Facundo Medina,ar ARG,DF,25-349,27.3,42,27,21,17,4,23,41,56.1,18,30,10,20,31,73,66,0,Matches,Lens,Ligue-1
1905,Andy Diouf,fr FRA,MF,21-360,23.8,36,25,10,21,5,15,38,39.5,23,24,1,23,13,49,18,2,Matches,Lens,Ligue-1
1906,Jonathan Gradit,fr FRA,DF,32-169,22.5,43,23,22,18,3,22,39,56.4,17,26,11,15,24,67,117,2,Matches,Lens,Ligue-1
1907,Florian Sotoca,fr FRA,"FW,MF",34-199,19.8,22,13,3,8,11,12,22,54.5,10,12,2,10,14,36,25,0,Matches,Lens,Ligue-1
1908,Deiver Machado,co COL,"DF,MF",31-252,20.1,36,26,14,14,8,17,30,56.7,13,20,4,16,16,52,34,2,Matches,Lens,Ligue-1
1909,Neil El Aynaoui,fr FRA,MF,23-314,16.7,38,21,17,15,6,12,34,35.3,22,34,8,26,27,65,29,0,Matches,Lens,Ligue-1
1910,M'Bala Nzola,ao ANG,FW,28-267,16.2,5,4,0,1,4,3,9,33.3,6,9,1,8,5,10,7,0,Matches,Lens,Ligue-1
1911,Przemysław Frankowski,pl POL,DF,30-030,15.4,32,21,17,10,5,19,30,63.3,11,10,2,8,19,51,28,0,Matches,Lens,Ligue-1
1912,Malang Sarr,fr FRA,DF,26-109,15.4,21,13,12,6,3,16,27,59.3,11,18,9,9,22,43,63,3,Matches,Lens,Ligue-1
1913,Brice Samba,fr FRA,GK,31-017,15.0,0,0,0,0,0,0,0,,0,0,0,0,1,1,6,2,Matches,Lens,Ligue-1
1914,Anass Zaroury,ma MAR,"FW,MF",24-186,14.6,20,15,4,11,5,9,24,37.5,15,8,0,8,4,24,15,0,Matches,Lens,Ligue-1
1915,Mathew Ryan,au AUS,GK,33-034,13.0,1,0,1,0,0,1,2,50.0,1,0,0,0,1,2,2,2,Matches,Lens,Ligue-1
1916,Kevin Danso,at AUT,DF,26-235,12.0,19,7,12,5,2,12,16,75.0,4,25,19,6,20,39,62,1,Matches,Lens,Ligue-1
1917,Ruben Aguilar,fr FRA,"DF,MF",32-016,11.6,34,18,17,12,5,24,38,63.2,14,23,3,20,13,47,22,0,Matches,Lens,Ligue-1
1918,Angelo Fulgini,fr FRA,"MF,FW",28-265,11.6,14,10,6,4,4,6,16,37.5,10,11,1,10,2,16,3,0,Matches,Lens,Ligue-1
1919,Abdukodir Khusanov,uz UZB,DF,21-072,10.8,15,11,9,5,1,7,11,63.6,4,17,11,6,26,41,57,0,Matches,Lens,Ligue-1
1920,Wesley Saïd,fr FRA,FW,30-023,10.0,16,11,3,10,3,6,13,46.2,7,6,0,6,2,18,2,0,Matches,Lens,Ligue-1
1921,Goduine Koyalipou,cf CTA,FW,25-086,9.0,2,1,0,2,0,0,0,,0,4,0,4,1,3,7,0,Matches,Lens,Ligue-1
1922,Juma Bah,sl SLE,DF,19-031,6.6,14,10,5,9,0,5,7,71.4,2,10,7,3,16,30,46,1,Matches,Lens,Ligue-1
1923,Jhoanner Chávez,ec ECU,"DF,MF",23-017,6.6,9,5,4,4,1,2,7,28.6,5,10,1,9,6,15,13,0,Matches,Lens,Ligue-1
1924,Rémy Labeau Lascary,gp GLP,"FW,MF",22-070,7.1,16,10,7,6,3,5,11,45.5,6,5,0,5,1,17,7,0,Matches,Lens,Ligue-1
1925,Nampalys Mendy,sn SEN,MF,32-323,5.5,12,7,4,5,3,5,12,41.7,7,7,2,5,6,18,8,0,Matches,Lens,Ligue-1
1926,Hervé Koffi,bf BFA,GK,28-208,5.0,1,1,1,0,0,1,1,100.0,0,0,0,0,0,1,5,0,Matches,Lens,Ligue-1
1927,David Costa,pt POR,"MF,FW",24-127,3.9,2,0,1,1,0,1,4,25.0,3,5,1,4,1,3,0,0,Matches,Lens,Ligue-1
1928,Tom Pouilly,fr FRA,"DF,MF",21-328,2.9,8,6,5,1,2,5,10,50.0,5,5,1,4,3,11,11,0,Matches,Lens,Ligue-1
1929,Kyllian Antonio,fr FRA,"DF,MF",17-128,1.5,3,2,2,0,1,1,3,33.3,2,3,0,3,3,6,3,1,Matches,Lens,Ligue-1
1930,Hamzat Ojediran,ng NGA,"MF,FW",21-179,4.6,28,15,12,13,3,7,19,36.8,12,10,2,8,10,38,7,0,Matches,Lens,Ligue-1
1931,Jeremy Agbonifo,se SWE,"FW,MF",19-200,3.3,7,6,6,0,1,3,7,42.9,4,2,1,1,1,8,0,1,Matches,Lens,Ligue-1
1932,Martin Satriano,uy URU,"FW,DF",24-081,0.9,3,1,1,1,1,3,3,100.0,0,0,0,0,0,3,2,0,Matches,Lens,Ligue-1
1933,Rayan Fofana,fr FRA,"FW,MF",19-089,0.3,2,2,1,1,0,0,0,,0,0,0,0,0,2,0,0,Matches,Lens,Ligue-1
1934,Gabin Capuano,fr FRA,FW,19-016,0.1,0,0,0,0,0,0,0,,0,0,0,0,0,0,0,0,Matches,Lens,Ligue-1
1935,Kembo Diliwidi,fr FRA,DF,19-098,0.0,0,0,0,0,0,0,0,,0,0,0,0,0,0,0,0,Matches,Lens,Ligue-1
1936,Lucas Chevalier,fr FRA,GK,23-187,33.0,3,2,3,0,0,3,4,75.0,1,0,0,0,0,3,13,4,Matches,Lille,Ligue-1
1937,Bafodé Diakité,fr FRA,DF,24-126,29.7,31,18,17,11,3,18,26,69.2,8,30,17,13,27,58,96,5,Matches,Lille,Ligue-1
1938,Alexsandro Ribeiro,br BRA,DF,25-276,29.0,31,18,18,12,1,20,30,66.7,10,23,13,10,26,57,140,3,Matches,Lille,Ligue-1
1939,Benjamin André,fr FRA,MF,34-282,28.9,102,57,30,60,12,53,93,57.0,40,42,6,36,48,150,54,0,Matches,Lille,Ligue-1
1940,Jonathan David,ca CAN,FW,25-118,27.6,23,7,3,12,8,9,21,42.9,12,13,2,11,6,29,9,1,Matches,Lille,Ligue-1
1941,Thomas Meunier,be BEL,DF,33-242,20.4,52,37,31,15,6,33,49,67.3,16,21,8,13,34,86,63,0,Matches,Lille,Ligue-1
1942,Aïssa Mandi,dz ALG,DF,33-202,19.3,31,17,12,15,4,16,22,72.7,6,23,11,12,15,46,54,0,Matches,Lille,Ligue-1
1943,Hákon Arnar Haraldsson,is ISL,"MF,FW",22-032,18.5,33,15,9,15,9,14,31,45.2,17,9,1,8,8,41,4,0,Matches,Lille,Ligue-1
1944,Gabriel Gudmundsson,se SWE,DF,26-013,18.8,34,23,13,15,6,21,34,61.8,13,18,7,11,15,49,39,3,Matches,Lille,Ligue-1
1945,André Gomes,pt POR,MF,31-286,14.2,27,13,9,11,7,11,31,35.5,20,7,1,6,6,33,11,2,Matches,Lille,Ligue-1
1946,Ngal'Ayel Mukau,cd COD,MF,20-163,13.2,32,18,9,21,2,16,28,57.1,12,14,0,14,15,47,21,0,Matches,Lille,Ligue-1
1947,Mitchel Bakker,nl NED,"FW,DF",24-326,12.7,23,13,6,11,6,10,19,52.6,9,10,1,9,12,35,15,0,Matches,Lille,Ligue-1
1948,Edon Zhegrova,xk KVX,"FW,MF",26-042,10.9,5,2,3,0,2,2,7,28.6,5,8,0,8,4,9,1,0,Matches,Lille,Ligue-1
1949,Matias Fernandez-Pardo,be BEL,"FW,MF",20-098,10.8,12,9,3,6,3,6,12,50.0,6,9,0,9,2,14,6,0,Matches,Lille,Ligue-1
1950,Rémy Cabella,fr FRA,"FW,MF",35-065,10.3,35,18,15,11,9,18,31,58.1,13,10,1,9,8,43,4,0,Matches,Lille,Ligue-1
1951,Osame Sahraoui,ma MAR,"FW,MF",23-335,14.2,12,9,3,4,5,3,8,37.5,5,14,1,13,7,19,8,1,Matches,Lille,Ligue-1
1952,Ayyoub Bouaddi,fr FRA,MF,17-222,11.9,49,30,21,20,8,18,31,58.1,13,11,3,8,10,59,12,1,Matches,Lille,Ligue-1
1953,Ismaily,br BRA,DF,35-121,10.0,33,17,17,12,4,17,26,65.4,9,15,1,14,13,46,49,0,Matches,Lille,Ligue-1
1954,Angel Gomes,eng ENG,MF,24-254,8.2,10,6,4,4,2,2,12,16.7,10,0,0,0,0,10,2,0,Matches,Lille,Ligue-1
1955,Chuba Akpom,eng ENG,FW,29-215,6.9,8,5,0,4,4,2,6,33.3,4,9,0,9,0,8,3,0,Matches,Lille,Ligue-1
1956,Tiago Santos,pt POR,DF,22-293,4.5,12,7,4,5,3,6,9,66.7,3,2,0,2,2,14,4,0,Matches,Lille,Ligue-1
1957,Mohamed Lamine Bayo,gn GUI,FW,26-342,3.4,1,1,0,0,1,1,1,100.0,0,0,0,0,0,1,4,0,Matches,Lille,Ligue-1
1958,Nabil Bentaleb,dz ALG,MF,30-169,3.7,4,3,2,0,2,3,7,42.9,4,5,0,5,5,9,7,2,Matches,Lille,Ligue-1
1959,Ethan Mbappé,fr FRA,"MF,FW",18-134,2.5,6,2,3,2,1,0,4,0.0,4,6,0,6,1,7,0,0,Matches,Lille,Ligue-1
1960,Younes Lachaab,fr FRA,"MF,FW",20-126,0.1,1,1,0,0,1,1,1,100.0,0,0,0,0,1,2,0,0,Matches,Lille,Ligue-1
1961,Ousmane Toure,fr FRA,DF,20-083,0.1,0,0,0,0,0,0,0,,0,0,0,0,1,1,2,0,Matches,Lille,Ligue-1
1962,Aaron Malouda,fr FRA,FW,19-163,0.0,0,0,0,0,0,0,0,,0,0,0,0,0,0,0,0,Matches,Lille,Ligue-1
1963,Lucas Perri,br BRA,GK,27-153,32.0,1,1,1,0,0,0,4,0.0,4,1,0,1,0,1,21,1,Matches,Lyon,Ligue-1
1964,Moussa Niakhate,sn SEN,DF,29-065,29.3,45,25,36,7,2,22,30,73.3,8,22,14,8,25,70,139,3,Matches,Lyon,Ligue-1
1965,Clinton Mata,ao ANG,DF,32-186,26.3,41,29,23,14,4,28,36,77.8,8,26,17,9,46,87,72,3,Matches,Lyon,Ligue-1
1966,Corentin Tolisso,fr FRA,MF,30-282,25.7,57,25,21,26,10,34,65,52.3,31,52,13,39,22,79,41,1,Matches,Lyon,Ligue-1
1967,Nemanja Matić,rs SRB,MF,36-284,22.1,41,29,14,21,6,22,40,55.0,18,21,9,12,18,59,30,1,Matches,Lyon,Ligue-1
1968,Alexandre Lacazette,fr FRA,FW,33-349,21.9,13,6,3,7,3,5,16,31.3,11,12,2,10,8,21,6,0,Matches,Lyon,Ligue-1
1969,Rayan Cherki,fr FRA,"FW,MF",21-268,21.7,14,11,3,7,4,5,26,19.2,21,6,0,6,7,21,6,0,Matches,Lyon,Ligue-1
1970,Nicolás Tagliafico,ar ARG,DF,32-254,20.1,54,35,23,21,10,27,46,58.7,19,25,7,18,34,88,52,0,Matches,Lyon,Ligue-1
1971,Ainsley Maitland-Niles,eng ENG,DF,27-256,21.1,70,43,30,26,14,48,74,64.9,26,28,4,24,25,95,57,6,Matches,Lyon,Ligue-1
1972,Jordan Veretout,fr FRA,MF,32-072,16.3,28,14,13,13,2,17,40,42.5,23,15,2,13,5,33,23,1,Matches,Lyon,Ligue-1
1973,Duje Ćaleta-Car,hr CRO,DF,28-237,16.6,20,12,11,9,0,10,19,52.6,9,31,23,8,16,36,94,2,Matches,Lyon,Ligue-1
1974,Malick Fofana,be BEL,FW,20-042,16.7,21,10,8,11,2,7,15,46.7,8,12,0,12,8,29,6,0,Matches,Lyon,Ligue-1
1975,Georges Mikautadze,ge GEO,FW,24-193,16.0,7,6,1,3,3,3,9,33.3,6,11,0,11,4,11,5,0,Matches,Lyon,Ligue-1
1976,Ernest Nuamah,gh GHA,"FW,MF",21-192,11.7,21,11,15,4,2,12,27,44.4,15,9,1,8,8,29,8,1,Matches,Lyon,Ligue-1
1977,Tanner Tessmann,us USA,MF,23-230,13.0,23,14,10,9,4,11,24,45.8,13,13,7,6,19,42,28,1,Matches,Lyon,Ligue-1
1978,Abner,br BRA,DF,24-350,12.1,29,20,12,10,7,21,32,65.6,11,15,2,13,5,34,41,0,Matches,Lyon,Ligue-1
1979,Sael Kumbedi,fr FRA,DF,20-047,10.6,28,14,11,13,4,14,20,70.0,6,11,3,8,8,36,32,1,Matches,Lyon,Ligue-1
1980,Saïd Benrahma,dz ALG,"FW,MF",29-275,8.2,9,5,4,4,1,3,10,30.0,7,6,0,6,3,12,2,0,Matches,Lyon,Ligue-1
1981,Thiago Almada,ar ARG,"MF,FW",24-016,9.7,13,8,7,4,2,7,21,33.3,14,2,0,2,7,20,5,3,Matches,Lyon,Ligue-1
1982,Maxence Caqueret,fr FRA,MF,25-086,6.4,21,11,5,11,5,4,22,18.2,18,12,2,10,7,28,2,0,Matches,Lyon,Ligue-1
1983,Gift Orban,ng NGA,"FW,DF",22-299,2.1,0,0,0,0,0,0,1,0.0,1,0,0,0,0,0,0,0,Matches,Lyon,Ligue-1
1984,Rémy Descamps,fr FRA,GK,28-321,1.0,0,0,0,0,0,0,0,,0,0,0,0,0,0,0,0,Matches,Lyon,Ligue-1
1985,Wilfried Zaha,ci CIV,FW,32-183,0.8,1,1,1,0,0,1,2,50.0,1,3,0,3,1,2,0,0,Matches,Lyon,Ligue-1
1986,Orel Mangala,be BEL,MF,27-055,0.7,1,0,0,0,1,0,1,0.0,1,2,0,2,0,1,1,0,Matches,Lyon,Ligue-1
1987,Mama Samba Baldé,gw GNB,FW,29-187,0.4,2,2,0,2,0,0,0,,0,0,0,0,1,3,1,0,Matches,Lyon,Ligue-1
1988,Alejandro Rodriguez,pt POR,MF,17-063,0.2,0,0,0,0,0,0,0,,0,0,0,0,0,0,0,0,Matches,Lyon,Ligue-1
1989,Paul Akouokou,ci CIV,MF,27-143,0.2,1,0,0,1,0,0,0,,0,0,0,0,1,2,0,1,Matches,Lyon,Ligue-1
1990,Mahamadou Diawara,fr FRA,MF,20-084,0.2,1,0,0,1,0,1,3,33.3,2,2,0,2,0,1,0,0,Matches,Lyon,Ligue-1
1991,Warmed Omari,km COM,DF,25-019,0.1,0,0,0,0,0,0,0,,0,0,0,0,0,0,1,0,Matches,Lyon,Ligue-1
1992,Adryelson,br BRA,DF,27-050,0.0,0,0,0,0,0,0,0,,0,0,0,0,1,1,1,0,Matches,Lyon,Ligue-1
1993,Gerónimo Rulli,ar ARG,GK,32-357,33.0,4,3,4,0,0,4,8,50.0,4,1,0,1,1,5,25,3,Matches,Marseille,Ligue-1
1994,Mason Greenwood,eng ENG,"FW,MF",23-223,30.2,33,17,10,13,10,16,37,43.2,21,7,0,7,11,44,5,2,Matches,Marseille,Ligue-1
1995,Luis Henrique,br BRA,"DF,FW",23-149,29.0,16,9,7,6,3,9,10,90.0,1,15,2,13,10,26,30,0,Matches,Marseille,Ligue-1
1996,Pierre Højbjerg,dk DEN,MF,29-280,28.6,57,39,23,27,7,33,65,50.8,32,28,4,24,42,99,32,2,Matches,Marseille,Ligue-1
1997,Adrien Rabiot,fr FRA,MF,30-039,26.6,49,31,17,21,11,19,32,59.4,13,21,2,19,21,70,31,0,Matches,Marseille,Ligue-1
1998,Michael Amir Murillo,pa PAN,DF,29-090,26.1,49,31,30,13,6,32,46,69.6,14,19,7,12,18,67,68,4,Matches,Marseille,Ligue-1
1999,Leonardo Balerdi,ar ARG,DF,26-106,24.3,50,35,28,17,5,25,45,55.6,20,24,14,10,32,82,70,4,Matches,Marseille,Ligue-1
2000,Geoffrey Kondogbia,cf CTA,"DF,MF",32-086,22.4,60,38,31,26,3,27,34,79.4,7,23,6,17,22,82,64,4,Matches,Marseille,Ligue-1
2001,Quentin Merlin,fr FRA,DF,22-361,17.0,20,15,10,5,5,7,13,53.8,6,18,4,14,13,33,16,1,Matches,Marseille,Ligue-1
2002,Valentin Rongier,fr FRA,"MF,DF",30-156,17.4,50,28,14,31,5,27,43,62.8,16,30,9,21,33,83,28,5,Matches,Marseille,Ligue-1
2003,Derek Cornelius,ca CAN,DF,27-168,15.8,24,17,15,8,1,17,22,77.3,5,16,10,6,14,38,51,0,Matches,Marseille,Ligue-1
2004,Neal Maupay,fr FRA,FW,28-271,11.5,9,4,1,6,2,3,6,50.0,3,5,0,5,2,11,0,0,Matches,Marseille,Ligue-1
2005,Amine Gouiri,dz ALG,"FW,MF",25-085,10.7,5,5,0,1,4,2,3,66.7,1,7,0,7,1,6,1,0,Matches,Marseille,Ligue-1
2006,Ulisses Garcia,ch SUI,DF,29-121,10.3,14,11,7,5,2,4,14,28.6,10,5,1,4,8,22,18,0,Matches,Marseille,Ligue-1
2007,Lilian Brassier,fr FRA,DF,25-191,8.7,8,6,8,0,0,5,6,83.3,1,8,3,5,9,17,28,2,Matches,Marseille,Ligue-1
2008,Amine Harit,ma MAR,MF,27-328,5.5,8,7,0,6,2,1,2,50.0,1,6,0,6,3,11,1,1,Matches,Marseille,Ligue-1
2009,Ismaël Bennacer,dz ALG,MF,27-162,6.5,21,10,8,12,1,12,17,70.6,5,5,0,5,10,31,1,1,Matches,Marseille,Ligue-1
2010,Elye Wahi,fr FRA,FW,22-130,6.4,0,0,0,0,0,0,4,0.0,4,1,0,1,1,1,0,0,Matches,Marseille,Ligue-1
2011,Jon Rowe,eng ENG,"FW,MF",22-012,8.2,14,11,4,4,6,5,12,41.7,7,3,1,2,2,16,3,0,Matches,Marseille,Ligue-1
2012,Pol Lirola,es ESP,DF,27-272,7.1,13,9,5,8,0,5,13,38.5,8,7,2,5,4,17,11,0,Matches,Marseille,Ligue-1
2013,Bilal Nadir,ma MAR,MF,21-165,4.0,10,3,4,6,0,4,6,66.7,2,6,1,5,2,12,7,0,Matches,Marseille,Ligue-1
2014,Ismaël Koné,ca CAN,"MF,FW",22-340,4.0,8,4,3,3,2,3,4,75.0,1,4,1,3,4,12,2,1,Matches,Marseille,Ligue-1
2015,Amar Dedić,ba BIH,DF,22-267,3.2,5,4,2,2,1,3,10,30.0,7,0,0,0,3,8,10,1,Matches,Marseille,Ligue-1
2016,Valentin Carboni,ar ARG,"MF,FW",20-068,1.1,2,2,0,1,1,0,1,0.0,1,1,0,1,1,3,1,0,Matches,Marseille,Ligue-1
2017,Luiz Felipe,it ITA,DF,28-051,0.9,2,1,2,0,0,0,1,0.0,1,2,2,0,1,3,4,0,Matches,Marseille,Ligue-1
2018,Robinio Vaz,fr FRA,FW,18-084,0.8,1,1,0,0,1,0,2,0.0,2,0,0,0,0,1,2,0,Matches,Marseille,Ligue-1
2019,Bamo Meïté,ci CIV,DF,23-160,0.3,0,0,0,0,0,0,0,,0,0,0,0,0,0,1,0,Matches,Marseille,Ligue-1
2020,Enzo Sternal,fr FRA,"FW,MF",17-349,0.3,0,0,0,0,0,0,0,,0,0,0,0,0,0,0,0,Matches,Marseille,Ligue-1
2021,Darryl Bakola,fr FRA,"DF,MF",17-163,0.2,1,1,0,1,0,0,0,,0,0,0,0,0,1,0,0,Matches,Marseille,Ligue-1
2022,Emmanuel Koum Mbondo,fr FRA,DF,19-096,0.1,0,0,0,0,0,0,0,,0,0,0,0,0,0,0,0,Matches,Marseille,Ligue-1
2023,Faris Pemi Moumbagna,cm CMR,FW,24-315,0.1,0,0,0,0,0,0,0,,0,0,0,0,0,0,0,0,Matches,Marseille,Ligue-1
2024,Keyliane Abdallah,fr FRA,FW,19-037,0.0,1,1,1,0,0,1,1,100.0,0,0,0,0,0,1,0,0,Matches,Marseille,Ligue-1
2025,Maghnes Akliouche,fr FRA,"FW,MF",23-076,26.6,51,31,12,24,15,19,41,46.3,22,21,0,21,15,66,13,0,Matches,Monaco,Ligue-1
2026,Thilo Kehrer,de GER,DF,28-233,26.5,37,23,26,11,0,22,38,57.9,16,18,10,8,36,73,113,1,Matches,Monaco,Ligue-1
2027,Takumi Minamino,jp JPN,"MF,FW",30-116,23.9,32,19,7,14,11,15,41,36.6,26,24,1,23,9,41,20,0,Matches,Monaco,Ligue-1
2028,Denis Zakaria,ch SUI,MF,28-173,23.7,41,26,15,19,7,24,33,72.7,9,31,8,23,33,74,39,1,Matches,Monaco,Ligue-1
2029,Lamine Camara,sn SEN,MF,21-131,21.8,63,38,21,32,10,26,48,54.2,22,27,4,23,30,93,32,1,Matches,Monaco,Ligue-1
2030,Vanderson,br BRA,DF,23-325,22.4,76,48,37,30,9,45,63,71.4,18,42,6,36,39,115,65,2,Matches,Monaco,Ligue-1
2031,Wilfried Singo,ci CIV,DF,24-138,22.3,37,23,24,10,3,20,28,71.4,8,14,6,8,42,79,107,2,Matches,Monaco,Ligue-1
2032,Caio Henrique Oliveira Silva,br BRA,DF,27-285,20.4,37,26,16,19,2,23,42,54.8,19,25,7,18,21,58,56,0,Matches,Monaco,Ligue-1
2033,Breel Embolo,ch SUI,"FW,MF",28-087,20.5,22,17,7,7,8,5,16,31.3,11,11,0,11,3,25,10,1,Matches,Monaco,Ligue-1
2034,Eliesse Ben Seghir,ma MAR,"MF,FW",20-085,18.5,29,21,10,12,7,17,30,56.7,13,17,0,17,12,41,3,0,Matches,Monaco,Ligue-1
2035,Philipp Köhn,ch SUI,GK,27-040,18.0,0,0,0,0,0,0,1,0.0,1,0,0,0,0,0,11,2,Matches,Monaco,Ligue-1
2036,Christian Mawissa,fr FRA,DF,20-024,15.7,40,28,26,12,2,26,43,60.5,17,22,5,17,25,65,41,1,Matches,Monaco,Ligue-1
2037,Mika Biereth,dk DEN,FW,22-093,13.6,5,5,0,3,2,3,7,42.9,4,11,0,11,4,9,7,0,Matches,Monaco,Ligue-1
2038,Radosław Majecki,pl POL,GK,25-177,15.0,0,0,0,0,0,0,2,0.0,2,0,0,0,0,0,8,1,Matches,Monaco,Ligue-1
2039,Aleksandr Golovin,ru RUS,"MF,FW",28-347,12.8,38,24,9,20,9,17,39,43.6,22,16,4,12,12,50,7,0,Matches,Monaco,Ligue-1
2040,Mohammed Salisu,gh GHA,DF,26-025,11.4,28,18,16,11,1,13,16,81.3,3,10,8,2,16,44,54,2,Matches,Monaco,Ligue-1
2041,Soungoutou Magassa,fr FRA,MF,21-216,10.8,44,24,13,25,6,25,45,55.6,20,16,3,13,21,65,19,1,Matches,Monaco,Ligue-1
2042,Folarin Balogun,us USA,FW,23-313,6.8,1,1,0,0,1,0,4,0.0,4,0,0,0,1,2,0,0,Matches,Monaco,Ligue-1
2043,Jordan Teze,nl NED,DF,25-224,5.8,18,9,8,9,1,7,16,43.8,9,12,1,11,6,24,14,0,Matches,Monaco,Ligue-1
2044,George Ilenikhena,fr FRA,"FW,MF",18-269,7.2,1,1,0,1,0,0,1,0.0,1,0,0,0,2,3,0,0,Matches,Monaco,Ligue-1
2045,Kassoum Ouattara,fr FRA,"DF,FW",20-210,4.3,9,7,5,4,0,4,14,28.6,10,6,0,6,5,14,2,1,Matches,Monaco,Ligue-1
2046,Almoatasem Al Musrati,ly LBY,MF,29-036,4.3,14,11,5,8,1,7,11,63.6,4,3,1,2,5,19,9,0,Matches,Monaco,Ligue-1
2047,Krépin Diatta,sn SEN,DF,26-076,4.9,18,12,13,2,3,14,23,60.9,9,5,1,4,7,25,11,2,Matches,Monaco,Ligue-1
2048,Ismail Jakobs,sn SEN,DF,25-268,2.0,5,5,3,0,2,3,5,60.0,2,0,0,0,2,7,6,0,Matches,Monaco,Ligue-1
2049,Saïmon Bouabré,fr FRA,"MF,FW",18-345,0.8,0,0,0,0,0,0,3,0.0,3,1,0,1,0,0,0,0,Matches,Monaco,Ligue-1
2050,Eliot Matazo,be BEL,MF,23-086,0.8,3,2,0,3,0,0,0,,0,0,0,0,1,4,2,0,Matches,Monaco,Ligue-1
2051,Lucas Michal,fr FRA,"FW,MF",19-325,1.1,5,3,3,2,0,2,4,50.0,2,2,0,2,1,6,2,0,Matches,Monaco,Ligue-1
2052,Mamadou Coulibaly,fr FRA,MF,21-021,0.1,1,0,0,1,0,0,0,,0,0,0,0,0,1,0,0,Matches,Monaco,Ligue-1
2053,Benjamin Lecomte,fr FRA,GK,34-016,29.0,0,0,0,0,0,0,0,,0,0,0,0,0,0,18,2,Matches,Montpellier,Ligue-1
2054,Téji Savanier,fr FRA,MF,33-141,24.8,29,24,7,16,6,18,43,41.9,25,16,1,15,14,43,21,4,Matches,Montpellier,Ligue-1
2055,Modibo Sagnan,ml MLI,DF,26-028,22.3,56,34,37,16,3,26,44,59.1,18,24,13,11,26,82,109,5,Matches,Montpellier,Ligue-1
2056,Joris Chotard,fr FRA,MF,23-230,19.0,39,25,17,20,2,20,43,46.5,23,27,9,18,19,58,52,1,Matches,Montpellier,Ligue-1
2057,Enzo Tchato,cm CMR,DF,22-170,20.8,47,25,26,17,4,26,44,59.1,18,29,9,20,22,69,57,0,Matches,Montpellier,Ligue-1
2058,Becir Omeragic,ch SUI,"DF,MF",23-112,19.0,31,15,19,11,1,16,21,76.2,5,30,20,10,13,44,73,0,Matches,Montpellier,Ligue-1
2059,Jordan Ferri,fr FRA,MF,33-061,18.7,39,20,17,20,2,17,42,40.5,25,20,3,17,9,48,20,0,Matches,Montpellier,Ligue-1
2060,Rabby Nzingoula,cg CGO,MF,19-168,18.3,64,40,26,31,7,27,58,46.6,31,27,5,22,28,92,23,0,Matches,Montpellier,Ligue-1
2061,Tanguy Coulibaly,fr FRA,"FW,MF",24-083,14.5,31,22,12,15,4,13,31,41.9,18,16,1,15,10,41,2,1,Matches,Montpellier,Ligue-1
2062,Issiaga Sylla,gn GUI,DF,31-131,12.3,25,9,17,7,1,15,29,51.7,14,13,4,9,10,35,34,1,Matches,Montpellier,Ligue-1
2063,Arnaud Nordin,fr FRA,FW,26-329,13.0,24,15,6,16,2,11,21,52.4,10,12,0,12,5,29,7,0,Matches,Montpellier,Ligue-1
2064,Falaye Sacko,ml MLI,DF,30-011,12.7,14,8,9,4,1,9,19,47.4,10,17,7,10,12,26,21,0,Matches,Montpellier,Ligue-1
2065,Akor Adams,ng NGA,FW,25-103,11.9,4,3,1,2,1,3,4,75.0,1,2,1,1,1,5,5,1,Matches,Montpellier,Ligue-1
2066,Musa Al-Taamari,jo JOR,"FW,MF",27-336,12.4,14,10,4,5,5,8,15,53.3,7,2,0,2,3,17,3,2,Matches,Montpellier,Ligue-1
2067,Wahbi Khazri,tn TUN,"FW,MF",34-093,11.9,25,18,5,16,4,8,21,38.1,13,13,1,12,5,30,7,0,Matches,Montpellier,Ligue-1
2068,Khalil Fayad,fr FRA,"MF,FW",20-337,11.4,31,16,12,17,2,15,28,53.6,13,18,1,17,10,41,15,1,Matches,Montpellier,Ligue-1
2069,Théo Sainte-Luce,fr FRA,DF,26-204,10.8,24,11,16,4,4,16,33,48.5,17,16,4,12,11,35,33,1,Matches,Montpellier,Ligue-1
2070,Yael Mouanga,fr FRA,DF,19-293,10.0,12,7,8,2,2,6,8,75.0,2,16,8,8,10,22,48,0,Matches,Montpellier,Ligue-1
2071,Boubakar Kouyaté,ml MLI,DF,28-027,7.4,22,15,16,6,0,11,19,57.9,8,17,11,6,12,34,54,0,Matches,Montpellier,Ligue-1
2072,Lucas Mincarelli,fr FRA,DF,21-127,6.9,13,8,5,6,2,5,12,41.7,7,5,3,2,9,22,27,0,Matches,Montpellier,Ligue-1
2073,Nikola Maksimović,rs SRB,DF,33-168,6.5,9,5,6,3,0,6,7,85.7,1,5,4,1,6,15,30,1,Matches,Montpellier,Ligue-1
2074,Andy Delort,dz ALG,FW,33-215,5.7,4,3,1,2,1,1,2,50.0,1,3,1,2,0,4,3,0,Matches,Montpellier,Ligue-1
2075,Bamo Meïté,ci CIV,DF,23-160,4.7,5,3,2,1,2,1,2,50.0,1,3,3,0,4,9,14,3,Matches,Montpellier,Ligue-1
2076,Nicolas Pays,fr FRA,"FW,MF",21-278,5.0,13,6,3,4,6,4,8,50.0,4,1,0,1,4,17,2,0,Matches,Montpellier,Ligue-1
2077,Junior Ndiaye,fr FRA,FW,20-044,3.9,2,1,1,1,0,1,2,50.0,1,2,1,1,0,2,2,0,Matches,Montpellier,Ligue-1
2078,Wilfried Ndollo,cm CMR,DF,19-303,3.7,6,5,4,1,1,4,7,57.1,3,7,1,6,6,12,9,0,Matches,Montpellier,Ligue-1
2079,Dimitry Bertaud,cd COD,GK,26-340,3.0,0,0,0,0,0,0,0,,0,0,0,0,0,0,2,0,Matches,Montpellier,Ligue-1
2080,Birama Touré,ml MLI,"MF,DF",32-340,3.3,8,5,5,2,1,4,6,66.7,2,3,2,1,6,14,7,0,Matches,Montpellier,Ligue-1
2081,Stefan Džodić,rs SRB,"DF,MF",20-058,2.2,8,5,3,5,0,5,7,71.4,2,5,4,1,4,12,8,0,Matches,Montpellier,Ligue-1
2082,Othmane Maamma,ma MAR,"FW,MF",19-218,3.0,3,1,2,1,0,1,4,25.0,3,4,0,4,1,4,2,1,Matches,Montpellier,Ligue-1
2083,Théo Chennahi,fr FRA,DF,20-095,1.0,4,3,1,3,0,3,6,50.0,3,2,0,2,1,5,1,0,Matches,Montpellier,Ligue-1
2084,Yanis Issoufou,fr FRA,"MF,FW",18-196,0.9,6,4,4,1,1,3,5,60.0,2,1,0,1,0,6,1,0,Matches,Montpellier,Ligue-1
2085,Gabriel Bares,ch SUI,"MF,DF",24-256,0.6,2,2,2,0,0,1,2,50.0,1,0,0,0,1,3,3,0,Matches,Montpellier,Ligue-1
2086,Axel Gueguin,fr FRA,FW,20-049,0.3,1,1,0,1,0,1,1,100.0,0,0,0,0,0,1,0,0,Matches,Montpellier,Ligue-1
2087,Simon Cara,fr FRA,"MF,FW",19-346,0.1,0,0,0,0,0,0,0,,0,0,0,0,0,0,0,0,Matches,Montpellier,Ligue-1
2088,Matthis Abline,fr FRA,FW,22-045,29.8,11,5,2,4,5,3,9,33.3,6,15,1,14,3,14,34,1,Matches,Nantes,Ligue-1
2089,Moses Simon,ng NGA,"FW,MF",29-304,28.0,20,14,4,7,9,7,22,31.8,15,11,0,11,12,32,13,0,Matches,Nantes,Ligue-1
2090,Jean-Charles Castelletto,cm CMR,"DF,MF",30-106,28.1,31,14,15,14,2,16,25,64.0,9,27,18,9,25,56,146,0,Matches,Nantes,Ligue-1
2091,Pedro Chirivella,es ESP,MF,27-354,25.1,41,28,20,16,5,18,41,43.9,23,24,3,21,16,57,42,0,Matches,Nantes,Ligue-1
2092,Douglas,br BRA,MF,28-119,24.6,66,39,28,30,8,25,42,59.5,17,49,11,38,31,97,46,0,Matches,Nantes,Ligue-1
2093,Nicolas Cozza,fr FRA,"DF,MF",26-124,22.8,59,41,35,18,6,31,47,66.0,16,25,10,15,25,84,69,0,Matches,Nantes,Ligue-1
2094,Johann Lepenant,fr FRA,MF,22-202,22.6,67,32,29,27,11,32,71,45.1,39,34,3,31,18,85,25,0,Matches,Nantes,Ligue-1
2095,Kelvin Amian,fr FRA,DF,27-093,23.1,54,30,39,14,1,29,35,82.9,6,17,10,7,11,65,82,0,Matches,Nantes,Ligue-1
2096,Nicolas Pallois,fr FRA,DF,37-235,21.6,60,26,43,13,4,37,61,60.7,24,47,17,30,28,88,163,3,Matches,Nantes,Ligue-1
2097,Nathan Zeze,fr FRA,DF,19-328,16.6,38,22,22,16,0,23,33,69.7,10,22,9,13,23,61,120,1,Matches,Nantes,Ligue-1
2098,Anthony Lopes,pt POR,GK,34-223,16.4,1,0,1,0,0,1,1,100.0,0,0,0,0,0,1,7,1,Matches,Nantes,Ligue-1
2099,Sorba Thomas,wls WAL,"FW,MF",25-263,13.9,12,6,6,4,2,8,16,50.0,8,10,1,9,7,19,25,1,Matches,Nantes,Ligue-1
2100,Alban Lafont,fr FRA,GK,26-109,12.0,1,1,1,0,0,1,1,100.0,0,2,0,2,0,1,8,1,Matches,Nantes,Ligue-1
2101,Mostafa Mohamed,eg EGY,FW,27-165,13.9,18,9,6,8,4,4,12,33.3,8,10,2,8,10,28,27,0,Matches,Nantes,Ligue-1
2102,Marcus Coco,fr FRA,DF,28-322,10.6,27,21,15,9,3,16,31,51.6,15,16,5,11,11,38,46,0,Matches,Nantes,Ligue-1
2103,Saidou Sow,gn GUI,DF,22-312,8.9,17,11,13,4,0,6,10,60.0,4,19,12,7,13,30,46,1,Matches,Nantes,Ligue-1
2104,Louis Leroux,fr FRA,"MF,DF",19-109,8.1,22,16,10,9,3,13,18,72.2,5,19,2,17,7,29,15,1,Matches,Nantes,Ligue-1
2105,Jean-Kevin Duverne,ht HAI,DF,27-304,6.0,21,12,13,4,4,15,27,55.6,12,10,3,7,8,29,23,0,Matches,Nantes,Ligue-1
2106,Tino Kadewere,zw ZIM,"MF,FW",29-127,5.7,14,8,5,3,6,6,13,46.2,7,3,0,3,6,20,8,0,Matches,Nantes,Ligue-1
2107,Patrik Carlgren,se SWE,GK,33-124,4.6,0,0,0,0,0,0,0,,0,0,0,0,0,0,0,0,Matches,Nantes,Ligue-1
2108,Fabien Centonze,fr FRA,DF,29-116,2.7,8,4,5,2,1,4,6,66.7,2,4,1,3,2,10,17,0,Matches,Nantes,Ligue-1
2109,Florent Mollet,fr FRA,"MF,FW",33-174,2.7,2,2,1,1,0,1,1,100.0,0,2,0,2,1,3,4,0,Matches,Nantes,Ligue-1
2110,Bahereba Guirassy,fr FRA,"FW,MF",18-256,3.8,12,8,6,3,3,7,13,53.8,6,10,0,10,1,13,4,0,Matches,Nantes,Ligue-1
2111,Jean-Philippe Gbamin,ci CIV,MF,29-229,2.4,2,1,0,2,0,1,4,25.0,3,5,2,3,3,5,2,0,Matches,Nantes,Ligue-1
2112,Francis Coquelin,fr FRA,MF,33-364,1.7,6,2,4,2,0,1,2,50.0,1,3,1,2,5,11,3,0,Matches,Nantes,Ligue-1
2113,Ignatius Ganago,cm CMR,"FW,MF",26-085,2.7,1,1,0,1,0,1,2,50.0,1,3,1,2,4,5,2,0,Matches,Nantes,Ligue-1
2114,Meschak Elia,cd COD,FW,27-279,1.9,7,5,3,2,2,1,1,100.0,0,3,0,3,0,7,2,0,Matches,Nantes,Ligue-1
2115,Dehmaine Assoumani,fr FRA,"MF,FW",20-025,1.1,6,3,0,4,2,4,5,80.0,1,1,0,1,1,7,4,0,Matches,Nantes,Ligue-1
2116,Plamedi Nsingi,,MF,24-146,0.2,1,0,1,0,0,0,1,0.0,1,0,0,0,0,1,0,0,Matches,Nantes,Ligue-1
2117,Sékou Doucoure,fr FRA,DF,20-016,0.1,0,0,0,0,0,0,0,,0,0,0,0,0,0,3,0,Matches,Nantes,Ligue-1
2118,Marcin Bułka,pl POL,GK,25-220,33.0,0,0,0,0,0,0,1,0.0,1,0,0,0,0,0,16,6,Matches,Nice,Ligue-1
2119,Evann Guessand,ci CIV,"FW,MF",23-315,27.6,41,27,12,15,14,6,13,46.2,7,25,3,22,15,56,16,0,Matches,Nice,Ligue-1
2120,Hicham Boudaoui,dz ALG,MF,25-231,26.1,75,52,28,36,11,31,53,58.5,22,39,11,28,22,97,44,1,Matches,Nice,Ligue-1
2121,Jonathan Clauss,fr FRA,"DF,MF",32-229,24.7,51,35,27,18,6,28,55,50.9,27,24,2,22,47,98,67,3,Matches,Nice,Ligue-1
2122,Moïse Bombito,ca CAN,DF,25-043,23.4,36,24,21,12,3,24,35,68.6,11,34,19,15,18,54,119,7,Matches,Nice,Ligue-1
2123,Youssouf Ndayishimiye,bi BDI,DF,26-197,21.5,40,21,25,14,1,16,27,59.3,11,35,19,16,21,61,117,4,Matches,Nice,Ligue-1
2124,Melvin Bard,fr FRA,"DF,MF",24-187,20.5,52,35,35,13,4,24,42,57.1,18,36,13,23,29,81,58,3,Matches,Nice,Ligue-1
2125,Pablo Rosario,nl NED,"MF,DF",28-125,19.7,30,20,6,19,5,11,20,55.0,9,19,11,8,31,61,43,2,Matches,Nice,Ligue-1
2126,Mohamed Ali Cho,fr FRA,"FW,MF",21-113,18.0,13,9,4,5,4,4,12,33.3,8,17,1,16,5,18,8,0,Matches,Nice,Ligue-1
2127,Dante,br BRA,DF,41-206,20.8,30,13,16,12,2,14,28,50.0,14,28,14,14,32,62,71,1,Matches,Nice,Ligue-1
2128,Gaëtan Laborde,fr FRA,FW,31-009,19.5,19,13,9,8,2,9,22,40.9,13,16,4,12,5,24,17,0,Matches,Nice,Ligue-1
2129,Ali Abdi,tn TUN,"DF,MF",31-143,15.4,43,25,18,14,11,28,43,65.1,15,20,6,14,20,63,37,0,Matches,Nice,Ligue-1
2130,Tanguy Ndombele,fr FRA,MF,28-135,12.6,35,23,10,21,4,12,20,60.0,8,9,0,9,14,49,9,0,Matches,Nice,Ligue-1
2131,Jeremie Boga,ci CIV,"MF,FW",28-129,11.7,10,5,2,5,3,4,8,50.0,4,13,0,13,3,13,2,1,Matches,Nice,Ligue-1
2132,Badredine Bouanani,dz ALG,"MF,FW",20-155,11.5,11,4,4,4,3,6,18,33.3,12,15,3,12,9,20,4,0,Matches,Nice,Ligue-1
2133,Baptiste Santamaria,fr FRA,MF,30-064,9.5,19,9,9,7,3,13,21,61.9,8,14,3,11,16,35,19,1,Matches,Nice,Ligue-1
2134,Mohamed Abdelmoneim,eg EGY,DF,26-100,9.5,21,14,12,6,3,13,22,59.1,9,11,5,6,15,36,56,1,Matches,Nice,Ligue-1
2135,Sofiane Diop,fr FRA,"MF,FW",24-337,11.6,23,16,16,3,4,9,22,40.9,13,19,2,17,16,39,7,1,Matches,Nice,Ligue-1
2136,Tom Louchet,fr FRA,"DF,MF",22-008,8.4,26,16,17,4,5,17,23,73.9,6,12,4,8,18,44,20,0,Matches,Nice,Ligue-1
2137,Antoine Mendy,sn SEN,DF,20-350,8.2,28,20,14,14,0,18,26,69.2,8,8,4,4,6,34,28,0,Matches,Nice,Ligue-1
2138,Morgan Sanson,fr FRA,MF,30-267,2.5,6,3,2,4,0,1,3,33.3,2,3,0,3,4,10,2,0,Matches,Nice,Ligue-1
2139,Youssoufa Moukoko,de GER,"FW,MF",20-173,2.3,3,2,2,1,0,1,2,50.0,1,2,0,2,0,3,0,0,Matches,Nice,Ligue-1
2140,Yael Nandjou,fr FRA,DF,19-310,1.7,4,1,2,1,1,4,8,50.0,4,4,1,3,4,8,7,0,Matches,Nice,Ligue-1
2141,Bilal Brahimi,dz ALG,MF,25-059,0.8,0,0,0,0,0,0,0,,0,1,0,1,0,0,2,0,Matches,Nice,Ligue-1
2142,Amidou Doumbouya,fr FRA,DF,17-280,0.5,1,1,0,0,1,1,1,100.0,0,3,1,2,1,2,1,0,Matches,Nice,Ligue-1
2143,Terem Moffi,ng NGA,FW,25-352,0.5,0,0,0,0,0,0,0,,0,0,0,0,0,0,0,0,Matches,Nice,Ligue-1
2144,Victor Orakpo,ng NGA,FW,18-332,0.4,0,0,0,0,0,0,0,,0,0,0,0,0,0,0,0,Matches,Nice,Ligue-1
2145,Jordan Lotomba,ch SUI,"MF,DF",26-225,0.4,0,0,0,0,0,0,0,,0,0,0,0,0,0,1,0,Matches,Nice,Ligue-1
2146,Issiaga Camara,gn GUI,MF,20-099,0.2,2,1,0,2,0,0,1,0.0,1,0,0,0,3,5,0,0,Matches,Nice,Ligue-1
2147,Rareş Ilie,ro ROU,MF,22-023,0.1,1,1,1,0,0,1,1,100.0,0,0,0,0,0,1,0,0,Matches,Nice,Ligue-1
2148,Bernard Nguene,cm CMR,FW,18-281,0.1,0,0,0,0,0,0,0,,0,0,0,0,0,0,0,0,Matches,Nice,Ligue-1
2149,Bradley Barcola,fr FRA,FW,22-252,23.6,26,16,10,7,9,8,31,25.8,23,25,2,23,19,45,11,0,Matches,Paris-Saint-Germain,Ligue-1
2150,Warren Zaïre-Emery,fr FRA,"MF,DF",19-065,22.4,51,26,17,21,13,23,45,51.1,22,33,6,27,23,74,20,2,Matches,Paris-Saint-Germain,Ligue-1
2151,Gianluigi Donnarumma,it ITA,GK,26-076,22.2,1,1,1,0,0,1,2,50.0,1,0,0,0,0,1,12,0,Matches,Paris-Saint-Germain,Ligue-1
2152,Achraf Hakimi,ma MAR,DF,26-189,22.0,47,35,18,19,10,27,55,49.1,28,25,2,23,29,76,18,3,Matches,Paris-Saint-Germain,Ligue-1
2153,Willian Pacho,ec ECU,DF,23-208,22.7,55,32,34,21,0,23,32,71.9,9,35,22,13,40,95,87,1,Matches,Paris-Saint-Germain,Ligue-1
2154,Lucas Beraldo,br BRA,DF,21-169,22.2,38,31,30,8,0,23,37,62.2,14,16,8,8,21,59,63,3,Matches,Paris-Saint-Germain,Ligue-1
2155,João Neves,pt POR,"MF,DF",20-227,19.8,61,31,19,26,16,26,42,61.9,16,29,9,20,21,82,22,1,Matches,Paris-Saint-Germain,Ligue-1
2156,Fabián Ruiz Peña,es ESP,MF,29-039,20.7,36,23,13,15,8,20,46,43.5,26,24,3,21,16,52,27,1,Matches,Paris-Saint-Germain,Ligue-1
2157,Vitinha,pt POR,MF,25-088,21.7,41,21,13,26,2,24,46,52.2,22,26,7,19,13,54,19,2,Matches,Paris-Saint-Germain,Ligue-1
2158,Lee Kang-in,kr KOR,"FW,MF",24-082,18.5,25,17,7,11,7,19,35,54.3,16,11,1,10,3,28,3,1,Matches,Paris-Saint-Germain,Ligue-1
2159,Ousmane Dembélé,fr FRA,FW,27-362,18.4,11,5,0,7,4,4,12,33.3,8,3,0,3,9,20,2,1,Matches,Paris-Saint-Germain,Ligue-1
2160,Désiré Doué,fr FRA,"FW,MF",19-343,18.9,47,29,15,19,13,24,47,51.1,23,24,0,24,13,60,7,0,Matches,Paris-Saint-Germain,Ligue-1
2161,Marquinhos,br BRA,DF,30-363,18.4,30,19,8,16,6,25,33,75.8,8,25,13,12,10,40,62,0,Matches,Paris-Saint-Germain,Ligue-1
2162,Nuno Mendes,pt POR,DF,22-327,17.6,29,18,14,12,3,22,37,59.5,15,25,8,17,17,46,35,2,Matches,Paris-Saint-Germain,Ligue-1
2163,Gonçalo Ramos,pt POR,FW,23-326,11.7,11,6,5,5,1,3,6,50.0,3,5,1,4,0,11,5,0,Matches,Paris-Saint-Germain,Ligue-1
2164,Lucas Hernández,fr FRA,DF,29-087,9.7,24,18,13,9,2,14,23,60.9,9,12,5,7,7,31,37,2,Matches,Paris-Saint-Germain,Ligue-1
2165,Khvicha Kvaratskhelia,ge GEO,FW,24-089,9.2,19,13,4,12,3,13,23,56.5,10,6,0,6,2,21,4,0,Matches,Paris-Saint-Germain,Ligue-1
2166,Matvei Safonov,ru RUS,GK,26-076,9.8,0,0,0,0,0,0,0,,0,1,0,1,1,1,3,0,Matches,Paris-Saint-Germain,Ligue-1
2167,Senny Mayulu,fr FRA,MF,18-360,8.6,25,16,8,14,3,8,14,57.1,6,8,3,5,5,30,12,0,Matches,Paris-Saint-Germain,Ligue-1
2168,Marco Asensio,es ESP,"FW,MF",29-111,6.9,4,3,1,3,0,0,6,0.0,6,1,0,1,0,4,1,0,Matches,Paris-Saint-Germain,Ligue-1
2169,Milan Škriniar,sk SVK,DF,30-090,4.2,7,5,3,4,0,3,3,100.0,0,7,6,1,3,10,16,0,Matches,Paris-Saint-Germain,Ligue-1
2170,Ibrahim Mbaye,fr FRA,"FW,MF",17-108,3.8,4,2,1,2,1,3,8,37.5,5,2,0,2,2,6,2,0,Matches,Paris-Saint-Germain,Ligue-1
2171,Randal Kolo Muani,fr FRA,FW,26-158,4.0,4,4,1,1,2,0,2,0.0,2,1,0,1,0,4,5,0,Matches,Paris-Saint-Germain,Ligue-1
2172,Yoram Zague,fr FRA,"DF,FW",18-362,2.0,8,6,3,1,4,6,8,75.0,2,3,0,3,2,10,2,0,Matches,Paris-Saint-Germain,Ligue-1
2173,Axel Tapé,fr FRA,"DF,MF",17-275,2.0,3,1,1,2,0,2,2,100.0,0,2,2,0,1,4,5,0,Matches,Paris-Saint-Germain,Ligue-1
2174,Arnau Tenas,es ESP,GK,23-347,1.0,0,0,0,0,0,0,0,,0,0,0,0,0,0,0,0,Matches,Paris-Saint-Germain,Ligue-1
2175,Noham Kamara,fr FRA,DF,18-110,0.8,1,1,0,1,0,0,0,,0,1,1,0,1,2,1,0,Matches,Paris-Saint-Germain,Ligue-1
2176,Presnel Kimpembe,fr FRA,DF,29-272,0.3,1,0,1,0,0,0,0,,0,2,2,0,0,1,1,0,Matches,Paris-Saint-Germain,Ligue-1
2177,Yehvann Diouf,fr FRA,GK,25-177,33.0,2,1,2,0,0,1,3,33.3,2,0,0,0,1,3,21,3,Matches,Reims,Ligue-1
2178,Valentin Atangana Edoa,fr FRA,MF,19-260,30.7,68,50,32,29,7,27,37,73.0,10,31,15,16,36,104,60,0,Matches,Reims,Ligue-1
2179,Keito Nakamura,jp JPN,"FW,MF",24-288,29.4,24,16,7,10,7,11,31,35.5,20,21,1,20,13,37,19,0,Matches,Reims,Ligue-1
2180,Junya Ito,jp JPN,"FW,MF",32-064,29.1,43,28,17,16,10,16,59,27.1,43,32,3,29,13,56,15,1,Matches,Reims,Ligue-1
2181,Sergio Akieme,es ESP,DF,27-147,27.0,32,22,28,3,1,21,35,60.0,14,26,9,17,17,49,94,4,Matches,Reims,Ligue-1
2182,Cédric Kipré,ci CIV,DF,28-154,23.3,40,29,29,10,1,27,37,73.0,10,40,27,13,31,71,155,2,Matches,Reims,Ligue-1
2183,Aurélio Buta,pt POR,DF,28-091,21.2,36,23,21,11,4,21,42,50.0,21,18,4,14,21,57,59,0,Matches,Reims,Ligue-1
2184,Oumar Diakité,ci CIV,FW,21-143,18.1,20,13,7,8,5,9,19,47.4,10,12,2,10,3,23,9,0,Matches,Reims,Ligue-1
2185,Marshall Munetsi,zw ZIM,MF,28-324,18.8,36,18,22,9,5,22,38,57.9,16,27,3,24,17,53,35,0,Matches,Reims,Ligue-1
2186,Joseph Okumu,ke KEN,DF,27-351,17.8,29,15,20,9,0,14,23,60.9,9,28,18,10,22,51,122,2,Matches,Reims,Ligue-1
2187,Amadou Koné,ml MLI,MF,19-363,13.6,47,31,31,15,1,21,33,63.6,12,14,2,12,17,64,37,2,Matches,Reims,Ligue-1
2188,Emmanuel Agbadou,ci CIV,DF,27-329,14.0,25,17,19,3,3,19,26,73.1,7,22,13,9,19,44,64,1,Matches,Reims,Ligue-1
2189,Mory Gbane,ci CIV,"DF,MF",24-138,11.5,20,11,16,4,0,13,24,54.2,11,11,9,2,17,37,85,1,Matches,Reims,Ligue-1
2190,Nhoa Sangui,fr FRA,"DF,MF",19-074,12.6,16,9,6,6,4,9,12,75.0,3,8,4,4,8,24,23,0,Matches,Reims,Ligue-1
2191,Teddy Teuma,mt MLT,MF,31-224,8.3,18,10,6,6,6,7,25,28.0,18,12,2,10,12,30,8,1,Matches,Reims,Ligue-1
2192,Hiroki Sekine,jp JPN,DF,22-274,8.9,8,6,5,2,1,6,15,40.0,9,15,6,9,5,13,48,1,Matches,Reims,Ligue-1
2193,Yaya Kader Fofana,ml MLI,"MF,FW",20-334,7.0,17,11,8,5,4,4,12,33.3,8,11,2,9,3,20,2,0,Matches,Reims,Ligue-1
2194,Mamadou Diakhon,fr FRA,"FW,MF",19-232,9.5,12,8,4,3,5,9,18,50.0,9,5,1,4,4,16,5,0,Matches,Reims,Ligue-1
2195,John Joe,ie IRL,MF,21-200,5.8,24,15,11,10,3,7,19,36.8,12,10,2,8,6,30,9,0,Matches,Reims,Ligue-1
2196,Jordan Pefok,us USA,FW,29-016,3.5,2,1,0,2,0,1,2,50.0,1,3,1,2,1,3,3,0,Matches,Reims,Ligue-1
2197,Amine Salama,fr FRA,FW,24-298,4.1,3,2,0,2,1,0,3,0.0,3,2,1,1,1,4,0,0,Matches,Reims,Ligue-1
2198,Hafiz Ibrahim,ng NGA,FW,19-143,4.1,3,2,0,1,2,0,5,0.0,5,4,2,2,2,5,6,0,Matches,Reims,Ligue-1
2199,Thibault De Smet,be BEL,DF,26-341,2.1,6,4,5,1,0,4,4,100.0,0,5,3,2,4,10,12,0,Matches,Reims,Ligue-1
2200,Ange Martial Tia,ml MLI,MF,18-173,1.5,4,3,1,2,1,2,5,40.0,3,3,0,3,2,6,4,0,Matches,Reims,Ligue-1
2201,Malcolm Jeng,se SWE,DF,20-064,1.2,0,0,0,0,0,0,0,,0,1,0,1,3,3,10,0,Matches,Reims,Ligue-1
2202,Abdoul Koné,fr FRA,DF,20-020,1.5,5,3,4,1,0,3,5,60.0,2,2,1,1,1,6,5,0,Matches,Reims,Ligue-1
2203,Gabriel Moscardo,br BRA,"MF,DF",19-226,0.9,3,1,2,1,0,1,3,33.3,2,3,1,2,0,3,1,0,Matches,Reims,Ligue-1
2204,Reda Khadra,de GER,"MF,FW",23-312,0.9,1,1,1,0,0,0,1,0.0,1,0,0,0,0,1,1,0,Matches,Reims,Ligue-1
2205,Niama Sissoko,ml MLI,"FW,MF",19-147,0.5,0,0,0,0,0,0,0,,0,1,0,1,0,0,0,0,Matches,Reims,Ligue-1
2206,Martin Adeline,fr FRA,MF,21-161,0.3,1,1,0,1,0,1,2,50.0,1,0,0,0,0,1,2,0,Matches,Reims,Ligue-1
2207,Eloge Zabi,ci CIV,"DF,MF",18-230,0.2,0,0,0,0,0,0,0,,0,0,0,0,0,0,1,0,Matches,Reims,Ligue-1
2208,Mohamed Daramy,dk DEN,FW,23-125,0.2,0,0,0,0,0,0,0,,0,0,0,0,0,0,1,0,Matches,Reims,Ligue-1
2209,Mohamed Bamba,ci CIV,MF,20-216,0.1,0,0,0,0,0,0,1,0.0,1,2,1,1,0,0,1,0,Matches,Reims,Ligue-1
2210,Ike Orazi,ie IRL,MF,17-335,0.0,0,0,0,0,0,0,0,,0,0,0,0,0,0,0,0,Matches,Reims,Ligue-1
2211,Adrien Truffert,fr FRA,"DF,MF",23-173,29.6,59,34,26,20,13,31,47,66.0,16,44,6,38,27,86,54,1,Matches,Rennes,Ligue-1
2212,Arnaud Kalimuendo,fr FRA,"FW,MF",23-112,27.6,19,12,6,9,4,7,15,46.7,8,9,2,7,4,23,14,1,Matches,Rennes,Ligue-1
2213,Lorenz Assignon,tg TOG,"DF,MF",24-324,25.2,46,24,23,21,2,16,40,40.0,24,19,3,16,24,70,74,0,Matches,Rennes,Ligue-1
2214,Ludovic Blas,fr FRA,"MF,FW",27-132,24.7,37,24,9,12,16,22,40,55.0,18,16,2,14,13,50,11,0,Matches,Rennes,Ligue-1
2215,Azor Matusiwa,nl NED,MF,27-014,22.4,64,39,32,30,2,32,43,74.4,11,28,10,18,34,98,51,0,Matches,Rennes,Ligue-1
2216,Hans Hateboer,nl NED,DF,31-123,18.7,31,16,14,12,5,18,36,50.0,18,19,6,13,29,60,64,2,Matches,Rennes,Ligue-1
2217,Steve Mandanda,fr FRA,GK,40-045,16.5,0,0,0,0,0,0,1,0.0,1,0,0,0,0,0,6,2,Matches,Rennes,Ligue-1
2218,Christopher Wooh,cm CMR,DF,23-236,16.2,36,19,21,13,2,18,27,66.7,9,22,8,14,23,59,63,0,Matches,Rennes,Ligue-1
2219,Brice Samba,fr FRA,GK,31-017,16.0,2,1,2,0,0,1,1,100.0,0,0,0,0,0,2,12,3,Matches,Rennes,Ligue-1
2220,Leo Skiri Østigård,no NOR,DF,25-165,13.6,20,18,16,4,0,15,22,68.2,7,12,10,2,15,35,81,1,Matches,Rennes,Ligue-1
2221,Jordan James,wls WAL,MF,20-314,12.8,29,18,7,18,4,16,29,55.2,13,14,1,13,13,42,16,1,Matches,Rennes,Ligue-1
2222,Lilian Brassier,fr FRA,DF,25-191,12.7,15,12,11,4,0,9,11,81.8,2,16,10,6,21,36,58,0,Matches,Rennes,Ligue-1
2223,Djaoui Cissé,fr FRA,MF,21-101,11.5,32,18,12,14,6,15,25,60.0,10,27,4,23,13,45,9,1,Matches,Rennes,Ligue-1
2224,Amine Gouiri,dz ALG,"MF,FW",25-085,11.5,9,6,4,4,1,2,8,25.0,6,8,0,8,2,11,5,0,Matches,Rennes,Ligue-1
2225,Anthony Rouault,fr FRA,DF,23-348,9.8,11,7,9,2,0,4,4,100.0,0,12,10,2,7,18,64,0,Matches,Rennes,Ligue-1
2226,Jérémy Jacquet,fr FRA,DF,19-303,9.6,25,16,10,8,7,13,20,65.0,7,9,3,6,24,49,43,1,Matches,Rennes,Ligue-1
2227,Alidu Seidu,gh GHA,DF,24-342,8.9,22,18,14,6,2,12,15,80.0,3,13,6,7,14,36,17,0,Matches,Rennes,Ligue-1
2228,Seko Fofana,ci CIV,MF,30-005,9.0,11,7,4,6,1,2,7,28.6,5,7,1,6,7,18,7,0,Matches,Rennes,Ligue-1
2229,Albert Grønbaek,dk DEN,"MF,FW",23-354,9.0,21,11,10,7,4,10,28,35.7,18,9,1,8,4,25,6,0,Matches,Rennes,Ligue-1
2230,Glen Kamara,fi FIN,MF,29-196,7.4,23,11,10,11,2,11,17,64.7,6,7,0,7,7,30,7,0,Matches,Rennes,Ligue-1
2231,Mikayil Ngor Faye,sn SEN,DF,20-302,7.6,15,12,10,3,2,7,9,77.8,2,9,4,5,12,27,30,0,Matches,Rennes,Ligue-1
2232,Musa Al-Taamari,jo JOR,"FW,MF",27-336,6.3,4,1,1,1,2,0,4,0.0,4,5,0,5,2,6,2,0,Matches,Rennes,Ligue-1
2233,Mohamed Meité,fr FRA,FW,17-213,6.0,2,0,0,2,0,1,1,100.0,0,1,0,1,0,2,5,0,Matches,Rennes,Ligue-1
2234,Baptiste Santamaria,fr FRA,MF,30-064,5.4,11,4,7,3,1,6,11,54.5,5,10,4,6,12,23,7,0,Matches,Rennes,Ligue-1
2235,Mahamadou Nagida,cm CMR,DF,19-318,4.8,8,6,4,3,1,4,5,80.0,1,3,0,3,9,17,6,0,Matches,Rennes,Ligue-1
2236,Ismaël Koné,ca CAN,MF,22-340,4.5,8,5,3,4,1,4,6,66.7,2,8,2,6,4,12,5,0,Matches,Rennes,Ligue-1
2237,Jota,pt POR,"FW,MF",26-043,3.7,5,2,2,3,0,4,7,57.1,3,1,0,1,3,8,2,0,Matches,Rennes,Ligue-1
2238,Kazeem Olaigbe,be BEL,"MF,FW",22-130,3.1,6,4,3,3,0,3,6,50.0,3,2,0,2,0,6,0,0,Matches,Rennes,Ligue-1
2239,Carlos Gómez,co COL,"MF,DF",22-242,3.9,8,6,3,4,1,3,9,33.3,6,6,0,6,2,10,2,0,Matches,Rennes,Ligue-1
2240,Kyogo Furuhashi,jp JPN,FW,30-112,1.4,2,2,1,1,0,1,1,100.0,0,0,0,0,0,2,0,0,Matches,Rennes,Ligue-1
2241,Benjamin Bourigeaud,fr FRA,MF,31-118,0.9,1,0,0,1,0,0,2,0.0,2,2,1,1,2,3,1,0,Matches,Rennes,Ligue-1
2242,Henrik Meister,dk DEN,FW,21-176,0.7,2,0,0,2,0,0,0,,0,4,0,4,1,3,0,0,Matches,Rennes,Ligue-1
2243,Naouirou Ahamada,fr FRA,"MF,FW",23-044,0.6,0,0,0,0,0,0,0,,0,0,0,0,2,2,2,0,Matches,Rennes,Ligue-1
2244,Gauthier Gallon,fr FRA,GK,32-019,0.5,0,0,0,0,0,0,0,,0,0,0,0,0,0,0,0,Matches,Rennes,Ligue-1
2245,Ayanda Sishuba,be BEL,FW,20-099,0.0,1,0,1,0,0,1,1,100.0,0,0,0,0,0,1,0,0,Matches,Rennes,Ligue-1
2246,Gautier Larsonneur,fr FRA,GK,28-078,32.0,1,0,1,0,0,0,2,0.0,2,1,0,1,0,1,24,1,Matches,Saint-Etienne,Ligue-1
2247,Zuriko Davitashvili,ge GEO,"FW,MF",24-086,28.9,22,13,9,7,6,15,48,31.3,33,20,0,20,12,34,14,0,Matches,Saint-Etienne,Ligue-1
2248,Léo Pétrot,fr FRA,DF,28-027,27.3,60,36,36,19,5,34,50,68.0,16,50,27,23,38,98,100,1,Matches,Saint-Etienne,Ligue-1
2249,Pierre Ekwah Elimby,fr FRA,MF,23-117,26.6,53,29,18,30,5,33,54,61.1,21,25,12,13,45,98,70,1,Matches,Saint-Etienne,Ligue-1
2250,Mickael Nade,fr FRA,DF,26-069,23.6,54,38,36,18,0,23,30,76.7,7,35,18,17,32,86,127,8,Matches,Saint-Etienne,Ligue-1
2251,Dylan Batubinsika,cd COD,DF,29-086,21.9,25,13,19,5,1,13,22,59.1,9,23,14,9,38,63,139,3,Matches,Saint-Etienne,Ligue-1
2252,Lucas Stassin,be BEL,FW,20-165,20.0,16,11,3,5,8,6,20,30.0,14,10,0,10,3,19,8,0,Matches,Saint-Etienne,Ligue-1
2253,Dennis Appiah,fr FRA,DF,32-337,22.6,68,40,40,21,7,40,69,58.0,29,33,7,26,25,93,87,2,Matches,Saint-Etienne,Ligue-1
2254,Benjamin Bouchouari,ma MAR,MF,23-180,18.4,31,24,14,12,5,15,42,35.7,27,18,1,17,17,48,15,2,Matches,Saint-Etienne,Ligue-1
2255,Louis Mouton,fr FRA,MF,22-343,11.6,49,25,14,25,10,22,37,59.5,15,17,3,14,10,59,19,0,Matches,Saint-Etienne,Ligue-1
2256,Aimen Moueffek,fr FRA,MF,24-033,11.3,20,12,3,11,6,10,23,43.5,13,20,7,13,5,25,25,1,Matches,Saint-Etienne,Ligue-1
2257,Florian Tardieu,fr FRA,MF,33-020,11.9,17,11,6,8,3,5,13,38.5,8,16,5,11,14,31,18,0,Matches,Saint-Etienne,Ligue-1
2258,Yunis Abdelhamid,ma MAR,DF,37-226,11.0,17,11,15,2,0,10,16,62.5,6,26,18,8,13,30,57,1,Matches,Saint-Etienne,Ligue-1
2259,Irvin Cardona,fr FRA,FW,27-277,9.9,5,4,3,2,0,2,12,16.7,10,16,3,13,3,8,6,2,Matches,Saint-Etienne,Ligue-1
2260,Mathis Amougou,fr FRA,MF,19-114,9.5,21,15,15,5,1,10,19,52.6,9,10,0,10,12,33,4,0,Matches,Saint-Etienne,Ligue-1
2261,Mathieu Cafaro,fr FRA,"MF,FW",28-048,8.1,10,7,4,4,2,4,15,26.7,11,7,1,6,7,17,3,0,Matches,Saint-Etienne,Ligue-1
2262,Yvann Macon,fr FRA,DF,26-223,7.8,19,11,9,7,3,10,21,47.6,11,14,4,10,2,21,10,1,Matches,Saint-Etienne,Ligue-1
2263,Ibrahim Sissoko,ml MLI,FW,29-166,9.1,11,9,5,3,3,2,5,40.0,3,10,2,8,2,13,13,0,Matches,Saint-Etienne,Ligue-1
2264,Augustine Boakye,gh GHA,"FW,MF",24-190,8.1,7,3,3,4,0,3,11,27.3,8,5,0,5,6,13,4,0,Matches,Saint-Etienne,Ligue-1
2265,Maxime Bernauer,fr FRA,DF,26-315,7.5,8,7,5,1,2,5,8,62.5,3,7,3,4,5,13,42,1,Matches,Saint-Etienne,Ligue-1
2266,Pierre Cornud,fr FRA,DF,28-151,6.4,12,10,6,4,2,8,17,47.1,9,9,4,5,9,21,28,1,Matches,Saint-Etienne,Ligue-1
2267,Ben Old,nz NZL,"FW,MF",22-272,5.6,6,5,3,2,1,3,11,27.3,8,8,1,7,2,8,2,0,Matches,Saint-Etienne,Ligue-1
2268,Lamine Fomba,fr FRA,MF,27-106,2.4,8,6,2,5,1,2,7,28.6,5,7,1,6,4,12,5,1,Matches,Saint-Etienne,Ligue-1
2269,Djylian N'Guessan,fr FRA,FW,16-255,1.9,5,3,4,1,0,1,4,25.0,3,1,0,1,0,5,1,0,Matches,Saint-Etienne,Ligue-1
2270,Marwann Nzuzi,fr FRA,DF,20-361,1.4,2,2,1,0,1,1,2,50.0,1,0,0,0,2,4,6,0,Matches,Saint-Etienne,Ligue-1
2271,Ibrahima Wadji,sn SEN,"FW,MF",30-007,3.1,7,6,3,3,1,3,7,42.9,4,1,0,1,1,8,0,0,Matches,Saint-Etienne,Ligue-1
2272,Ayman Aiki,fr FRA,"FW,MF",19-321,1.4,3,3,1,2,0,1,1,100.0,0,1,0,1,1,4,0,0,Matches,Saint-Etienne,Ligue-1
2273,Beres Owusu,fr FRA,DF,21-235,1.0,2,2,1,1,0,2,2,100.0,0,2,2,0,0,2,5,0,Matches,Saint-Etienne,Ligue-1
2274,Igor Miladinović,rs SRB,"FW,MF",21-338,0.3,0,0,0,0,0,0,0,,0,0,0,0,1,1,1,0,Matches,Saint-Etienne,Ligue-1
2275,Kévin Pedro,fr FRA,DF,19-080,0.1,3,0,2,1,0,3,3,100.0,0,1,0,1,2,5,1,0,Matches,Saint-Etienne,Ligue-1
2276,Jibril Othman,tn TUN,FW,21-016,0.1,0,0,0,0,0,0,0,,0,0,0,0,0,0,0,0,Matches,Saint-Etienne,Ligue-1
2277,Anthony Briançon,fr FRA,DF,30-165,0.0,0,0,0,0,0,0,0,,0,0,0,0,0,0,0,0,Matches,Saint-Etienne,Ligue-1
2278,Andrey Santos,br BRA,MF,21-009,30.7,109,73,47,50,12,50,86,58.1,36,45,14,31,32,141,67,1,Matches,Strasbourg,Ligue-1
2279,Đorđe Petrović,rs SRB,GK,25-216,30.0,1,1,1,0,0,0,0,,0,0,0,0,0,1,24,1,Matches,Strasbourg,Ligue-1
2280,Ismaël Doukouré,fr FRA,"DF,MF",21-292,28.3,38,20,18,17,3,16,24,66.7,8,31,14,17,25,63,101,3,Matches,Strasbourg,Ligue-1
2281,Guela Doué,ci CIV,DF,22-207,29.2,62,43,39,14,9,37,54,68.5,17,37,6,31,32,94,150,1,Matches,Strasbourg,Ligue-1
2282,Diego Moreira,pt POR,"DF,MF",20-279,27.5,42,27,17,18,7,24,47,51.1,23,23,4,19,34,76,63,0,Matches,Strasbourg,Ligue-1
2283,Dilane Bakwa,fr FRA,"MF,DF",22-259,26.9,26,14,11,8,7,12,24,50.0,12,20,1,19,14,40,27,0,Matches,Strasbourg,Ligue-1
2284,Habib Diarra,sn SEN,"MF,FW",21-129,25.9,22,13,6,13,3,8,20,40.0,12,22,6,16,13,35,45,2,Matches,Strasbourg,Ligue-1
2285,Emanuel Emegha,nl NED,FW,22-098,25.5,6,6,1,2,3,2,6,33.3,4,18,5,13,1,7,30,0,Matches,Strasbourg,Ligue-1
2286,Mamadou Sarr,fr FRA,DF,19-256,25.3,35,21,22,11,2,16,24,66.7,8,26,20,6,24,59,115,3,Matches,Strasbourg,Ligue-1
2287,Sebastian Nanasi,se SWE,"MF,FW",22-361,22.4,20,13,6,12,2,8,21,38.1,13,24,3,21,7,27,18,0,Matches,Strasbourg,Ligue-1
2288,Félix Lemaréchal,fr FRA,"MF,FW",21-278,18.8,33,23,13,15,5,14,29,48.3,15,35,4,31,14,47,19,0,Matches,Strasbourg,Ligue-1
2289,Valentín Barco,ar ARG,"MF,DF",20-293,12.1,36,22,24,10,2,22,30,73.3,8,7,3,4,11,47,26,1,Matches,Strasbourg,Ligue-1
2290,Saidou Sow,gn GUI,DF,22-312,11.3,9,5,6,3,0,6,12,50.0,6,15,9,6,15,24,37,2,Matches,Strasbourg,Ligue-1
2291,Abakar Sylla,ci CIV,DF,22-138,10.6,27,15,14,11,2,15,17,88.2,2,18,10,8,11,38,63,0,Matches,Strasbourg,Ligue-1
2292,Sekou Mara,fr FRA,"FW,MF",22-286,7.7,9,6,0,5,4,3,9,33.3,6,9,0,9,3,12,2,0,Matches,Strasbourg,Ligue-1
2293,Andrew Omobamidele,ie IRL,DF,22-323,6.0,7,4,4,3,0,2,5,40.0,3,12,8,4,8,15,38,0,Matches,Strasbourg,Ligue-1
2294,Guimissongui Ouattara,fr FRA,"DF,FW",19-202,5.1,6,4,3,1,2,3,5,60.0,2,9,0,9,8,14,12,2,Matches,Strasbourg,Ligue-1
2295,Samuel Amo-Ameyaw,eng ENG,"DF,MF",18-298,3.4,5,3,3,2,0,2,8,25.0,6,3,0,3,2,7,2,0,Matches,Strasbourg,Ligue-1
2296,Karl-Johan Johnsson,se SWE,GK,35-104,3.0,0,0,0,0,0,0,1,0.0,1,0,0,0,0,0,3,0,Matches,Strasbourg,Ligue-1
2297,Caleb Wiley,us USA,"DF,MF",20-141,3.0,1,0,0,1,0,0,1,0.0,1,3,1,2,4,5,5,0,Matches,Strasbourg,Ligue-1
2298,Junior Mwanga,fr FRA,MF,22-001,3.3,17,9,9,7,1,5,9,55.6,4,2,0,2,2,19,2,0,Matches,Strasbourg,Ligue-1
2299,Marvin Senaya,tg TOG,DF,24-104,2.5,8,3,5,2,1,6,12,50.0,6,6,2,4,7,15,12,0,Matches,Strasbourg,Ligue-1
2300,Jérémy Sebas,mq MTQ,"FW,MF",22-028,2.1,3,2,1,1,1,2,3,66.7,1,2,0,2,0,3,4,0,Matches,Strasbourg,Ligue-1
2301,Pape Daouda Diongue,sn SEN,"MF,FW",,0.9,2,0,1,1,0,1,2,50.0,1,0,0,0,3,5,2,0,Matches,Strasbourg,Ligue-1
2302,Eduard Sobol,ua UKR,DF,30-022,1.1,0,0,0,0,0,0,2,0.0,2,2,1,1,2,2,14,0,Matches,Strasbourg,Ligue-1
2303,Óscar Perea,co COL,"MF,DF",19-227,0.2,0,0,0,0,0,0,0,,0,0,0,0,0,0,0,0,Matches,Strasbourg,Ligue-1
2304,Milos Lukovic,rs SRB,"FW,MF",19-175,0.1,0,0,0,0,0,0,0,,0,0,0,0,0,0,0,0,Matches,Strasbourg,Ligue-1
2305,Nordine Kandil,fr FRA,MF,23-193,0.1,0,0,0,0,0,0,0,,0,0,0,0,0,0,1,0,Matches,Strasbourg,Ligue-1
2306,Thomas Delaine,fr FRA,DF,33-049,0.1,1,1,1,0,0,1,1,100.0,0,0,0,0,1,2,1,0,Matches,Strasbourg,Ligue-1
2307,Karol Fila,pl POL,MF,26-333,0.1,0,0,0,0,0,0,0,,0,0,0,0,0,0,0,0,Matches,Strasbourg,Ligue-1
2308,Aron Dønnum,no NOR,"DF,MF",27-022,29.9,56,35,25,24,7,31,55,56.4,24,29,4,25,28,84,37,1,Matches,Toulouse,Ligue-1
2309,Cristian Cásseres Jr.,ve VEN,MF,25-112,29.0,95,61,41,42,12,45,85,52.9,40,34,8,26,39,134,36,1,Matches,Toulouse,Ligue-1
2310,Charlie Cresswell,eng ENG,DF,22-268,27.8,35,23,19,15,1,28,45,62.2,17,43,27,16,28,63,180,3,Matches,Toulouse,Ligue-1
2311,Guillaume Restes,fr FRA,GK,20-062,27.3,2,1,2,0,0,2,3,66.7,1,0,0,0,1,3,14,1,Matches,Toulouse,Ligue-1
2312,Mark McKenzie,us USA,DF,26-076,26.7,49,28,30,18,1,31,43,72.1,12,29,17,12,21,70,131,1,Matches,Toulouse,Ligue-1
2313,Vincent Sierro,ch SUI,MF,29-216,25.7,44,27,15,23,6,27,54,50.0,27,33,8,25,15,59,43,1,Matches,Toulouse,Ligue-1
2314,Yann Gboho,fr FRA,"MF,FW",24-118,24.9,29,16,7,14,8,12,30,40.0,18,20,0,20,6,35,4,1,Matches,Toulouse,Ligue-1
2315,Gabriel Suazo,cl CHI,DF,27-276,24.0,59,39,25,22,12,30,72,41.7,42,27,3,24,36,95,40,1,Matches,Toulouse,Ligue-1
2316,Djibril Sidibé,fr FRA,DF,32-287,22.6,62,33,31,22,9,30,49,61.2,19,10,3,7,19,81,62,1,Matches,Toulouse,Ligue-1
2317,Zakaria Aboukhlal,ma MAR,"MF,FW",25-083,20.8,21,12,6,8,7,4,21,19.0,17,16,1,15,6,27,8,0,Matches,Toulouse,Ligue-1
2318,Joshua King,no NOR,"FW,MF",33-117,17.9,11,11,4,4,3,5,12,41.7,7,10,3,7,6,17,18,0,Matches,Toulouse,Ligue-1
2319,Frank Magri,cm CMR,"FW,MF",25-250,15.9,7,1,1,5,1,3,8,37.5,5,16,2,14,4,11,10,0,Matches,Toulouse,Ligue-1
2320,Shavy Babicka,ga GAB,"MF,FW",24-345,13.1,21,12,6,11,4,10,21,47.6,11,14,0,14,3,24,4,3,Matches,Toulouse,Ligue-1
2321,Jaydee Canvot,fr FRA,"DF,MF",18-287,11.3,20,9,13,5,2,11,17,64.7,6,9,2,7,11,31,50,1,Matches,Toulouse,Ligue-1
2322,Waren Kamanzi,no NOR,"DF,MF",24-182,10.4,26,12,11,11,4,12,24,50.0,12,5,2,3,8,34,22,0,Matches,Toulouse,Ligue-1
2323,Rasmus Nicolaisen,dk DEN,DF,28-057,6.9,6,3,4,2,0,3,5,60.0,2,10,5,5,10,16,25,0,Matches,Toulouse,Ligue-1
2324,Ümit Akdag,ro ROU,DF,21-218,5.5,8,4,3,4,1,5,12,41.7,7,10,8,2,11,19,19,0,Matches,Toulouse,Ligue-1
2325,Kjetil Haug,no NOR,GK,26-334,5.5,0,0,0,0,0,0,0,,0,0,0,0,0,0,3,0,Matches,Toulouse,Ligue-1
2326,Rafik Messali,fr FRA,DF,22-014,4.9,15,8,6,6,3,7,8,87.5,1,9,1,8,9,24,11,0,Matches,Toulouse,Ligue-1
2327,Denis Genreau,au AUS,MF,25-356,2.5,7,5,4,1,2,4,8,50.0,4,3,0,3,3,10,4,0,Matches,Toulouse,Ligue-1
2328,Niklas Schmidt,de GER,MF,27-072,2.3,6,4,1,5,0,4,7,57.1,3,0,0,0,1,7,4,0,Matches,Toulouse,Ligue-1
2329,Miha Zajc,si SVN,MF,30-315,2.9,4,4,1,2,1,3,5,60.0,2,2,1,1,3,7,7,0,Matches,Toulouse,Ligue-1
2330,Noah Edjouma,fr FRA,"MF,FW",19-220,1.9,2,2,0,1,1,1,2,50.0,1,1,1,0,2,4,2,0,Matches,Toulouse,Ligue-1
2331,Logan Costa,cv CPV,DF,24-041,1.0,2,1,0,2,0,1,1,100.0,0,2,2,0,2,4,4,0,Matches,Toulouse,Ligue-1
2332,Álex Domínguez,es ESP,GK,26-286,0.2,0,0,0,0,0,0,0,,0,0,0,0,0,0,0,0,Matches,Toulouse,Ligue-1
2333,Edhy Zuliani,it ITA,DF,20-274,0.1,0,0,0,0,0,0,0,,0,0,0,0,1,1,0,0,Matches,Toulouse,Ligue-1
2334,Naatan Skyttä,fi FIN,FW,23-005,0.1,1,0,0,0,1,0,0,,0,0,0,0,0,1,0,0,Matches,Toulouse,Ligue-1
2335,Jeffrey Gouweleeuw,nl NED,DF,33-306,31.7,48,26,24,20,4,26,38,68.4,12,33,15,18,35,83,178,0,Matches,Augsburg,Bundesliga
2336,Dimitris Giannoulis,gr GRE,DF,29-207,28.4,45,30,26,15,4,25,43,58.1,18,46,11,35,43,88,73,0,Matches,Augsburg,Bundesliga
2337,Frank Onyeka,ng NGA,MF,27-131,27.9,58,45,22,28,8,22,40,55.0,18,36,9,27,36,94,36,2,Matches,Augsburg,Bundesliga
2338,Chrislain Matsima,fr FRA,DF,22-362,27.3,27,18,16,10,1,16,25,64.0,9,48,29,19,51,78,159,0,Matches,Augsburg,Bundesliga
2339,Marius Wolf,de GER,DF,29-350,23.2,26,16,12,11,3,15,41,36.6,26,27,5,22,23,49,50,1,Matches,Augsburg,Bundesliga
2340,Kristijan Jakić,hr CRO,MF,27-363,24.6,45,22,20,18,7,21,42,50.0,21,41,9,32,28,73,50,1,Matches,Augsburg,Bundesliga
2341,Alexis Claude-Maurice,fr FRA,"MF,FW",26-340,22.8,41,26,12,15,14,17,34,50.0,17,16,0,16,15,56,8,1,Matches,Augsburg,Bundesliga
2342,Elvis Rexhbeçaj,xk KVX,MF,27-192,19.7,27,19,9,14,4,15,35,42.9,20,38,9,29,16,43,22,1,Matches,Augsburg,Bundesliga
2343,Samuel Essende,cd COD,FW,27-109,18.2,7,6,1,3,3,3,4,75.0,1,13,2,11,0,7,11,1,Matches,Augsburg,Bundesliga
2344,Finn Dahmen,de GER,GK,27-046,18.0,1,0,1,0,0,1,2,50.0,1,0,0,0,0,1,9,0,Matches,Augsburg,Bundesliga
2345,Phillip Tietz,de GER,FW,27-307,17.7,11,6,2,7,2,5,8,62.5,3,7,1,6,5,16,26,1,Matches,Augsburg,Bundesliga
2346,Nediljko Labrović,hr CRO,GK,25-214,15.0,0,0,0,0,0,0,0,,0,0,0,0,0,0,12,1,Matches,Augsburg,Bundesliga
2347,Keven Schlotterbeck,de GER,DF,28-014,14.4,19,17,9,9,1,12,16,75.0,4,13,6,7,15,34,73,1,Matches,Augsburg,Bundesliga
2348,Cedric Zesiger,ch SUI,DF,26-322,12.7,12,6,7,5,0,8,13,61.5,5,17,10,7,21,33,91,1,Matches,Augsburg,Bundesliga
2349,Fredrik Jensen,fi FIN,MF,27-245,8.3,6,6,1,3,2,3,4,75.0,1,8,1,7,4,10,16,0,Matches,Augsburg,Bundesliga
2350,Maximilian Bauer,de GER,DF,25-092,7.3,14,8,5,7,2,9,14,64.3,5,10,4,6,6,20,35,1,Matches,Augsburg,Bundesliga
2351,Arne Maier,de GER,MF,26-124,10.1,12,6,4,8,0,7,12,58.3,5,15,1,14,5,17,14,1,Matches,Augsburg,Bundesliga
2352,Henri Koudossou,de GER,DF,25-251,8.3,18,10,6,11,1,11,19,57.9,8,8,2,6,15,33,37,0,Matches,Augsburg,Bundesliga
2353,Mert Kömür,de GER,MF,19-299,6.5,3,2,2,0,1,0,3,0.0,3,9,3,6,3,6,7,1,Matches,Augsburg,Bundesliga
2354,Ruben Vargas,ch SUI,"MF,FW",26-280,3.4,2,1,1,1,0,1,4,25.0,3,1,0,1,2,4,1,1,Matches,Augsburg,Bundesliga
2355,Noahkai Banks,us USA,DF,18-162,3.1,11,5,6,4,1,3,7,42.9,4,4,1,3,5,16,28,0,Matches,Augsburg,Bundesliga
2356,Robert Gumny,pl POL,DF,26-342,2.7,3,3,1,2,0,2,6,33.3,4,2,0,2,1,4,6,0,Matches,Augsburg,Bundesliga
2357,Mads Pedersen,dk DEN,DF,28-253,2.6,8,7,5,2,1,4,5,80.0,1,4,0,4,2,10,6,0,Matches,Augsburg,Bundesliga
2358,Tim Breithaupt,de GER,MF,23-094,1.3,1,1,0,1,0,0,4,0.0,4,1,0,1,2,3,0,0,Matches,Augsburg,Bundesliga
2359,Steve Mounié,bj BEN,"FW,MF",30-225,3.6,4,4,0,1,3,0,1,0.0,1,1,1,0,1,5,4,1,Matches,Augsburg,Bundesliga
2360,Arne Engels,be BEL,"MF,FW",21-246,0.9,0,0,0,0,0,0,0,,0,1,1,0,0,0,0,0,Matches,Augsburg,Bundesliga
2361,Yusuf Kabadayı,de GER,"FW,MF",21-099,0.8,1,0,0,1,0,0,0,,0,1,0,1,0,1,0,0,Matches,Augsburg,Bundesliga
2362,Mergim Berisha,de GER,FW,27-001,0.4,1,0,0,1,0,1,1,100.0,0,2,1,1,0,1,0,0,Matches,Augsburg,Bundesliga
2363,Niklas Dorsch,de GER,MF,27-117,0.4,0,0,0,0,0,0,0,,0,1,0,1,0,0,0,0,Matches,Augsburg,Bundesliga
2364,Joshua Kimmich,de GER,MF,30-093,30.6,47,29,11,29,7,30,47,63.8,17,22,3,19,25,72,33,3,Matches,Bayern-Munich,Bundesliga
2365,Harry Kane,eng ENG,FW,31-288,26.1,13,11,3,8,2,2,6,33.3,4,16,2,14,2,15,16,0,Matches,Bayern-Munich,Bundesliga
2366,Kim Min-jae,kr KOR,DF,28-178,25.4,35,20,18,13,4,11,21,52.4,10,23,10,13,37,72,91,4,Matches,Bayern-Munich,Bundesliga
2367,Michael Olise,fr FRA,"FW,MF",23-151,24.9,35,22,10,21,4,17,36,47.2,19,23,1,22,8,43,15,2,Matches,Bayern-Munich,Bundesliga
2368,Manuel Neuer,de GER,GK,39-046,21.0,1,0,1,0,0,1,1,100.0,0,0,0,0,0,1,9,1,Matches,Bayern-Munich,Bundesliga
2369,Jamal Musiala,de GER,MF,22-075,20.0,36,21,7,16,13,12,29,41.4,17,30,0,30,8,44,5,1,Matches,Bayern-Munich,Bundesliga
2370,Dayot Upamecano,fr FRA,DF,26-197,19.5,36,22,18,16,2,16,29,55.2,13,17,7,10,34,70,45,1,Matches,Bayern-Munich,Bundesliga
2371,Konrad Laimer,at AUT,DF,27-350,18.1,48,27,18,22,8,23,48,47.9,25,24,1,23,8,56,24,1,Matches,Bayern-Munich,Bundesliga
2372,Raphaël Guerreiro,pt POR,"DF,MF",31-141,16.7,19,12,9,7,3,12,16,75.0,4,8,0,8,9,28,17,1,Matches,Bayern-Munich,Bundesliga
2373,Leroy Sané,de GER,FW,29-121,17.9,21,14,4,8,9,11,21,52.4,10,8,0,8,7,28,3,0,Matches,Bayern-Munich,Bundesliga
2374,Alphonso Davies,ca CAN,DF,24-191,17.3,30,17,7,17,6,17,26,65.4,9,14,1,13,13,43,22,2,Matches,Bayern-Munich,Bundesliga
2375,Aleksandar Pavlovic,de GER,MF,21-009,15.1,35,20,11,15,9,19,28,67.9,9,17,3,14,4,39,12,0,Matches,Bayern-Munich,Bundesliga
2376,Eric Dier,eng ENG,DF,31-117,15.3,17,10,6,9,2,11,18,61.1,7,19,8,11,20,37,71,1,Matches,Bayern-Munich,Bundesliga
2377,Leon Goretzka,de GER,MF,30-095,14.5,21,11,5,12,4,10,20,50.0,10,26,6,20,19,40,23,1,Matches,Bayern-Munich,Bundesliga
2378,Kingsley Coman,fr FRA,FW,28-333,13.6,15,10,5,5,5,6,10,60.0,4,12,0,12,8,23,15,0,Matches,Bayern-Munich,Bundesliga
2379,Serge Gnabry,de GER,"FW,MF",29-302,12.8,19,11,6,6,7,8,12,66.7,4,11,0,11,6,25,9,0,Matches,Bayern-Munich,Bundesliga
2380,Thomas Müller,de GER,"MF,FW",35-241,12.9,8,5,2,3,3,4,16,25.0,12,10,0,10,2,10,14,0,Matches,Bayern-Munich,Bundesliga
2381,Josip Stanišić,hr CRO,DF,25-040,8.7,12,10,6,4,2,6,13,46.2,7,10,6,4,5,17,27,1,Matches,Bayern-Munich,Bundesliga
2382,Jonas Urbig,de GER,GK,21-277,8.0,0,0,0,0,0,0,0,,0,0,0,0,0,0,9,2,Matches,Bayern-Munich,Bundesliga
2383,João Palhinha,pt POR,MF,29-307,7.5,20,14,6,11,3,11,16,68.8,5,13,1,12,4,24,9,1,Matches,Bayern-Munich,Bundesliga
2384,Sacha Boey,fr FRA,DF,24-241,6.3,18,5,6,4,8,11,15,73.3,4,6,0,6,2,20,13,0,Matches,Bayern-Munich,Bundesliga
2385,Daniel Peretz,il ISR,GK,24-306,3.0,0,0,0,0,0,0,1,0.0,1,0,0,0,0,0,2,0,Matches,Bayern-Munich,Bundesliga
2386,Hiroki Ito,jp JPN,DF,26-000,2.8,2,0,1,1,0,1,1,100.0,0,3,2,1,6,8,15,1,Matches,Bayern-Munich,Bundesliga
2387,Mathys Tel,fr FRA,"FW,MF",20-015,2.8,2,2,0,2,0,0,0,,0,0,0,0,1,3,1,0,Matches,Bayern-Munich,Bundesliga
2388,Sven Ulreich,de GER,GK,36-282,1.0,0,0,0,0,0,0,0,,0,0,0,0,0,0,0,0,Matches,Bayern-Munich,Bundesliga
2389,Gabriel Vidovic,hr CRO,MF,21-162,0.2,0,0,0,0,0,0,0,,0,2,0,2,0,0,0,0,Matches,Bayern-Munich,Bundesliga
2390,Adam Aznou,ma MAR,DF,18-344,0.2,0,0,0,0,0,0,0,,0,0,0,0,0,0,1,0,Matches,Bayern-Munich,Bundesliga
2391,Jonah Kusi-Asare,se SWE,FW,17-312,0.0,1,0,0,0,1,0,0,,0,0,0,0,0,1,0,0,Matches,Bayern-Munich,Bundesliga
2392,Arijon Ibrahimović,de GER,FW,19-152,0.0,0,0,0,0,0,0,0,,0,0,0,0,0,0,0,0,Matches,Bayern-Munich,Bundesliga
2393,Maximilian Wittek,de GER,DF,29-264,29.1,63,42,40,18,5,38,54,70.4,16,54,8,46,27,90,87,3,Matches,Bochum,Bundesliga
2394,Ibrahima Sissoko,ml MLI,MF,27-197,28.4,64,42,30,29,5,24,45,53.3,21,38,11,27,36,100,57,0,Matches,Bochum,Bundesliga
2395,Felix Passlack,de GER,"DF,MF",26-348,24.9,52,23,31,13,8,30,55,54.5,25,39,10,29,18,70,60,1,Matches,Bochum,Bundesliga
2396,Matúš Bero,sk SVK,MF,29-248,27.5,62,34,31,20,11,27,58,46.6,31,37,9,28,17,79,35,1,Matches,Bochum,Bundesliga
2397,Philipp Hofmann,de GER,FW,32-043,25.3,17,12,4,6,7,8,15,53.3,7,14,1,13,4,21,33,0,Matches,Bochum,Bundesliga
2398,Tim Oermann,de GER,DF,21-218,23.6,45,27,22,19,4,24,41,58.5,17,32,16,16,21,66,64,0,Matches,Bochum,Bundesliga
2399,Patrick Drewes,de GER,GK,32-097,21.0,0,0,0,0,0,0,1,0.0,1,1,0,1,0,0,11,1,Matches,Bochum,Bundesliga
2400,Ivan Ordets,ua UKR,DF,32-308,20.7,18,8,13,5,0,10,13,76.9,3,29,16,13,41,59,139,3,Matches,Bochum,Bundesliga
2401,Bernardo,br BRA,DF,29-363,18.8,45,27,31,13,1,27,37,73.0,10,37,17,20,25,70,98,4,Matches,Bochum,Bundesliga
2402,Jakov Medić,hr CRO,DF,26-247,16.9,13,11,9,3,1,8,18,44.4,10,29,19,10,21,34,102,4,Matches,Bochum,Bundesliga
2403,Moritz Broschinski,de GER,"FW,MF",24-231,15.3,18,14,6,6,6,5,14,35.7,9,18,0,18,1,19,18,0,Matches,Bochum,Bundesliga
2404,Anthony Losilla,fr FRA,MF,39-063,12.3,30,16,15,12,3,17,33,51.5,16,22,7,15,18,48,25,1,Matches,Bochum,Bundesliga
2405,Tom Krauß,de GER,MF,23-324,12.0,35,18,20,13,2,19,38,50.0,19,26,2,24,11,46,19,1,Matches,Bochum,Bundesliga
2406,Gerrit Holtmann,ph PHI,"DF,FW",30-048,12.6,24,19,14,8,2,12,24,50.0,12,18,5,13,16,40,15,0,Matches,Bochum,Bundesliga
2407,Timo Horn,de GER,GK,32-000,12.0,0,0,0,0,0,0,0,,0,0,0,0,0,0,9,1,Matches,Bochum,Bundesliga
2408,Dani de Wit,nl NED,"MF,FW",27-104,12.7,28,16,11,14,3,18,31,58.1,13,17,4,13,11,39,23,1,Matches,Bochum,Bundesliga
2409,Giorgos Masouras,gr GRE,"FW,MF",31-131,10.9,17,9,6,6,5,7,14,50.0,7,9,1,8,4,21,3,1,Matches,Bochum,Bundesliga
2410,Myron Boadu,nl NED,FW,24-118,10.7,2,1,0,0,2,1,5,20.0,4,3,0,3,1,3,4,0,Matches,Bochum,Bundesliga
2411,Erhan Mašović,rs SRB,DF,26-171,10.1,14,10,10,4,0,13,28,46.4,15,17,11,6,12,26,55,0,Matches,Bochum,Bundesliga
2412,Koji Miyoshi,jp JPN,"FW,MF",28-047,5.0,8,5,2,1,5,4,9,44.4,5,10,1,9,2,10,2,0,Matches,Bochum,Bundesliga
2413,Lukas Daschner,de GER,"MF,FW",26-223,4.6,4,2,1,2,1,2,9,22.2,7,5,0,5,0,4,5,0,Matches,Bochum,Bundesliga
2414,Cristian Gamboa,cr CRC,DF,35-200,2.5,8,3,5,3,0,3,9,33.3,6,2,0,2,2,10,8,0,Matches,Bochum,Bundesliga
2415,Mats Pannewig,de GER,MF,20-196,2.1,6,4,5,1,0,1,9,11.1,8,8,1,7,1,7,5,0,Matches,Bochum,Bundesliga
2416,Moritz-Broni Kwarteng,gh GHA,"MF,FW",27-014,1.9,4,3,1,1,2,1,2,50.0,1,0,0,0,0,4,1,0,Matches,Bochum,Bundesliga
2417,Aliou Badara Baldé,gn GUI,"MF,FW",22-151,1.0,1,1,1,0,0,0,0,,0,2,0,2,0,1,0,0,Matches,Bochum,Bundesliga
2418,Samuel Bamba,de GER,"FW,MF",21-088,0.3,1,1,1,0,0,0,0,,0,0,0,0,0,1,0,0,Matches,Bochum,Bundesliga
2419,Gregor Kobel,ch SUI,GK,27-157,31.0,0,0,0,0,0,0,0,,0,0,0,0,1,1,22,3,Matches,Dortmund,Bundesliga
2420,Serhou Guirassy,gn GUI,FW,29-061,27.9,7,6,2,2,3,2,5,40.0,3,10,3,7,4,11,36,0,Matches,Dortmund,Bundesliga
2421,Pascal Groß,de GER,"MF,DF",33-331,25.9,44,28,11,26,7,15,51,29.4,36,46,13,33,9,53,30,1,Matches,Dortmund,Bundesliga
2422,Julian Brandt,de GER,MF,29-010,24.7,25,12,13,8,4,15,42,35.7,27,17,0,17,14,39,12,1,Matches,Dortmund,Bundesliga
2423,Julian Ryerson,no NOR,DF,27-176,24.1,45,29,26,13,6,24,43,55.8,19,28,2,26,21,66,26,1,Matches,Dortmund,Bundesliga
2424,Emre Can,de GER,"DF,MF",31-120,23.3,49,28,30,15,4,17,35,48.6,18,31,17,14,20,69,90,3,Matches,Dortmund,Bundesliga
2425,Nico Schlotterbeck,de GER,DF,25-162,22.0,38,24,21,16,1,27,45,60.0,18,31,15,16,22,60,79,1,Matches,Dortmund,Bundesliga
2426,Ramy Bensebaini,dz ALG,DF,30-026,21.5,48,23,25,17,6,30,48,62.5,18,42,9,33,29,77,82,1,Matches,Dortmund,Bundesliga
2427,Waldemar Anton,de GER,DF,28-296,20.7,34,21,18,10,6,17,23,73.9,6,32,16,16,28,62,104,1,Matches,Dortmund,Bundesliga
2428,Jamie Gittens,eng ENG,"FW,MF",20-277,19.7,30,19,12,11,7,14,18,77.8,4,16,0,16,10,40,4,0,Matches,Dortmund,Bundesliga
2429,Felix Nmecha,de GER,MF,24-214,15.9,34,22,6,19,9,12,22,54.5,10,20,5,15,23,57,29,1,Matches,Dortmund,Bundesliga
2430,Maximilian Beier,de GER,"FW,MF",22-207,17.7,25,16,8,11,6,12,31,38.7,19,15,1,14,7,32,14,1,Matches,Dortmund,Bundesliga
2431,Marcel Sabitzer,at AUT,"MF,FW",31-056,17.0,28,18,7,15,6,15,26,57.7,11,18,6,12,10,38,29,1,Matches,Dortmund,Bundesliga
2432,Karim Adeyemi,de GER,"FW,MF",23-114,15.1,20,14,6,6,8,8,20,40.0,12,13,1,12,7,27,5,0,Matches,Dortmund,Bundesliga
2433,Niklas Süle,de GER,DF,29-251,10.8,14,12,9,5,0,10,14,71.4,4,10,6,4,4,18,46,1,Matches,Dortmund,Bundesliga
2434,Yan Couto,br BRA,"DF,FW",22-343,9.9,24,16,17,2,5,14,25,56.0,11,12,1,11,10,34,32,2,Matches,Dortmund,Bundesliga
2435,Daniel Svensson,se SWE,"DF,FW",23-089,7.7,12,9,5,5,2,5,9,55.6,4,8,3,5,4,16,28,0,Matches,Dortmund,Bundesliga
2436,Donyell Malen,nl NED,"FW,MF",26-123,6.8,0,0,0,0,0,0,2,0.0,2,2,0,2,3,3,6,0,Matches,Dortmund,Bundesliga
2437,Salih Özcan,tr TUR,MF,27-121,4.3,11,7,6,4,1,7,13,53.8,6,7,0,7,11,22,10,0,Matches,Dortmund,Bundesliga
2438,Gio Reyna,us USA,MF,22-180,3.8,6,0,3,0,3,3,4,75.0,1,3,1,2,0,6,9,0,Matches,Dortmund,Bundesliga
2439,Julien Duranville,be BEL,"FW,MF",19-007,3.1,3,0,0,3,0,1,1,100.0,0,1,0,1,0,3,3,0,Matches,Dortmund,Bundesliga
2440,Alexander Meyer,de GER,GK,34-029,2.0,0,0,0,0,0,0,0,,0,0,0,0,0,0,0,0,Matches,Dortmund,Bundesliga
2441,Carney Chukwuemeka,eng ENG,MF,21-204,2.6,6,5,3,1,2,1,1,100.0,0,5,0,5,1,7,1,0,Matches,Dortmund,Bundesliga
2442,Almugera Kabar,de GER,DF,18-340,1.5,5,3,2,2,1,3,3,100.0,0,1,0,1,1,6,4,0,Matches,Dortmund,Bundesliga
2443,Yannik Lührs,de GER,DF,21-245,1.4,1,1,1,0,0,0,0,,0,0,0,0,2,3,4,0,Matches,Dortmund,Bundesliga
2444,Ayman Azhil,ma MAR,MF,24-032,0.3,1,1,1,0,0,0,0,,0,0,0,0,0,1,0,0,Matches,Dortmund,Bundesliga
2445,Cole Campbell,us USA,"MF,FW",19-081,0.2,0,0,0,0,0,0,0,,0,0,0,0,0,0,1,0,Matches,Dortmund,Bundesliga
2446,Kjell-Arik Wätjen,de GER,MF,19-085,0.2,0,0,0,0,0,0,0,,0,0,0,0,0,0,2,0,Matches,Dortmund,Bundesliga
2447,Arthur Theate,be BEL,DF,24-352,29.0,36,25,19,16,1,21,42,50.0,21,42,19,23,37,73,160,3,Matches,Eintracht-Frankfurt,Bundesliga
2448,Hugo Ekitike,fr FRA,FW,22-326,27.5,16,12,3,8,5,4,11,36.4,7,13,1,12,7,23,24,0,Matches,Eintracht-Frankfurt,Bundesliga
2449,Robin Koch,de GER,DF,28-299,27.7,22,10,13,7,2,10,22,45.5,12,39,25,14,25,47,176,4,Matches,Eintracht-Frankfurt,Bundesliga
2450,Rasmus Kristensen,dk DEN,DF,27-305,26.9,57,32,37,15,5,39,66,59.1,27,50,13,37,20,77,93,1,Matches,Eintracht-Frankfurt,Bundesliga
2451,Hugo Larsson,se SWE,MF,20-319,25.6,47,27,17,25,5,21,41,51.2,20,41,10,31,29,76,32,1,Matches,Eintracht-Frankfurt,Bundesliga
2452,Tuta,br BRA,"DF,MF",25-312,25.3,44,27,25,17,2,28,40,70.0,12,42,21,21,40,84,135,1,Matches,Eintracht-Frankfurt,Bundesliga
2453,Kevin Trapp,de GER,GK,34-308,24.5,0,0,0,0,0,0,0,,0,0,0,0,0,0,13,3,Matches,Eintracht-Frankfurt,Bundesliga
2454,Ellyes Skhiri,tn TUN,MF,30-002,23.9,36,22,12,20,4,17,43,39.5,26,30,7,23,29,65,43,4,Matches,Eintracht-Frankfurt,Bundesliga
2455,Nathaniel Brown,de GER,"DF,MF",21-330,20.6,63,39,33,16,14,40,50,80.0,10,29,0,29,15,78,54,1,Matches,Eintracht-Frankfurt,Bundesliga
2456,Mario Götze,de GER,"MF,FW",32-343,17.1,41,28,18,20,3,15,36,41.7,21,15,1,14,7,48,8,0,Matches,Eintracht-Frankfurt,Bundesliga
2457,Ansgar Knauff,de GER,"MF,DF",23-122,16.8,40,21,18,15,7,12,25,48.0,13,22,4,18,12,52,22,0,Matches,Eintracht-Frankfurt,Bundesliga
2458,Omar Marmoush,eg EGY,FW,26-094,16.1,12,8,0,3,9,3,7,42.9,4,7,1,6,2,14,2,0,Matches,Eintracht-Frankfurt,Bundesliga
2459,Nnamdi Collins,de GER,DF,21-122,15.5,29,20,20,7,2,15,20,75.0,5,22,11,11,14,43,66,3,Matches,Eintracht-Frankfurt,Bundesliga
2460,Jean Mattéo Bahoya,fr FRA,"MF,FW",20-005,10.2,29,18,11,13,5,16,26,61.5,10,14,2,12,4,33,10,1,Matches,Eintracht-Frankfurt,Bundesliga
2461,Fares Chaïbi,dz ALG,"MF,FW",22-165,10.5,13,9,4,5,4,7,19,36.8,12,10,0,10,10,23,31,1,Matches,Eintracht-Frankfurt,Bundesliga
2462,Kauã Santos,br BRA,GK,22-031,8.5,0,0,0,0,0,0,0,,0,0,0,0,0,0,10,2,Matches,Eintracht-Frankfurt,Bundesliga
2463,Oscar Højlund,dk DEN,MF,20-128,7.8,21,12,8,9,4,8,16,50.0,8,15,7,8,5,26,8,1,Matches,Eintracht-Frankfurt,Bundesliga
2464,Can Uzun,tr TUR,"MF,FW",19-182,7.5,10,4,1,4,5,5,10,50.0,5,9,0,9,1,11,3,0,Matches,Eintracht-Frankfurt,Bundesliga
2465,Niels Nkounkou,fr FRA,"DF,MF",24-192,4.2,13,10,7,3,3,4,7,57.1,3,5,2,3,7,20,15,0,Matches,Eintracht-Frankfurt,Bundesliga
2466,Mahmoud Dahoud,de GER,MF,29-131,4.0,9,4,4,5,0,4,6,66.7,2,5,1,4,2,11,5,0,Matches,Eintracht-Frankfurt,Bundesliga
2467,Michy Batshuayi,be BEL,"FW,MF",31-222,3.3,1,1,1,0,0,1,1,100.0,0,2,0,2,1,2,0,0,Matches,Eintracht-Frankfurt,Bundesliga
2468,Junior Dina Ebimbe,fr FRA,"MF,FW",24-172,3.3,3,2,1,2,0,1,3,33.3,2,4,0,4,7,10,6,0,Matches,Eintracht-Frankfurt,Bundesliga
2469,Igor Matanovic,hr CRO,FW,22-042,3.5,2,0,0,2,0,0,1,0.0,1,3,0,3,1,3,9,0,Matches,Eintracht-Frankfurt,Bundesliga
2470,Elye Wahi,fr FRA,"FW,MF",22-130,2.2,0,0,0,0,0,0,1,0.0,1,1,0,1,0,0,1,0,Matches,Eintracht-Frankfurt,Bundesliga
2471,Aurele Amenda,ch SUI,DF,21-285,1.0,1,0,1,0,0,0,0,,0,2,2,0,1,2,8,0,Matches,Eintracht-Frankfurt,Bundesliga
2472,Timothy Chandler,us USA,DF,35-044,0.3,0,0,0,0,0,0,0,,0,0,0,0,3,3,2,0,Matches,Eintracht-Frankfurt,Bundesliga
2473,Ritsu Doan,jp JPN,"FW,MF",26-330,30.8,63,40,31,26,6,25,46,54.3,21,55,2,53,14,77,45,1,Matches,Freiburg,Bundesliga
2474,Maximilian Eggestein,de GER,MF,28-155,30.6,55,30,20,26,9,24,43,55.8,19,36,10,26,38,93,53,1,Matches,Freiburg,Bundesliga
2475,Philipp Lienhart,at AUT,DF,28-305,29.8,22,13,12,10,0,15,30,50.0,15,31,20,11,36,58,121,2,Matches,Freiburg,Bundesliga
2476,Vincenzo Grifo,it ITA,"FW,MF",32-035,26.0,27,20,11,12,4,13,32,40.6,19,23,2,21,8,35,21,1,Matches,Freiburg,Bundesliga
2477,Matthias Ginter,de GER,DF,31-113,27.5,29,17,14,11,4,15,28,53.6,13,35,23,12,18,47,139,5,Matches,Freiburg,Bundesliga
2478,Christian Günter,de GER,DF,32-073,25.5,23,21,12,8,3,16,29,55.2,13,24,10,14,8,31,49,1,Matches,Freiburg,Bundesliga
2479,Patrick Osterhage,de GER,MF,25-100,25.2,45,29,16,27,2,14,30,46.7,16,27,3,24,18,63,37,0,Matches,Freiburg,Bundesliga
2480,Noah Atubolu,de GER,GK,22-352,24.6,0,0,0,0,0,0,0,,0,0,0,0,0,0,13,4,Matches,Freiburg,Bundesliga
2481,Lukas Kübler,de GER,DF,32-255,20.2,40,21,17,20,3,27,48,56.3,21,32,13,19,52,92,59,3,Matches,Freiburg,Bundesliga
2482,Lucas Höler,de GER,"FW,MF",30-306,19.7,35,22,17,15,3,8,23,34.8,15,29,7,22,7,42,32,0,Matches,Freiburg,Bundesliga
2483,Junior Adamu,at AUT,FW,23-340,16.4,9,3,3,3,3,3,10,30.0,7,14,0,14,12,21,19,0,Matches,Freiburg,Bundesliga
2484,Eren Dinkçi,de GER,"MF,FW",23-150,13.3,21,13,8,8,5,7,23,30.4,16,22,2,20,7,28,7,0,Matches,Freiburg,Bundesliga
2485,Max Rosenfelder,de GER,DF,22-091,13.1,25,16,16,9,0,12,17,70.6,5,16,9,7,7,32,63,0,Matches,Freiburg,Bundesliga
2486,Merlin Röhl,de GER,"MF,FW",22-311,10.6,16,10,4,10,2,9,11,81.8,2,8,1,7,5,21,2,0,Matches,Freiburg,Bundesliga
2487,Kiliann Sildillia,fr FRA,DF,22-361,8.9,17,10,8,6,3,7,13,53.8,6,16,5,11,11,28,38,0,Matches,Freiburg,Bundesliga
2488,Florian Müller,de GER,GK,27-180,8.4,0,0,0,0,0,0,0,,0,0,0,0,0,0,3,0,Matches,Freiburg,Bundesliga
2489,Nicolas Höfler,de GER,MF,35-064,8.8,33,23,13,18,2,20,31,64.5,11,7,1,6,14,47,28,1,Matches,Freiburg,Bundesliga
2490,Jordy Makengo,fr FRA,DF,23-282,7.5,15,8,9,5,1,9,15,60.0,6,8,3,5,7,22,28,0,Matches,Freiburg,Bundesliga
2491,Michael Gregoritsch,at AUT,FW,31-024,6.9,3,2,1,0,2,0,4,0.0,4,2,1,1,0,3,10,0,Matches,Freiburg,Bundesliga
2492,Johan Manzambi,ch SUI,"FW,MF",19-210,2.8,6,2,1,2,3,1,4,25.0,3,6,0,6,3,9,4,0,Matches,Freiburg,Bundesliga
2493,Jan-Niklas Beste,de GER,"FW,MF",26-128,2.4,2,1,0,1,1,1,7,14.3,6,3,0,3,1,3,7,0,Matches,Freiburg,Bundesliga
2494,Florent Muslija,xk KVX,"FW,MF",26-310,1.9,5,4,3,1,1,2,2,100.0,0,0,0,0,1,6,1,0,Matches,Freiburg,Bundesliga
2495,Noah Weißhaupt,de GER,FW,23-234,0.9,0,0,0,0,0,0,1,0.0,1,0,0,0,0,0,1,0,Matches,Freiburg,Bundesliga
2496,Roland Sallai,hu HUN,"FW,MF",27-355,0.5,2,1,1,1,0,0,0,,0,0,0,0,1,3,0,0,Matches,Freiburg,Bundesliga
2497,Ifechukwu Ogbus,ch SUI,DF,19-146,0.2,1,1,0,0,1,0,1,0.0,1,0,0,0,1,2,2,0,Matches,Freiburg,Bundesliga
2498,Maximilian Philipp,de GER,"MF,FW",31-072,0.2,0,0,0,0,0,0,0,,0,0,0,0,0,0,0,0,Matches,Freiburg,Bundesliga
2499,Julian Weigl,de GER,MF,29-246,31.0,51,24,24,22,5,26,42,61.9,16,53,26,27,47,98,84,2,Matches,Monchengladbach,Bundesliga
2500,Tim Kleindienst,de GER,FW,29-254,30.4,30,15,6,15,9,10,35,28.6,25,45,9,36,12,42,66,1,Matches,Monchengladbach,Bundesliga
2501,Ko Itakura,jp JPN,DF,28-105,30.0,40,29,23,16,1,21,34,61.8,13,40,21,19,25,65,169,0,Matches,Monchengladbach,Bundesliga
2502,Joe Scally,us USA,DF,22-132,28.4,44,31,25,17,2,27,46,58.7,19,34,11,23,16,60,86,2,Matches,Monchengladbach,Bundesliga
2503,Robin Hack,de GER,"FW,MF",26-258,23.4,20,16,9,8,3,11,27,40.7,16,30,2,28,9,29,28,0,Matches,Monchengladbach,Bundesliga
2504,Nico Elvedi,ch SUI,DF,28-224,22.7,38,23,28,6,4,17,23,73.9,6,35,27,8,29,67,153,0,Matches,Monchengladbach,Bundesliga
2505,Lukas Ullrich,de GER,DF,21-057,20.1,24,15,17,6,1,14,41,34.1,27,24,9,15,23,47,69,1,Matches,Monchengladbach,Bundesliga
2506,Alassane Pléa,fr FRA,"MF,FW",32-063,20.1,7,3,0,2,5,4,12,33.3,8,10,0,10,2,9,7,1,Matches,Monchengladbach,Bundesliga
2507,Rocco Reitz,de GER,MF,22-348,19.4,47,21,20,23,4,20,39,51.3,19,36,15,21,50,97,55,1,Matches,Monchengladbach,Bundesliga
2508,Moritz Nicolas,de GER,GK,27-203,18.2,0,0,0,0,0,0,0,,0,1,0,1,1,1,8,1,Matches,Monchengladbach,Bundesliga
2509,Franck Honorat,fr FRA,FW,28-274,15.1,15,6,8,4,3,1,6,16.7,5,9,1,8,5,20,28,1,Matches,Monchengladbach,Bundesliga
2510,Kevin Stöger,at AUT,MF,31-258,17.0,37,21,23,10,4,16,38,42.1,22,24,3,21,16,53,26,3,Matches,Monchengladbach,Bundesliga
2511,Philipp Sander,de GER,MF,27-080,14.8,32,16,16,14,2,10,23,43.5,13,16,7,9,22,54,43,3,Matches,Monchengladbach,Bundesliga
2512,Jonas Omlin,ch SUI,GK,31-122,9.9,0,0,0,0,0,0,1,0.0,1,0,0,0,0,0,4,1,Matches,Monchengladbach,Bundesliga
2513,Marvin Friedrich,de GER,DF,29-150,11.0,15,9,12,3,0,9,16,56.3,7,16,12,4,5,20,57,0,Matches,Monchengladbach,Bundesliga
2514,Nathan N'Goumou,cm CMR,FW,25-059,9.2,17,11,11,4,2,6,11,54.5,5,8,2,6,4,21,16,0,Matches,Monchengladbach,Bundesliga
2515,Luca Netz,de GER,DF,21-362,10.8,24,14,14,8,2,13,19,68.4,6,17,4,13,10,34,36,0,Matches,Monchengladbach,Bundesliga
2516,Tomáš Čvančara,cz CZE,FW,24-272,9.0,4,1,3,1,0,2,7,28.6,5,6,3,3,5,9,17,0,Matches,Monchengladbach,Bundesliga
2517,Stefan Lainer,at AUT,DF,32-258,7.7,20,12,14,5,1,12,14,85.7,2,11,6,5,11,31,25,0,Matches,Monchengladbach,Bundesliga
2518,Tiago Cardoso,lu LUX,GK,19-035,4.2,1,0,1,0,0,1,1,100.0,0,0,0,0,0,1,2,2,Matches,Monchengladbach,Bundesliga
2519,Fabio Chiarodia,it ITA,DF,19-341,4.2,10,4,6,4,0,4,6,66.7,2,8,3,5,9,19,53,1,Matches,Monchengladbach,Bundesliga
2520,Florian Neuhaus,de GER,MF,28-057,4.1,10,3,7,3,0,7,17,41.2,10,9,2,7,6,16,5,1,Matches,Monchengladbach,Bundesliga
2521,Tobias Sippel,de GER,GK,37-051,0.7,0,0,0,0,0,0,0,,0,0,0,0,0,0,0,0,Matches,Monchengladbach,Bundesliga
2522,Shiō Fukuda,jp JPN,"FW,MF",21-034,0.6,0,0,0,0,0,0,0,,0,1,0,1,0,0,0,0,Matches,Monchengladbach,Bundesliga
2523,Grant Ranos,am ARM,FW,21-296,0.2,1,0,0,1,0,0,1,0.0,1,2,0,2,0,1,0,0,Matches,Monchengladbach,Bundesliga
2524,Noah Pesch,hr CRO,FW,19-359,0.1,1,0,0,0,1,0,0,,0,0,0,0,0,1,0,0,Matches,Monchengladbach,Bundesliga
2525,Patrick Mainka,de GER,DF,30-187,33.0,57,29,35,20,2,34,53,64.2,19,58,33,25,68,125,205,0,Matches,Heidenheim,Bundesliga
2526,Kevin Müller,de GER,GK,34-058,31.7,3,2,3,0,0,3,3,100.0,0,0,0,0,0,3,12,4,Matches,Heidenheim,Bundesliga
2527,Jan Schöppner,de GER,MF,25-334,29.3,56,30,19,27,10,20,58,34.5,38,37,6,31,43,99,94,1,Matches,Heidenheim,Bundesliga
2528,Benedikt Gimber,de GER,DF,28-082,29.2,72,46,48,23,1,38,63,60.3,25,53,19,34,31,103,131,1,Matches,Heidenheim,Bundesliga
2529,Omar Traoré,de GER,DF,27-097,28.1,48,25,31,16,1,24,40,60.0,16,35,6,29,20,68,66,0,Matches,Heidenheim,Bundesliga
2530,Marvin Pieringer,de GER,"FW,MF",25-220,23.5,22,13,5,12,5,5,9,55.6,4,21,2,19,8,30,31,0,Matches,Heidenheim,Bundesliga
2531,Jonas Föhrenbach,de GER,DF,29-106,20.2,44,23,24,15,5,22,35,62.9,13,29,3,26,16,60,57,0,Matches,Heidenheim,Bundesliga
2532,Paul Wanner,de GER,"MF,FW",19-140,18.7,37,25,15,20,2,14,30,46.7,16,14,0,14,4,41,20,0,Matches,Heidenheim,Bundesliga
2533,Niklas Dorsch,de GER,MF,27-117,14.3,27,16,12,15,0,13,22,59.1,9,14,1,13,17,44,17,2,Matches,Heidenheim,Bundesliga
2534,Adrian Beck,de GER,"MF,FW",27-337,17.3,36,17,18,12,6,12,35,34.3,23,31,2,29,9,45,16,0,Matches,Heidenheim,Bundesliga
2535,Marnon Busch,de GER,"DF,MF",30-155,15.5,26,17,19,7,0,23,32,71.9,9,23,10,13,13,39,65,5,Matches,Heidenheim,Bundesliga
2536,Frans Krätzig,de GER,"DF,MF",22-118,13.5,32,18,14,12,6,12,21,57.1,9,12,1,11,17,49,15,0,Matches,Heidenheim,Bundesliga
2537,Léo Scienza,br BRA,"FW,MF",26-241,12.3,16,11,9,5,2,6,17,35.3,11,13,1,12,5,21,9,1,Matches,Heidenheim,Bundesliga
2538,Tim Siersleben,de GER,DF,25-064,12.1,20,13,12,7,1,7,17,41.2,10,17,6,11,20,40,61,0,Matches,Heidenheim,Bundesliga
2539,Mathias Honsak,at AUT,"FW,MF",28-143,12.3,15,8,10,5,0,10,23,43.5,13,17,4,13,9,24,30,0,Matches,Heidenheim,Bundesliga
2540,Budu Zivzivadze,ge GEO,FW,31-063,10.1,16,10,1,9,6,4,8,50.0,4,9,0,9,3,19,7,0,Matches,Heidenheim,Bundesliga
2541,Lennard Maloney,us USA,MF,25-216,8.4,20,11,12,7,1,14,23,60.9,9,9,2,7,14,34,38,0,Matches,Heidenheim,Bundesliga
2542,Luca Kerber,de GER,"MF,DF",23-063,8.2,26,16,17,8,1,16,29,55.2,13,13,4,9,5,31,25,0,Matches,Heidenheim,Bundesliga
2543,Sirlord Conteh,de GER,"FW,MF",28-307,9.9,9,5,3,6,0,2,7,28.6,5,1,1,0,1,10,8,0,Matches,Heidenheim,Bundesliga
2544,Mikkel Kaufmann,dk DEN,FW,24-129,4.1,6,4,1,3,2,2,5,40.0,3,5,2,3,2,8,7,0,Matches,Heidenheim,Bundesliga
2545,Maximilian Breunig,de GER,"FW,MF",24-271,3.9,4,3,1,2,1,3,6,50.0,3,9,2,7,1,5,3,0,Matches,Heidenheim,Bundesliga
2546,Thomas Keller,de GER,"DF,MF",25-280,1.6,6,5,5,1,0,4,6,66.7,2,3,1,2,4,10,11,0,Matches,Heidenheim,Bundesliga
2547,Frank Feller,de GER,GK,21-125,1.3,0,0,0,0,0,0,0,,0,0,0,0,0,0,1,0,Matches,Heidenheim,Bundesliga
2548,Stefan Schimmer,de GER,"FW,MF",31-014,2.7,2,0,1,1,0,1,2,50.0,1,1,0,1,0,2,4,0,Matches,Heidenheim,Bundesliga
2549,Julian Niehues,de GER,MF,24-025,1.2,1,0,1,0,0,1,5,20.0,4,1,0,1,0,1,7,0,Matches,Heidenheim,Bundesliga
2550,Norman Theuerkauf,de GER,MF,38-108,0.2,0,0,0,0,0,0,0,,0,0,0,0,0,0,0,0,Matches,Heidenheim,Bundesliga
2551,Denis Thomalla,de GER,MF,32-269,0.0,0,0,0,0,0,0,0,,0,0,0,0,0,0,0,0,Matches,Heidenheim,Bundesliga
2552,Andrej Kramarić,hr CRO,"MF,FW",33-327,29.8,15,8,5,8,2,6,11,54.5,5,16,3,13,7,22,11,1,Matches,Hoffenheim,Bundesliga
2553,Tom Bischof,de GER,"MF,FW",19-318,27.7,94,52,35,45,14,40,76,52.6,36,64,11,53,29,123,51,1,Matches,Hoffenheim,Bundesliga
2554,Anton Stach,de GER,"MF,DF",26-178,27.8,63,45,25,34,4,30,45,66.7,15,46,13,33,45,108,101,2,Matches,Hoffenheim,Bundesliga
2555,Oliver Baumann,de GER,GK,34-344,27.0,2,2,2,0,0,2,4,50.0,2,0,0,0,0,2,15,2,Matches,Hoffenheim,Bundesliga
2556,Arthur Chaves,br BRA,DF,24-103,23.3,48,34,27,17,4,24,48,50.0,24,47,20,27,34,82,128,3,Matches,Hoffenheim,Bundesliga
2557,Kevin Akpoguma,ng NGA,DF,30-023,23.7,52,25,34,12,6,29,43,67.4,14,65,37,28,26,78,109,1,Matches,Hoffenheim,Bundesliga
2558,Marius Bülter,de GER,"FW,DF",32-044,18.7,11,9,3,6,2,8,15,53.3,7,9,2,7,3,14,14,1,Matches,Hoffenheim,Bundesliga
2559,Adam Hložek,cz CZE,"FW,MF",22-291,19.8,20,9,7,7,6,11,20,55.0,9,13,1,12,4,24,20,0,Matches,Hoffenheim,Bundesliga
2560,Alexander Prass,at AUT,DF,23-351,16.9,41,23,23,15,3,24,57,42.1,33,32,6,26,9,50,48,4,Matches,Hoffenheim,Bundesliga
2561,Pavel Kadeřábek,cz CZE,DF,33-017,16.5,24,13,13,4,7,15,31,48.4,16,13,3,10,20,44,49,1,Matches,Hoffenheim,Bundesliga
2562,Stanley N'Soki,fr FRA,DF,26-033,14.5,22,16,13,7,2,12,23,52.2,11,22,7,15,26,48,58,3,Matches,Hoffenheim,Bundesliga
2563,Valentin Gendrey,fr FRA,DF,24-325,15.7,30,12,19,9,2,11,18,61.1,7,19,5,14,15,45,53,0,Matches,Hoffenheim,Bundesliga
2564,Leo Skiri Østigård,no NOR,DF,25-165,9.3,8,7,5,3,0,4,6,66.7,2,17,9,8,8,16,102,0,Matches,Hoffenheim,Bundesliga
2565,Florian Grillitsch,at AUT,MF,29-278,6.7,15,9,5,9,1,8,14,57.1,6,6,2,4,8,23,18,0,Matches,Hoffenheim,Bundesliga
2566,Gift Orban,ng NGA,FW,22-299,7.6,3,1,2,1,0,1,6,16.7,5,7,0,7,0,3,3,0,Matches,Hoffenheim,Bundesliga
2567,Finn Ole Becker,de GER,MF,24-338,7.3,11,5,4,6,1,1,4,25.0,3,7,3,4,10,21,18,0,Matches,Hoffenheim,Bundesliga
2568,Bazoumana Touré,ci CIV,"FW,MF",19-071,6.5,12,10,2,7,3,2,8,25.0,6,3,0,3,3,15,2,0,Matches,Hoffenheim,Bundesliga
2569,Haris Tabakovic,ba BIH,FW,30-326,9.1,3,1,1,0,2,0,3,0.0,3,4,2,2,1,4,16,0,Matches,Hoffenheim,Bundesliga
2570,Dennis Geiger,de GER,"MF,FW",26-336,7.3,22,10,8,12,2,11,17,64.7,6,13,2,11,5,27,6,1,Matches,Hoffenheim,Bundesliga
2571,David Jurásek,cz CZE,DF,24-278,6.9,6,3,3,2,1,2,5,40.0,3,5,0,5,6,12,17,0,Matches,Hoffenheim,Bundesliga
2572,Luca Philipp,de GER,GK,24-165,6.0,1,0,1,0,0,1,1,100.0,0,0,0,0,0,1,1,0,Matches,Hoffenheim,Bundesliga
2573,Diadie Samassékou,ml MLI,MF,29-121,3.2,5,5,1,2,2,2,4,50.0,2,4,2,2,5,10,5,0,Matches,Hoffenheim,Bundesliga
2574,Max Moerstedt,de GER,FW,,5.0,5,5,1,3,1,1,2,50.0,1,4,0,4,0,5,5,0,Matches,Hoffenheim,Bundesliga
2575,Tim Drexler,de GER,DF,20-067,4.0,17,7,11,6,0,9,12,75.0,3,6,4,2,1,18,9,1,Matches,Hoffenheim,Bundesliga
2576,Jacob Bruun Larsen,dk DEN,"FW,MF",26-235,4.4,4,3,1,2,1,3,8,37.5,5,5,1,4,1,5,2,0,Matches,Hoffenheim,Bundesliga
2577,Umut Tohumcu,de GER,"MF,FW",20-274,4.0,9,5,3,5,1,5,7,71.4,2,5,0,5,3,12,6,0,Matches,Hoffenheim,Bundesliga
2578,Mergim Berisha,de GER,"FW,MF",27-001,3.7,3,3,1,2,0,0,3,0.0,3,2,1,1,0,3,3,0,Matches,Hoffenheim,Bundesliga
2579,Erencan Yardimci,tr TUR,"FW,MF",23-097,3.5,4,3,1,3,0,1,2,50.0,1,2,0,2,1,5,2,0,Matches,Hoffenheim,Bundesliga
2580,Robin Hranáč,cz CZE,DF,25-103,2.4,0,0,0,0,0,0,1,0.0,1,3,2,1,5,5,9,1,Matches,Hoffenheim,Bundesliga
2581,Grischa Prömel,de GER,MF,30-123,1.9,0,0,0,0,0,0,1,0.0,1,1,1,0,2,2,4,0,Matches,Hoffenheim,Bundesliga
2582,Florian Micheler,at AUT,MF,19-360,0.4,0,0,0,0,0,0,2,0.0,2,0,0,0,0,0,0,0,Matches,Hoffenheim,Bundesliga
2583,Hannes Behrens,de GER,DF,,0.3,1,1,0,1,0,0,0,,0,1,0,1,2,3,0,0,Matches,Hoffenheim,Bundesliga
2584,David Mokwa,fr FRA,"DF,FW",21-009,0.2,1,0,1,0,0,0,0,,0,0,0,0,0,1,0,0,Matches,Hoffenheim,Bundesliga
2585,Paul Hennrich,de GER,MF,20-067,0.1,0,0,0,0,0,0,0,,0,1,1,0,0,0,0,0,Matches,Hoffenheim,Bundesliga
2586,Timo Becker,de GER,DF,28-048,26.2,50,31,36,9,5,31,41,75.6,10,30,17,13,16,66,108,1,Matches,Holstein-Kiel,Bundesliga
2587,Nicolai Remberg,de GER,MF,24-327,25.9,44,25,23,17,4,19,38,50.0,19,45,19,26,28,72,97,0,Matches,Holstein-Kiel,Bundesliga
2588,Timon Weiner,de GER,GK,26-114,25.0,0,0,0,0,0,0,1,0.0,1,0,0,0,0,0,17,3,Matches,Holstein-Kiel,Bundesliga
2589,Armin Gigovic,ba BIH,MF,23-036,21.1,25,13,14,8,3,5,21,23.8,16,20,1,19,21,46,33,0,Matches,Holstein-Kiel,Bundesliga
2590,Shuto Machino,jp JPN,"FW,MF",25-224,20.9,8,5,4,3,1,6,15,40.0,9,12,3,9,7,15,27,0,Matches,Holstein-Kiel,Bundesliga
2591,Magnus Knudsen,no NOR,MF,23-331,20.1,48,29,21,21,6,25,44,56.8,19,18,4,14,12,60,42,0,Matches,Holstein-Kiel,Bundesliga
2592,Finn Porath,de GER,"DF,MF",28-078,21.6,44,25,23,14,7,25,52,48.1,27,27,9,18,20,64,67,0,Matches,Holstein-Kiel,Bundesliga
2593,Lasse Rosenboom,de GER,DF,23-113,18.3,42,30,20,16,6,28,42,66.7,14,27,8,19,18,60,69,2,Matches,Holstein-Kiel,Bundesliga
2594,Marko Ivezić,rs SRB,DF,23-161,18.4,29,19,20,6,3,15,42,35.7,27,25,13,12,27,56,102,2,Matches,Holstein-Kiel,Bundesliga
2595,Phil Harres,de GER,FW,23-048,17.0,10,10,3,4,3,4,8,50.0,4,17,3,14,5,15,20,0,Matches,Holstein-Kiel,Bundesliga
2596,David Zec,si SVN,DF,25-127,16.1,22,9,16,6,0,12,18,66.7,6,30,17,13,16,38,86,3,Matches,Holstein-Kiel,Bundesliga
2597,Marco Komenda,hr CRO,DF,28-167,14.5,26,17,12,13,1,11,15,73.3,4,23,11,12,6,32,68,0,Matches,Holstein-Kiel,Bundesliga
2598,Steven Skrzybski,de GER,"MF,FW",32-175,14.2,18,5,7,6,5,7,24,29.2,17,16,0,16,11,29,11,0,Matches,Holstein-Kiel,Bundesliga
2599,Alexander Bernhardsson,se SWE,"FW,MF",26-246,13.2,26,14,7,8,11,17,27,63.0,10,14,0,14,4,30,23,0,Matches,Holstein-Kiel,Bundesliga
2600,Max Geschwill,de GER,DF,23-309,13.7,26,21,13,12,1,14,19,73.7,5,14,9,5,27,53,50,1,Matches,Holstein-Kiel,Bundesliga
2601,Lewis Holtby,de GER,MF,34-236,13.3,32,20,17,10,5,10,26,38.5,16,14,2,12,21,53,26,3,Matches,Holstein-Kiel,Bundesliga
2602,Patrick Erras,de GER,DF,30-111,9.2,8,5,6,2,0,2,9,22.2,7,13,11,2,9,17,64,0,Matches,Holstein-Kiel,Bundesliga
2603,Thomas Dähne,de GER,GK,31-128,8.0,0,0,0,0,0,0,0,,0,0,0,0,0,0,7,2,Matches,Holstein-Kiel,Bundesliga
2604,John Tolkin,us USA,"DF,MF",22-285,7.2,18,11,11,7,0,12,14,85.7,2,9,2,7,7,25,48,0,Matches,Holstein-Kiel,Bundesliga
2605,Benedikt Pichler,at AUT,FW,27-296,8.7,5,2,1,0,4,2,4,50.0,2,4,2,2,2,7,11,0,Matches,Holstein-Kiel,Bundesliga
2606,Carl Johansson,se SWE,DF,30-354,6.2,4,2,4,0,0,3,7,42.9,4,12,8,4,10,14,53,1,Matches,Holstein-Kiel,Bundesliga
2607,Tymoteusz Puchacz,pl POL,DF,26-109,4.4,9,4,6,3,0,5,7,71.4,2,4,1,3,3,12,11,0,Matches,Holstein-Kiel,Bundesliga
2608,Dominik Javorček,sk SVK,"DF,MF",22-191,4.3,3,0,3,0,0,1,5,20.0,4,7,3,4,5,8,26,1,Matches,Holstein-Kiel,Bundesliga
2609,Jann-Fiete Arp,de GER,"FW,MF",25-126,7.9,13,10,5,2,6,4,13,30.8,9,6,0,6,3,16,8,1,Matches,Holstein-Kiel,Bundesliga
2610,Marvin Schulz,de GER,"MF,DF",30-117,3.4,6,5,2,2,2,2,8,25.0,6,12,8,4,0,6,17,0,Matches,Holstein-Kiel,Bundesliga
2611,Andu Kelati,de GER,"MF,DF",22-272,3.2,7,4,2,4,1,2,5,40.0,3,4,1,3,3,10,3,0,Matches,Holstein-Kiel,Bundesliga
2612,Ivan Nekić,hr CRO,DF,24-139,0.8,1,1,1,0,0,1,2,50.0,1,1,0,1,3,4,2,0,Matches,Holstein-Kiel,Bundesliga
2613,Granit Xhaka,ch SUI,MF,32-227,32.1,48,26,15,27,6,24,42,57.1,18,30,7,23,13,61,52,4,Matches,Bayer-Leverkusen,Bundesliga
2614,Jonathan Tah,de GER,DF,29-090,32.0,17,10,10,6,1,8,14,57.1,6,21,15,6,34,51,145,2,Matches,Bayer-Leverkusen,Bundesliga
2615,Álex Grimaldo,es ESP,DF,29-234,29.0,24,14,12,8,4,16,42,38.1,26,22,3,19,17,41,43,3,Matches,Bayer-Leverkusen,Bundesliga
2616,Lukáš Hrádecký,fi FIN,GK,35-169,28.0,0,0,0,0,0,0,1,0.0,1,0,0,0,0,0,7,2,Matches,Bayer-Leverkusen,Bundesliga
2617,Edmond Tapsoba,bf BFA,DF,26-099,26.9,37,22,18,15,4,20,37,54.1,17,18,12,6,24,61,87,3,Matches,Bayer-Leverkusen,Bundesliga
2618,Piero Hincapié,ec ECU,DF,23-123,28.7,51,40,27,15,9,24,39,61.5,15,35,17,18,32,83,109,1,Matches,Bayer-Leverkusen,Bundesliga
2619,Jeremie Frimpong,nl NED,"DF,MF",24-153,25.7,34,25,14,13,7,15,28,53.6,13,25,0,25,8,42,22,1,Matches,Bayer-Leverkusen,Bundesliga
2620,Florian Wirtz,de GER,"MF,FW",22-009,25.1,32,20,10,12,10,9,21,42.9,12,28,2,26,9,41,5,1,Matches,Bayer-Leverkusen,Bundesliga
2621,Robert Andrich,de GER,"MF,DF",30-232,17.3,24,12,8,14,2,7,14,50.0,7,16,8,8,29,53,22,0,Matches,Bayer-Leverkusen,Bundesliga
2622,Patrik Schick,cz CZE,FW,29-108,17.7,6,5,1,3,2,1,5,20.0,4,7,0,7,4,10,15,1,Matches,Bayer-Leverkusen,Bundesliga
2623,Aleix García,es ESP,MF,27-318,15.2,12,6,4,6,2,6,13,46.2,7,12,2,10,10,22,24,1,Matches,Bayer-Leverkusen,Bundesliga
2624,Nathan Tella,ng NGA,"MF,FW",25-311,14.6,15,10,4,6,5,5,12,41.7,7,14,1,13,4,19,6,0,Matches,Bayer-Leverkusen,Bundesliga
2625,Victor Boniface,ng NGA,FW,24-140,11.2,5,4,0,3,2,3,4,75.0,1,1,0,1,0,5,5,0,Matches,Bayer-Leverkusen,Bundesliga
2626,Exequiel Palacios,ar ARG,MF,26-219,11.8,21,15,7,10,4,8,15,53.3,7,14,1,13,12,33,11,0,Matches,Bayer-Leverkusen,Bundesliga
2627,Nordi Mukiele,fr FRA,DF,27-192,10.0,20,16,8,8,4,12,18,66.7,6,10,0,10,16,36,37,2,Matches,Bayer-Leverkusen,Bundesliga
2628,Arthur,br BRA,DF,22-056,7.6,14,11,3,9,2,5,10,50.0,5,7,0,7,9,23,26,0,Matches,Bayer-Leverkusen,Bundesliga
2629,Martin Terrier,fr FRA,"MF,FW",28-069,6.5,4,2,1,0,3,1,4,25.0,3,3,0,3,1,5,1,0,Matches,Bayer-Leverkusen,Bundesliga
2630,Amine Adli,ma MAR,"MF,FW",25-002,8.0,14,8,3,2,9,4,11,36.4,7,11,0,11,0,14,5,0,Matches,Bayer-Leverkusen,Bundesliga
2631,Matej Kovar,cz CZE,GK,24-360,5.0,0,0,0,0,0,0,0,,0,0,0,0,0,0,0,1,Matches,Bayer-Leverkusen,Bundesliga
2632,Jonas Hofmann,de GER,"MF,DF",32-302,3.5,2,0,0,2,0,1,4,25.0,3,2,0,2,0,2,2,0,Matches,Bayer-Leverkusen,Bundesliga
2633,Mario Hermoso,es ESP,DF,29-328,3.3,0,0,0,0,0,0,0,,0,3,1,2,9,9,15,1,Matches,Bayer-Leverkusen,Bundesliga
2634,Emi Buendía,ar ARG,MF,28-138,2.8,6,5,1,4,1,5,8,62.5,3,5,0,5,0,6,0,0,Matches,Bayer-Leverkusen,Bundesliga
2635,Jeanuël Belocian,fr FRA,"DF,MF",20-084,0.8,1,1,1,0,0,1,1,100.0,0,0,0,0,0,1,2,0,Matches,Bayer-Leverkusen,Bundesliga
2636,Kaishu Sano,jp JPN,MF,24-133,32.8,58,34,22,28,8,22,48,45.8,26,66,14,52,60,118,56,1,Matches,Mainz-05,Bundesliga
2637,Anthony Caci,fr FRA,DF,27-315,29.1,60,40,23,25,12,28,43,65.1,15,33,8,25,24,84,47,2,Matches,Mainz-05,Bundesliga
2638,Robin Zentner,de GER,GK,30-196,31.0,2,1,2,0,0,1,2,50.0,1,0,0,0,0,2,31,4,Matches,Mainz-05,Bundesliga
2639,Phillipp Mwene,at AUT,DF,31-103,28.0,49,28,22,22,5,17,44,38.6,27,27,6,21,24,73,51,1,Matches,Mainz-05,Bundesliga
2640,Lee Jae-sung,kr KOR,MF,32-275,28.5,42,21,16,19,7,15,38,39.5,23,36,3,33,34,76,38,0,Matches,Mainz-05,Bundesliga
2641,Nadiem Amiri,de GER,MF,28-197,26.5,48,21,13,27,8,18,45,40.0,27,19,4,15,16,64,30,2,Matches,Mainz-05,Bundesliga
2642,Dominik Kohr,de GER,"DF,MF",31-101,25.5,62,46,34,21,7,35,55,63.6,20,43,24,19,42,104,127,0,Matches,Mainz-05,Bundesliga
2643,Jonathan Burkardt,de GER,FW,24-305,22.4,14,8,1,7,6,5,9,55.6,4,11,1,10,1,15,14,0,Matches,Mainz-05,Bundesliga
2644,Paul Nebel,de GER,MF,22-214,25.1,34,22,10,15,9,11,34,32.4,23,52,4,48,13,47,30,2,Matches,Mainz-05,Bundesliga
2645,Danny da Costa,de GER,DF,31-303,21.3,41,23,22,15,4,17,27,63.0,10,19,10,9,27,68,95,3,Matches,Mainz-05,Bundesliga
2646,Moritz Jenz,de GER,DF,26-012,17.8,36,20,18,18,0,16,21,76.2,5,23,14,9,30,66,128,2,Matches,Mainz-05,Bundesliga
2647,Stefan Bell,de GER,DF,33-261,15.0,21,11,16,5,0,9,14,64.3,5,15,13,2,27,48,99,1,Matches,Mainz-05,Bundesliga
2648,Andreas Hanche-Olsen,no NOR,DF,28-115,13.3,21,13,12,8,1,9,12,75.0,3,24,17,7,11,32,81,2,Matches,Mainz-05,Bundesliga
2649,Nelson Weiper,de GER,"FW,MF",20-056,7.8,5,4,2,3,0,2,4,50.0,2,5,0,5,2,7,5,1,Matches,Mainz-05,Bundesliga
2650,Maxim Leitsch,de GER,DF,26-359,7.5,12,4,6,4,2,7,9,77.8,2,12,4,8,10,22,42,1,Matches,Mainz-05,Bundesliga
2651,Armindo Sieb,de GER,"FW,MF",22-084,8.5,10,4,4,5,1,3,10,30.0,7,4,0,4,1,11,7,0,Matches,Mainz-05,Bundesliga
2652,Hong Hyunseok,kr KOR,MF,25-330,5.9,8,3,3,3,2,1,4,25.0,3,7,1,6,7,15,8,0,Matches,Mainz-05,Bundesliga
2653,Silvan Widmer,ch SUI,DF,32-068,5.6,11,5,3,6,2,8,12,66.7,4,7,1,6,5,16,27,0,Matches,Mainz-05,Bundesliga
2654,Nikolas Veratschnig,at AUT,"DF,MF",22-108,3.8,9,6,1,4,4,2,3,66.7,1,4,0,4,4,13,8,0,Matches,Mainz-05,Bundesliga
2655,Lasse Rieß,de GER,GK,23-289,2.0,0,0,0,0,0,0,0,,0,0,0,0,0,0,5,0,Matches,Mainz-05,Bundesliga
2656,Karim Onisiwo,at AUT,"MF,FW",33-056,1.2,1,1,0,0,1,0,0,,0,0,0,0,0,1,0,0,Matches,Mainz-05,Bundesliga
2657,Arnaud Nordin,fr FRA,"DF,MF",26-329,0.9,2,0,0,2,0,1,1,100.0,0,2,1,1,0,2,2,0,Matches,Mainz-05,Bundesliga
2658,Aymen Barkok,ma MAR,MF,26-356,0.8,2,1,1,1,0,1,1,100.0,0,1,1,0,2,4,0,0,Matches,Mainz-05,Bundesliga
2659,Lennard Maloney,us USA,MF,25-216,0.3,1,0,0,0,1,1,1,100.0,0,2,0,2,0,1,3,0,Matches,Mainz-05,Bundesliga
2660,Gabriel Vidovic,hr CRO,MF,21-162,0.0,0,0,0,0,0,0,0,,0,0,0,0,0,0,0,0,Matches,Mainz-05,Bundesliga
2661,Benjamin Šeško,si SVN,"FW,MF",21-346,26.4,7,3,0,4,3,3,11,27.3,8,15,4,11,5,12,20,0,Matches,RB-Leipzig,Bundesliga
2662,Péter Gulácsi,hu HUN,GK,35-006,28.2,1,1,1,0,0,1,2,50.0,1,0,0,0,0,1,15,4,Matches,RB-Leipzig,Bundesliga
2663,Loïs Openda,be BEL,"FW,MF",25-085,27.1,9,4,3,4,2,3,11,27.3,8,19,1,18,5,14,12,0,Matches,RB-Leipzig,Bundesliga
2664,Willi Orban,hu HUN,DF,32-190,24.7,38,21,23,14,1,23,32,71.9,9,45,31,14,21,59,169,4,Matches,RB-Leipzig,Bundesliga
2665,Xavi Simons,nl NED,MF,22-021,22.9,26,19,5,15,6,12,26,46.2,14,17,3,14,12,38,19,1,Matches,RB-Leipzig,Bundesliga
2666,Lukas Klostermann,de GER,DF,28-343,20.4,27,14,18,7,2,14,24,58.3,10,31,17,14,24,51,143,3,Matches,RB-Leipzig,Bundesliga
2667,David Raum,de GER,DF,27-020,18.8,36,27,15,13,8,19,34,55.9,15,25,8,17,9,45,43,4,Matches,RB-Leipzig,Bundesliga
2668,Nicolas Seiwald,at AUT,"MF,DF",24-008,22.2,51,31,19,27,5,24,48,50.0,24,42,9,33,30,81,71,2,Matches,RB-Leipzig,Bundesliga
2669,Christoph Baumgartner,at AUT,"MF,FW",25-284,17.7,44,28,13,19,12,17,41,41.5,24,45,9,36,12,56,24,2,Matches,RB-Leipzig,Bundesliga
2670,Castello Lukeba,fr FRA,DF,22-146,17.5,31,17,15,12,4,17,24,70.8,7,29,12,17,17,48,74,0,Matches,RB-Leipzig,Bundesliga
2671,Kevin Kampl,si SVN,MF,34-215,16.7,26,18,11,9,6,15,22,68.2,7,25,6,19,23,49,24,0,Matches,RB-Leipzig,Bundesliga
2672,Arthur Vermeeren,be BEL,MF,20-094,16.6,31,18,14,12,5,13,46,28.3,33,34,12,22,23,54,25,2,Matches,RB-Leipzig,Bundesliga
2673,Lutsharel Geertruida,nl NED,DF,24-298,16.3,35,24,24,11,0,15,31,48.4,16,15,4,11,16,51,56,4,Matches,RB-Leipzig,Bundesliga
2674,Amadou Haidara,ml MLI,MF,27-101,14.7,30,17,12,16,2,12,29,41.4,17,42,12,30,18,48,56,1,Matches,RB-Leipzig,Bundesliga
2675,Antonio Nusa,no NOR,"MF,DF",20-025,16.5,30,17,16,9,5,18,36,50.0,18,21,2,19,8,38,11,0,Matches,RB-Leipzig,Bundesliga
2676,Ridle Baku,de GER,"DF,MF",27-034,13.2,21,18,9,11,1,8,20,40.0,12,16,2,14,9,30,44,0,Matches,RB-Leipzig,Bundesliga
2677,El Chadaille Bitshiabu,fr FRA,DF,19-361,11.6,24,16,14,9,1,9,18,50.0,9,24,13,11,11,35,91,1,Matches,RB-Leipzig,Bundesliga
2678,Benjamin Henrichs,de GER,DF,28-078,10.4,32,16,18,10,4,14,27,51.9,13,22,3,19,15,47,33,0,Matches,RB-Leipzig,Bundesliga
2679,Kosta Nedeljković,rs SRB,DF,19-147,5.3,11,8,5,6,0,6,10,60.0,4,6,4,2,2,13,14,0,Matches,RB-Leipzig,Bundesliga
2680,Maarten Vandevoordt,be BEL,GK,23-075,4.8,1,0,1,0,0,1,1,100.0,0,0,0,0,0,1,4,0,Matches,RB-Leipzig,Bundesliga
2681,Yussuf Poulsen,dk DEN,"FW,MF",30-331,4.0,10,5,2,6,2,4,8,50.0,4,7,2,5,0,10,14,0,Matches,RB-Leipzig,Bundesliga
2682,Xaver Schlager,at AUT,MF,27-226,2.0,4,2,2,1,1,3,7,42.9,4,7,0,7,0,4,3,0,Matches,RB-Leipzig,Bundesliga
2683,Mohamed Simakan,fr FRA,DF,25-009,0.6,0,0,0,0,0,0,0,,0,0,0,0,2,2,0,0,Matches,RB-Leipzig,Bundesliga
2684,André Silva,pt POR,"FW,MF",29-187,1.5,1,1,1,0,0,0,1,0.0,1,1,0,1,1,2,2,0,Matches,RB-Leipzig,Bundesliga
2685,Tidiam Gomis,fr FRA,"MF,DF",18-277,1.0,0,0,0,0,0,0,0,,0,2,0,2,1,1,0,0,Matches,RB-Leipzig,Bundesliga
2686,Assan Ouedraogo,de GER,MF,19-003,0.6,0,0,0,0,0,0,0,,0,1,0,1,0,0,0,0,Matches,RB-Leipzig,Bundesliga
2687,Elif Elmas,mk MKD,MF,25-230,0.5,3,1,3,0,0,1,3,33.3,2,2,0,2,0,3,2,0,Matches,RB-Leipzig,Bundesliga
2688,Viggo Gebel,de GER,MF,17-171,0.2,0,0,0,0,0,0,0,,0,0,0,0,0,0,0,0,Matches,RB-Leipzig,Bundesliga
2689,Faik Sakar,de GER,MF,17-118,0.0,0,0,0,0,0,0,0,,0,0,0,0,0,0,0,0,Matches,RB-Leipzig,Bundesliga
2690,Hauke Wahl,de GER,DF,31-027,32.0,35,26,20,13,2,21,34,61.8,13,44,25,19,31,66,169,4,Matches,St-Pauli,Bundesliga
2691,Nikola Vasilj,ba BIH,GK,29-161,32.0,0,0,0,0,0,0,2,0.0,2,0,0,0,0,0,22,3,Matches,St-Pauli,Bundesliga
2692,Philipp Treu,de GER,"MF,DF",24-160,31.0,61,42,35,17,9,39,66,59.1,27,52,12,40,19,80,87,2,Matches,St-Pauli,Bundesliga
2693,Eric Smith,se SWE,"DF,MF",28-124,30.4,46,29,26,17,3,23,39,59.0,16,36,10,26,37,83,103,4,Matches,St-Pauli,Bundesliga
2694,Jackson Irvine,au AUS,MF,32-066,29.0,56,28,24,26,6,25,45,55.6,20,27,5,22,36,92,63,2,Matches,St-Pauli,Bundesliga
2695,Manolis Saliakas,gr GRE,"MF,DF",28-242,25.0,46,22,24,18,4,25,48,52.1,23,38,8,30,19,65,62,0,Matches,St-Pauli,Bundesliga
2696,David Nemeth,at AUT,DF,24-055,22.7,42,28,25,15,2,25,42,59.5,17,28,11,17,16,58,93,2,Matches,St-Pauli,Bundesliga
2697,Johannes Eggestein,de GER,FW,27-004,20.3,5,3,0,2,3,1,5,20.0,4,5,0,5,0,5,8,0,Matches,St-Pauli,Bundesliga
2698,Morgan Guilavogui,gn GUI,"FW,MF",27-063,19.2,32,17,11,16,5,14,30,46.7,16,27,0,27,13,45,33,0,Matches,St-Pauli,Bundesliga
2699,Carlo Boukhalfa,ma MAR,MF,26-009,17.3,25,11,7,17,1,6,18,33.3,12,19,3,16,12,37,24,1,Matches,St-Pauli,Bundesliga
2700,Oladapo Afolayan,eng ENG,"FW,MF",27-089,17.7,17,8,4,8,5,7,19,36.8,12,16,1,15,8,25,20,0,Matches,St-Pauli,Bundesliga
2701,Danel Sinani,lu LUX,"FW,MF",28-037,13.2,14,11,2,7,5,6,13,46.2,7,12,1,11,1,15,13,0,Matches,St-Pauli,Bundesliga
2702,Noah Weißhaupt,de GER,"FW,MF",23-234,12.4,6,4,3,0,3,3,8,37.5,5,7,0,7,2,8,8,1,Matches,St-Pauli,Bundesliga
2703,Lars Ritzka,de GER,"DF,MF",27-005,9.6,49,29,28,16,5,25,41,61.0,16,15,2,13,11,60,37,0,Matches,St-Pauli,Bundesliga
2704,Karol Mets,ee EST,DF,31-361,10.0,13,8,6,7,0,4,7,57.1,3,9,3,6,12,25,60,0,Matches,St-Pauli,Bundesliga
2705,Elias Saad,tn TUN,"FW,MF",25-136,10.0,20,13,7,8,5,10,20,50.0,10,14,0,14,3,23,1,0,Matches,St-Pauli,Bundesliga
2706,Siebe Van Der Heyden,be BEL,"DF,MF",26-347,9.3,17,10,10,7,0,8,18,44.4,10,8,4,4,17,34,40,2,Matches,St-Pauli,Bundesliga
2707,James Sands,us USA,"MF,DF",24-310,5.0,15,6,5,8,2,4,4,100.0,0,5,1,4,5,20,8,0,Matches,St-Pauli,Bundesliga
2708,Robert Wagner,de GER,MF,21-302,4.5,8,3,2,6,0,4,13,30.8,9,8,0,8,2,10,11,0,Matches,St-Pauli,Bundesliga
2709,Connor Metcalfe,au AUS,"MF,FW",25-188,4.0,2,0,1,1,0,0,5,0.0,5,4,0,4,3,5,8,0,Matches,St-Pauli,Bundesliga
2710,Adam Dźwigała,pl POL,"DF,MF",29-229,3.8,20,10,13,6,1,11,16,68.8,5,6,1,5,3,23,26,0,Matches,St-Pauli,Bundesliga
2711,Ben Alexander Voll,de GER,GK,24-154,1.0,0,0,0,0,0,0,0,,0,0,0,0,0,0,0,0,Matches,St-Pauli,Bundesliga
2712,Scott Banks,sct SCO,"FW,MF",23-228,1.1,1,1,1,0,0,0,2,0.0,2,0,0,0,2,3,2,0,Matches,St-Pauli,Bundesliga
2713,Andreas Albers,dk DEN,FW,35-050,0.7,1,1,0,0,1,0,1,0.0,1,0,0,0,0,1,1,0,Matches,St-Pauli,Bundesliga
2714,Abdoulie Ceesay,gm GAM,FW,21-127,0.7,3,3,1,1,1,2,3,66.7,1,2,0,2,0,3,1,0,Matches,St-Pauli,Bundesliga
2715,Erik Ahlstrand,se SWE,"FW,MF",23-210,0.5,0,0,0,0,0,0,0,,0,1,0,1,1,1,1,0,Matches,St-Pauli,Bundesliga
2716,Maurides,br BRA,FW,31-063,0.0,0,0,0,0,0,0,0,,0,0,0,0,0,0,0,0,Matches,St-Pauli,Bundesliga
2717,Finley Stevens,wls WAL,DF,22-032,0.0,0,0,0,0,0,0,0,,0,0,0,0,0,0,0,0,Matches,St-Pauli,Bundesliga
2718,Alexander Nübel,de GER,GK,28-224,33.0,0,0,0,0,0,0,1,0.0,1,0,0,0,0,0,18,3,Matches,Stuttgart,Bundesliga
2719,Angelo Stiller,de GER,MF,24-038,30.5,49,27,18,25,6,14,30,46.7,16,29,9,20,26,75,50,4,Matches,Stuttgart,Bundesliga
2720,Atakan Karazor,,MF,28-211,28.1,57,28,17,28,12,28,56,50.0,28,38,6,32,32,89,50,1,Matches,Stuttgart,Bundesliga
2721,Maximilian Mittelstädt,de GER,DF,28-055,26.7,77,54,41,29,7,52,72,72.2,20,43,11,32,45,122,97,2,Matches,Stuttgart,Bundesliga
2722,Julian Chabot,de GER,DF,27-089,24.2,36,23,18,15,3,14,30,46.7,16,27,18,9,38,74,130,0,Matches,Stuttgart,Bundesliga
2723,Chris Führich,de GER,"MF,FW",27-123,21.8,15,10,5,5,5,13,27,48.1,14,23,2,21,6,21,19,0,Matches,Stuttgart,Bundesliga
2724,Enzo Millot,fr FRA,"MF,FW",22-299,19.7,28,12,10,13,5,11,33,33.3,22,27,0,27,11,39,6,1,Matches,Stuttgart,Bundesliga
2725,Jamie Leweling,de GER,"MF,FW",24-075,17.8,16,6,6,3,7,11,24,45.8,13,22,1,21,10,26,17,1,Matches,Stuttgart,Bundesliga
2726,Ermedin Demirović,ba BIH,FW,27-048,20.2,11,6,2,4,5,2,10,20.0,8,14,3,11,3,14,11,0,Matches,Stuttgart,Bundesliga
2727,Deniz Undav,de GER,"FW,MF",28-297,18.2,11,10,2,3,6,1,17,5.9,16,14,2,12,3,14,9,0,Matches,Stuttgart,Bundesliga
2728,Josha Vagnoman,de GER,"DF,MF",24-152,19.4,24,12,11,11,2,17,31,54.8,14,16,2,14,12,36,54,1,Matches,Stuttgart,Bundesliga
2729,Nick Woltemade,de GER,"FW,MF",23-087,17.1,9,6,2,4,3,6,10,60.0,4,22,2,20,1,10,14,1,Matches,Stuttgart,Bundesliga
2730,Anthony Rouault,fr FRA,DF,23-348,13.5,15,11,10,3,2,10,15,66.7,5,18,9,9,19,34,63,1,Matches,Stuttgart,Bundesliga
2731,Leonidas Stergiou,ch SUI,DF,23-070,9.5,24,13,9,11,4,16,19,84.2,3,16,5,11,14,38,39,0,Matches,Stuttgart,Bundesliga
2732,Ramon Hendriks,nl NED,DF,23-298,11.8,18,7,10,7,1,9,13,69.2,4,15,7,8,17,35,59,0,Matches,Stuttgart,Bundesliga
2733,Finn Jeltsch,de GER,DF,18-299,8.6,18,13,6,11,1,12,15,80.0,3,12,6,6,13,31,27,2,Matches,Stuttgart,Bundesliga
2734,Fabian Rieder,ch SUI,"MF,FW",23-085,9.6,17,14,4,9,4,7,23,30.4,16,10,1,9,10,27,7,1,Matches,Stuttgart,Bundesliga
2735,Anrie Chase,jp JPN,DF,21-049,8.2,10,4,6,4,0,5,7,71.4,2,10,6,4,9,19,35,0,Matches,Stuttgart,Bundesliga
2736,Ameen Al-Dakhil,be BEL,DF,23-067,4.8,6,6,4,2,0,4,4,100.0,0,12,8,4,9,15,30,1,Matches,Stuttgart,Bundesliga
2737,Pascal Stenzel,de GER,DF,29-053,3.2,3,2,1,0,2,2,5,40.0,3,5,1,4,2,5,6,0,Matches,Stuttgart,Bundesliga
2738,Jacob Bruun Larsen,dk DEN,"MF,FW",26-235,4.5,1,1,1,0,0,0,2,0.0,2,7,0,7,1,2,3,1,Matches,Stuttgart,Bundesliga
2739,El Bilal Touré,ml MLI,"FW,MF",23-221,4.0,4,1,1,1,2,3,3,100.0,0,1,0,1,0,4,1,0,Matches,Stuttgart,Bundesliga
2740,Yannik Keitel,de GER,MF,25-086,3.0,9,6,3,5,1,9,10,90.0,1,5,2,3,4,13,6,0,Matches,Stuttgart,Bundesliga
2741,Luca Jaquez,ch SUI,DF,21-344,1.9,3,0,3,0,0,1,2,50.0,1,2,0,2,1,4,2,0,Matches,Stuttgart,Bundesliga
2742,Frans Krätzig,de GER,DF,22-118,0.6,2,1,1,0,1,1,3,33.3,2,2,1,1,0,2,1,0,Matches,Stuttgart,Bundesliga
2743,Justin Diehl,de GER,"FW,DF",20-166,1.2,1,0,0,1,0,1,1,100.0,0,2,0,2,0,1,0,0,Matches,Stuttgart,Bundesliga
2744,Dan-Axel Zagadou,fr FRA,"DF,MF",25-343,0.3,0,0,0,0,0,0,0,,0,0,0,0,1,1,1,0,Matches,Stuttgart,Bundesliga
2745,Jarzinho Malanga,de GER,DF,18-306,0.0,0,0,0,0,0,0,0,,0,0,0,0,0,0,0,0,Matches,Stuttgart,Bundesliga
2746,Danilho Doekhi,nl NED,DF,26-316,33.0,36,23,17,16,3,13,23,56.5,10,33,15,18,42,78,165,1,Matches,Union-Berlin,Bundesliga
2747,Rani Khedira,de GER,MF,31-105,29.3,68,40,30,35,3,24,38,63.2,14,31,11,20,43,111,55,0,Matches,Union-Berlin,Bundesliga
2748,Diogo Leite,pt POR,DF,26-109,28.3,64,32,43,17,4,33,50,66.0,17,61,25,36,57,121,162,1,Matches,Union-Berlin,Bundesliga
2749,Benedict Hollerbach,de GER,"FW,MF",23-360,27.3,42,21,8,22,12,21,51,41.2,30,33,0,33,2,44,12,1,Matches,Union-Berlin,Bundesliga
2750,Frederik Rønnow,dk DEN,GK,32-281,28.0,0,0,0,0,0,0,1,0.0,1,0,0,0,0,0,22,2,Matches,Union-Berlin,Bundesliga
2751,Christopher Trimmel,at AUT,"DF,MF",38-077,19.0,38,25,23,14,1,28,42,66.7,14,13,6,7,18,56,90,0,Matches,Union-Berlin,Bundesliga
2752,Janik Haberer,de GER,"MF,DF",31-040,17.8,32,26,13,17,2,20,37,54.1,17,14,0,14,17,49,36,0,Matches,Union-Berlin,Bundesliga
2753,Tom Rothe,de GER,"DF,MF",20-195,17.6,43,26,25,15,3,28,49,57.1,21,38,3,35,16,59,49,1,Matches,Union-Berlin,Bundesliga
2754,Jeong Woo-yeong,kr KOR,"MF,FW",25-234,14.0,10,7,5,5,0,3,11,27.3,8,10,1,9,11,21,11,0,Matches,Union-Berlin,Bundesliga
2755,Leopold Querfeld,at AUT,DF,21-143,18.4,24,11,20,4,0,13,18,72.2,5,24,10,14,17,41,135,2,Matches,Union-Berlin,Bundesliga
2756,András Schäfer,hu HUN,MF,26-029,16.4,47,25,22,20,5,23,38,60.5,15,33,6,27,22,69,35,0,Matches,Union-Berlin,Bundesliga
2757,Kevin Vogt,de GER,DF,33-231,15.2,12,8,7,5,0,8,13,61.5,5,16,8,8,9,21,75,1,Matches,Union-Berlin,Bundesliga
2758,Josip Juranović,hr CRO,"DF,MF",29-269,12.2,21,13,12,6,3,10,25,40.0,15,13,6,7,7,28,39,2,Matches,Union-Berlin,Bundesliga
2759,Aljoscha Kemlein,de GER,MF,20-283,10.2,10,4,4,5,1,5,14,35.7,9,14,3,11,6,16,15,0,Matches,Union-Berlin,Bundesliga
2760,Andrej Ilic,rs SRB,FW,25-039,10.1,2,2,0,2,0,0,5,0.0,5,7,3,4,5,7,6,1,Matches,Union-Berlin,Bundesliga
2761,Robert Skov,dk DEN,"DF,MF",28-357,9.5,15,11,8,7,0,10,20,50.0,10,8,1,7,8,23,9,0,Matches,Union-Berlin,Bundesliga
2762,Tim Skarke,de GER,"FW,MF",28-247,12.1,14,11,5,8,1,10,19,52.6,9,7,0,7,5,19,17,0,Matches,Union-Berlin,Bundesliga
2763,Jordan Pefok,us USA,FW,29-016,10.1,11,6,6,0,5,3,7,42.9,4,9,2,7,4,15,18,0,Matches,Union-Berlin,Bundesliga
2764,Yorbe Vertessen,be BEL,"MF,FW",24-124,8.0,6,3,3,2,1,2,8,25.0,6,6,0,6,3,9,6,0,Matches,Union-Berlin,Bundesliga
2765,Lucas Tousart,fr FRA,MF,28-013,5.9,17,9,6,9,2,5,12,41.7,7,9,3,6,7,24,23,0,Matches,Union-Berlin,Bundesliga
2766,Alexander Schwolow,de GER,GK,32-344,5.0,0,0,0,0,0,0,0,,0,0,0,0,0,0,1,0,Matches,Union-Berlin,Bundesliga
2767,László Bénes,sk SVK,"MF,FW",27-245,6.5,2,2,1,1,0,1,3,33.3,2,5,1,4,3,5,9,0,Matches,Union-Berlin,Bundesliga
2768,Ivan Prtajin,hr CRO,FW,28-363,1.8,3,2,0,1,2,0,0,,0,2,0,2,0,3,3,0,Matches,Union-Berlin,Bundesliga
2769,Marin Ljubicic,hr CRO,"FW,MF",23-073,3.0,2,1,0,2,0,1,3,33.3,2,2,0,2,0,2,7,0,Matches,Union-Berlin,Bundesliga
2770,Jérôme Roussillon,fr FRA,"DF,MF",32-126,1.5,0,0,0,0,0,0,2,0.0,2,0,0,0,2,2,7,0,Matches,Union-Berlin,Bundesliga
2771,Robin Gosens,de GER,DF,30-311,1.0,0,0,0,0,0,0,3,0.0,3,1,0,1,1,1,2,0,Matches,Union-Berlin,Bundesliga
2772,David Preu,de GER,"DF,MF",20-198,0.7,1,1,0,1,0,0,2,0.0,2,3,2,1,0,1,2,0,Matches,Union-Berlin,Bundesliga
2773,Kevin Volland,de GER,"FW,MF",32-286,0.7,0,0,0,0,0,0,0,,0,1,0,1,0,0,1,0,Matches,Union-Berlin,Bundesliga
2774,Michael Zetterer,de GER,GK,29-304,33.0,0,0,0,0,0,0,1,0.0,1,1,0,1,1,1,10,6,Matches,Werder-Bremen,Bundesliga
2775,Mitchell Weiser,de GER,"DF,MF",31-021,30.9,58,38,17,33,8,26,53,49.1,27,29,2,27,22,80,60,3,Matches,Werder-Bremen,Bundesliga
2776,Romano Schmid,at AUT,MF,25-105,30.5,41,23,10,20,11,22,48,45.8,26,42,3,39,11,52,9,2,Matches,Werder-Bremen,Bundesliga
2777,Senne Lynen,be BEL,MF,26-082,29.4,72,39,36,30,6,39,67,58.2,28,54,12,42,65,137,71,5,Matches,Werder-Bremen,Bundesliga
2778,Marvin Ducksch,de GER,FW,31-066,25.9,10,7,3,5,2,3,14,21.4,11,9,2,7,8,18,25,2,Matches,Werder-Bremen,Bundesliga
2779,Jens Stage,dk DEN,MF,28-185,23.7,45,28,21,21,3,23,43,53.5,20,44,10,34,18,63,41,2,Matches,Werder-Bremen,Bundesliga
2780,Marco Friedl,at AUT,DF,27-057,23.0,60,40,34,25,1,38,64,59.4,26,39,23,16,34,94,128,1,Matches,Werder-Bremen,Bundesliga
2781,Niklas Stark,de GER,DF,30-028,22.4,33,21,20,11,2,14,21,66.7,7,39,26,13,34,67,122,1,Matches,Werder-Bremen,Bundesliga
2782,Anthony Jung,de GER,DF,33-190,21.0,34,22,22,11,1,22,34,64.7,12,23,14,9,25,59,76,1,Matches,Werder-Bremen,Bundesliga
2783,Felix Agu,de GER,DF,25-227,18.7,28,13,11,13,4,12,22,54.5,10,24,8,16,18,46,48,0,Matches,Werder-Bremen,Bundesliga
2784,Amos Pieper,de GER,DF,27-115,15.7,30,17,16,9,5,19,29,65.5,10,28,17,11,23,53,95,1,Matches,Werder-Bremen,Bundesliga
2785,Derrick Köhn,de GER,"DF,FW",26-097,14.7,20,10,7,10,3,10,14,71.4,4,21,4,17,9,29,26,0,Matches,Werder-Bremen,Bundesliga
2786,Marco Grüll,at AUT,"FW,MF",26-310,12.3,11,8,1,4,6,4,17,23.5,13,14,2,12,3,14,9,0,Matches,Werder-Bremen,Bundesliga
2787,Miloš Veljković,rs SRB,DF,29-228,11.4,10,5,6,3,1,7,15,46.7,8,14,9,5,2,12,47,1,Matches,Werder-Bremen,Bundesliga
2788,Leonardo Bittencourt,de GER,MF,31-144,10.7,25,9,15,7,3,6,18,33.3,12,8,0,8,14,39,11,0,Matches,Werder-Bremen,Bundesliga
2789,Justin Njinmah,de GER,"FW,MF",24-178,10.4,5,2,1,3,1,3,5,60.0,2,5,0,5,3,8,1,0,Matches,Werder-Bremen,Bundesliga
2790,Oliver Burke,sct SCO,FW,28-035,10.1,11,4,5,1,5,4,6,66.7,2,20,0,20,2,13,6,0,Matches,Werder-Bremen,Bundesliga
2791,Julián Malatini,ar ARG,DF,23-346,5.0,11,9,5,5,1,5,11,45.5,6,8,3,5,7,18,17,0,Matches,Werder-Bremen,Bundesliga
2792,André Silva,pt POR,FW,29-187,4.2,2,2,1,1,0,0,1,0.0,1,3,1,2,0,2,3,0,Matches,Werder-Bremen,Bundesliga
2793,Issa Kaboré,bf BFA,"DF,FW",24-000,3.4,8,4,2,5,1,4,6,66.7,2,8,2,6,2,10,7,0,Matches,Werder-Bremen,Bundesliga
2794,Keke Maximilian Topp,de GER,"FW,MF",21-048,2.7,3,1,0,2,1,1,2,50.0,1,0,0,0,1,4,4,0,Matches,Werder-Bremen,Bundesliga
2795,Skelly Alvero,fr FRA,MF,23-008,2.6,11,6,5,5,1,4,5,80.0,1,4,0,4,2,13,10,0,Matches,Werder-Bremen,Bundesliga
2796,Olivier Deman,be BEL,DF,25-036,0.7,6,3,2,4,0,2,7,28.6,5,3,1,2,3,9,4,0,Matches,Werder-Bremen,Bundesliga
2797,Kilian Fischer,de GER,DF,24-212,25.5,64,44,48,12,4,47,89,52.8,42,41,8,33,19,83,98,2,Matches,Wolfsburg,Bundesliga
2798,Kamil Grabara,pl POL,GK,26-124,27.7,0,0,0,0,0,0,2,0.0,2,1,0,1,0,0,15,2,Matches,Wolfsburg,Bundesliga
2799,Mohamed Amoura,dz ALG,FW,25-003,26.4,26,20,12,5,9,12,34,35.3,22,40,2,38,9,35,22,0,Matches,Wolfsburg,Bundesliga
2800,Konstantinos Koulierakis,gr GRE,DF,21-165,26.4,40,20,25,13,2,25,40,62.5,15,32,14,18,30,70,140,2,Matches,Wolfsburg,Bundesliga
2801,Denis Vavro,sk SVK,DF,29-032,26.3,18,13,14,4,0,8,20,40.0,12,45,31,14,34,52,227,3,Matches,Wolfsburg,Bundesliga
2802,Maximilian Arnold,de GER,MF,30-350,25.2,33,20,13,18,2,15,33,45.5,18,21,11,10,24,57,69,2,Matches,Wolfsburg,Bundesliga
2803,Joakim Mæhle,dk DEN,DF,27-357,23.3,33,15,25,6,2,17,45,37.8,28,24,3,21,23,56,49,2,Matches,Wolfsburg,Bundesliga
2804,Tiago Tomás,pt POR,"FW,MF",22-330,20.9,33,19,15,11,7,15,35,42.9,20,17,4,13,9,42,19,0,Matches,Wolfsburg,Bundesliga
2805,Jonas Wind,dk DEN,"FW,MF",26-094,21.8,10,6,1,8,1,4,8,50.0,4,17,3,14,6,16,15,0,Matches,Wolfsburg,Bundesliga
2806,Patrick Wimmer,at AUT,"MF,FW",23-347,19.0,46,34,19,20,7,15,45,33.3,30,31,4,27,31,77,15,2,Matches,Wolfsburg,Bundesliga
2807,Bence Dárdai,hu HUN,MF,19-108,14.3,24,14,9,13,2,16,29,55.2,13,20,4,16,12,36,28,1,Matches,Wolfsburg,Bundesliga
2808,Yannick Gerhardt,de GER,"MF,DF",31-060,15.9,25,14,13,11,1,10,28,35.7,18,29,8,21,16,41,45,0,Matches,Wolfsburg,Bundesliga
2809,Mattias Svanberg,se SWE,MF,26-127,13.5,20,10,6,11,3,9,19,47.4,10,11,4,7,15,35,26,0,Matches,Wolfsburg,Bundesliga
2810,Ridle Baku,de GER,"FW,MF",27-034,13.0,23,15,9,9,5,8,19,42.1,11,22,1,21,15,38,15,0,Matches,Wolfsburg,Bundesliga
2811,Jakub Kamiński,pl POL,"DF,MF",22-341,11.6,17,8,8,3,6,9,22,40.9,13,17,7,10,11,28,22,1,Matches,Wolfsburg,Bundesliga
2812,Sebastiaan Bornauw,be BEL,DF,26-051,8.7,9,6,4,4,1,4,8,50.0,4,14,12,2,12,21,35,0,Matches,Wolfsburg,Bundesliga
2813,Aster Vranckx,be BEL,MF,22-220,6.2,11,6,3,8,0,3,9,33.3,6,14,3,11,10,21,13,0,Matches,Wolfsburg,Bundesliga
2814,Cedric Zesiger,ch SUI,DF,26-322,5.8,13,8,6,5,2,6,12,50.0,6,6,5,1,3,16,28,0,Matches,Wolfsburg,Bundesliga
2815,Marius Müller,de GER,GK,31-304,5.3,0,0,0,0,0,0,0,,0,0,0,0,0,0,0,0,Matches,Wolfsburg,Bundesliga
2816,Andreas Skov Olsen,dk DEN,"FW,MF",25-134,5.6,8,6,5,3,0,4,4,100.0,0,4,0,4,2,10,10,0,Matches,Wolfsburg,Bundesliga
2817,Salih Özcan,tr TUR,MF,27-121,3.9,2,2,1,0,1,1,5,20.0,4,5,1,4,7,9,5,0,Matches,Wolfsburg,Bundesliga
2818,Lukas Nmecha,de GER,"FW,MF",26-149,4.4,2,0,1,1,0,0,1,0.0,1,1,0,1,2,4,3,0,Matches,Wolfsburg,Bundesliga
2819,Mads Roerslev,dk DEN,DF,25-322,3.3,10,9,8,1,1,6,9,66.7,3,2,2,0,5,15,16,0,Matches,Wolfsburg,Bundesliga
2820,Lovro Majer,hr CRO,MF,27-115,2.6,1,1,0,0,1,1,5,20.0,4,2,0,2,0,1,2,1,Matches,Wolfsburg,Bundesliga
2821,David Odogu,de GER,DF,18-343,2.2,6,4,4,2,0,3,5,60.0,2,2,2,0,2,8,25,1,Matches,Wolfsburg,Bundesliga
2822,Kevin Paredes,us USA,DF,22-005,1.4,3,1,3,0,0,2,3,66.7,1,2,2,0,1,4,0,0,Matches,Wolfsburg,Bundesliga
2823,Kevin Behrens,de GER,FW,34-098,1.7,1,1,0,1,0,0,1,0.0,1,0,0,0,1,2,2,0,Matches,Wolfsburg,Bundesliga
