,Player,Nation,Pos,Age,90s,Tkl,TklW,Def 3rd,Mid 3rd,Att 3rd,Tkl,Att,Tkl%,Lost,Blocks,Sh,Pass,Int,Tkl+Int,Clr,Err,Matches,Squad,League
0,David Raya,es ESP,GK,28.0,38.0,0,0,0,0,0,0,2,0.0,2,0,0,0,2,2,21,9,Matches,Arsenal,Premier-League
1,William Saliba,fr FRA,DF,23.0,33.8,62,37,37,23,2,21,28,75.0,7,25,15,10,21,83,119,7,Matches,Arsenal,Premier-League
2,Declan Rice,eng ENG,MF,25.0,31.4,53,25,22,25,6,17,41,41.5,24,27,13,14,25,78,51,0,Matches,Arsenal,Premier-League
3,Thomas Partey,gh GHA,"MF,DF",31.0,31.1,89,53,26,39,24,46,76,60.5,30,29,9,20,35,124,49,4,Matches,Arsenal,Premier-League
4,Leandro Trossard,be BEL,FW,29.0,28.3,31,20,6,16,9,12,34,35.3,22,32,0,32,9,40,18,0,Matches,Arsenal,Premier-League
5,Gabriel Magalhães,br BRA,DF,26.0,26.3,25,15,12,8,5,12,16,75.0,4,42,29,13,16,41,93,2,Matches,Arsenal,Premier-League
6,Jurriën Timber,nl NED,DF,23.0,26.9,58,38,17,30,11,18,27,66.7,9,19,4,15,22,80,44,1,Matches,Arsenal,Premier-League
7,Martin Ødegaard,no NOR,MF,25.0,25.8,19,11,9,7,3,4,25,16.0,21,5,0,5,6,25,6,1,Matches,Arsenal,Premier-League
8,Gabriel Martinelli,br BRA,"FW,MF",23.0,25.4,23,15,9,6,8,7,23,30.4,16,15,0,15,5,28,19,0,Matches,Arsenal,Premier-League
9,Kai Havertz,de GER,"FW,MF",25.0,20.8,16,9,3,6,7,4,15,26.7,11,23,4,19,6,22,33,1,Matches,Arsenal,Premier-League
10,Bukayo Saka,eng ENG,"FW,MF",22.0,19.2,29,15,9,11,9,13,24,54.2,11,22,0,22,3,32,8,0,Matches,Arsenal,Premier-League
11,Mikel Merino,es ESP,"MF,FW",28.0,17.6,46,28,7,26,13,20,36,55.6,16,18,5,13,15,61,26,2,Matches,Arsenal,Premier-League
12,Myles Lewis-Skelly,eng ENG,DF,17.0,15.2,22,14,10,9,3,10,11,90.9,1,4,1,3,7,29,27,0,Matches,Arsenal,Premier-League
13,Ben White,eng ENG,DF,26.0,13.3,20,14,10,4,6,16,38,42.1,22,10,8,2,16,36,44,0,Matches,Arsenal,Premier-League
14,Riccardo Calafiori,it ITA,DF,22.0,10.9,27,19,15,10,2,18,29,62.1,11,12,6,6,9,36,25,0,Matches,Arsenal,Premier-League
15,Ethan Nwaneri,eng ENG,"FW,MF",17.0,9.9,11,7,4,4,3,7,21,33.3,14,8,2,6,2,13,4,1,Matches,Arsenal,Premier-League
16,Jakub Kiwior,pl POL,DF,24.0,12.5,22,8,13,7,2,11,15,73.3,4,13,8,5,6,28,58,3,Matches,Arsenal,Premier-League
17,Jorginho,it ITA,MF,32.0,7.8,12,4,1,7,4,8,20,40.0,12,3,0,3,7,19,2,2,Matches,Arsenal,Premier-League
18,Raheem Sterling,eng ENG,"FW,MF",29.0,5.5,9,4,1,3,5,5,10,50.0,5,3,0,3,1,10,4,0,Matches,Arsenal,Premier-League
19,Gabriel Jesus,br BRA,FW,27.0,6.8,10,6,4,3,3,4,9,44.4,5,10,1,9,4,14,8,0,Matches,Arsenal,Premier-League
20,Oleksandr Zinchenko,ua UKR,"DF,MF",27.0,5.9,6,1,1,3,2,3,8,37.5,5,8,1,7,5,11,10,0,Matches,Arsenal,Premier-League
21,Kieran Tierney,sct SCO,"DF,FW",27.0,2.9,7,5,4,1,2,4,6,66.7,2,0,0,0,3,10,9,0,Matches,Arsenal,Premier-League
22,Nathan Butler-Oyedeji,eng ENG,FW,21.0,0.1,0,0,0,0,0,0,0,,0,0,0,0,0,0,0,0,Matches,Arsenal,Premier-League
23,Takehiro Tomiyasu,jp JPN,DF,25.0,0.1,0,0,0,0,0,0,0,,0,0,0,0,0,0,1,0,Matches,Arsenal,Premier-League
24,Reiss Nelson,eng ENG,FW,24.0,0.0,1,0,0,1,0,0,1,0.0,1,0,0,0,0,1,1,0,Matches,Arsenal,Premier-League
25,Emiliano Martínez,ar ARG,GK,31.0,35.5,3,3,3,0,0,2,2,100.0,0,1,0,1,0,3,17,6,Matches,Aston-Villa,Premier-League
26,Morgan Rogers,eng ENG,"FW,MF",22.0,34.6,43,22,15,15,13,24,47,51.1,23,26,7,19,6,49,20,2,Matches,Aston-Villa,Premier-League
27,Youri Tielemans,be BEL,MF,27.0,33.6,84,58,32,44,8,40,73,54.8,33,38,16,22,23,107,47,4,Matches,Aston-Villa,Premier-League
28,Ezri Konsa,eng ENG,DF,26.0,32.6,34,18,20,10,4,20,25,80.0,5,20,11,9,24,58,114,4,Matches,Aston-Villa,Premier-League
29,Ollie Watkins,eng ENG,FW,28.0,28.9,10,7,0,6,4,3,11,27.3,8,11,3,8,8,18,15,2,Matches,Aston-Villa,Premier-League
30,Lucas Digne,fr FRA,DF,31.0,26.1,65,38,40,16,9,44,66,66.7,22,23,4,19,25,90,89,1,Matches,Aston-Villa,Premier-League
31,John McGinn,sct SCO,"MF,FW",29.0,24.7,33,24,10,14,9,13,31,41.9,18,22,2,20,14,47,18,3,Matches,Aston-Villa,Premier-League
32,Matty Cash,pl POL,DF,26.0,23.0,56,32,29,21,6,31,43,72.1,12,22,8,14,23,79,70,2,Matches,Aston-Villa,Premier-League
33,Pau Torres,es ESP,DF,27.0,22.4,21,15,11,8,2,10,17,58.8,7,16,11,5,10,31,75,2,Matches,Aston-Villa,Premier-League
34,Boubacar Kamara,fr FRA,MF,24.0,19.2,50,21,28,18,4,29,56,51.8,27,19,7,12,19,69,51,3,Matches,Aston-Villa,Premier-League
35,Amadou Onana,be BEL,MF,22.0,18.0,55,30,23,26,6,16,29,55.2,13,16,7,9,26,81,41,3,Matches,Aston-Villa,Premier-League
36,Jacob Ramsey,eng ENG,"FW,MF",23.0,18.0,30,15,14,10,6,10,20,50.0,10,23,4,19,8,38,8,1,Matches,Aston-Villa,Premier-League
37,Leon Bailey,jm JAM,"FW,MF",26.0,12.7,7,5,2,3,2,3,11,27.3,8,6,0,6,3,10,12,0,Matches,Aston-Villa,Premier-League
38,Tyrone Mings,eng ENG,DF,31.0,12.4,7,6,6,1,0,2,2,100.0,0,13,11,2,7,14,61,1,Matches,Aston-Villa,Premier-League
39,Ian Maatsen,nl NED,DF,22.0,12.7,29,17,17,9,3,17,24,70.8,7,13,0,13,15,44,39,3,Matches,Aston-Villa,Premier-League
40,Marco Asensio,es ESP,MF,28.0,8.3,7,5,0,7,0,3,9,33.3,6,7,1,6,2,9,3,0,Matches,Aston-Villa,Premier-League
41,Diego Carlos,br BRA,DF,31.0,9.2,8,3,6,1,1,4,6,66.7,2,13,7,6,5,13,36,2,Matches,Aston-Villa,Premier-League
42,Axel Disasi,fr FRA,DF,26.0,5.4,8,5,7,1,0,3,7,42.9,4,4,1,3,5,13,18,0,Matches,Aston-Villa,Premier-League
43,Lamare Bogarde,nl NED,"DF,MF",20.0,5.3,14,6,6,6,2,10,16,62.5,6,5,3,2,1,15,13,0,Matches,Aston-Villa,Premier-League
44,Andrés García,es ESP,"DF,MF",21.0,3.5,9,5,5,3,1,4,8,50.0,4,2,0,2,2,11,10,2,Matches,Aston-Villa,Premier-League
45,Jáder Durán,co COL,FW,20.0,7.1,8,7,1,2,5,1,4,25.0,3,5,0,5,0,8,13,0,Matches,Aston-Villa,Premier-League
46,Marcus Rashford,eng ENG,FW,26.0,4.9,10,7,2,3,5,4,6,66.7,2,2,0,2,1,11,3,0,Matches,Aston-Villa,Premier-League
47,Ross Barkley,eng ENG,MF,30.0,6.5,14,3,4,10,0,9,14,64.3,5,9,3,6,10,24,5,0,Matches,Aston-Villa,Premier-League
48,Jaden Philogene Bidace,eng ENG,"FW,MF",22.0,3.7,11,5,4,7,0,4,6,66.7,2,5,0,5,3,14,2,1,Matches,Aston-Villa,Premier-League
49,Donyell Malen,nl NED,FW,25.0,3.4,7,4,3,3,1,1,4,25.0,3,2,0,2,0,7,1,0,Matches,Aston-Villa,Premier-League
50,Robin Olsen,se SWE,GK,34.0,2.5,1,0,1,0,0,1,1,100.0,0,0,0,0,0,1,2,1,Matches,Aston-Villa,Premier-League
51,Kosta Nedeljković,rs SRB,DF,18.0,1.4,7,5,1,3,3,2,3,66.7,1,1,0,1,0,7,3,0,Matches,Aston-Villa,Premier-League
52,Emi Buendía,ar ARG,"MF,FW",27.0,1.1,6,6,3,2,1,0,5,0.0,5,5,1,4,0,6,2,0,Matches,Aston-Villa,Premier-League
53,Milos Kerkez,hu HUN,DF,20.0,37.1,52,26,25,20,7,24,38,63.2,14,38,11,27,45,97,106,4,Matches,Bournemouth,Premier-League
54,Antoine Semenyo,gh GHA,FW,24.0,35.6,55,35,17,25,13,16,43,37.2,27,67,9,58,11,66,39,2,Matches,Bournemouth,Premier-League
55,Illia Zabarnyi,ua UKR,DF,21.0,34.5,52,36,31,20,1,34,50,68.0,16,33,20,13,41,93,182,2,Matches,Bournemouth,Premier-League
56,Lewis Cook,eng ENG,"MF,DF",27.0,33.1,81,42,41,36,4,37,67,55.2,30,30,11,19,41,122,70,0,Matches,Bournemouth,Premier-League
57,Kepa Arrizabalaga,es ESP,GK,29.0,31.0,1,0,1,0,0,0,2,0.0,2,2,0,2,0,1,15,3,Matches,Bournemouth,Premier-League
58,Justin Kluivert,nl NED,MF,25.0,26.0,23,11,4,11,8,4,22,18.2,18,24,0,24,14,37,24,1,Matches,Bournemouth,Premier-League
59,Evanilson,br BRA,FW,24.0,25.8,16,10,6,5,5,8,12,66.7,4,11,2,9,1,17,21,0,Matches,Bournemouth,Premier-League
60,Ryan Christie,sct SCO,MF,29.0,23.5,54,33,19,27,8,27,64,42.2,37,44,11,33,30,84,51,3,Matches,Bournemouth,Premier-League
61,Dean Huijsen,es ESP,DF,19.0,27.0,36,26,19,16,1,18,29,62.1,11,40,29,11,51,87,198,4,Matches,Bournemouth,Premier-League
62,Dango Ouattara,bf BFA,FW,22.0,22.3,35,26,14,11,10,17,41,41.5,24,36,10,26,11,46,51,0,Matches,Bournemouth,Premier-League
63,Tyler Adams,us USA,MF,25.0,21.8,83,50,26,49,8,39,72,54.2,33,33,10,23,32,115,42,0,Matches,Bournemouth,Premier-League
64,Marcus Tavernier,eng ENG,"FW,MF",25.0,21.5,43,24,15,19,9,10,27,37.0,17,16,3,13,5,48,11,0,Matches,Bournemouth,Premier-League
65,Adam Smith,eng ENG,DF,33.0,17.7,24,12,11,7,6,14,27,51.9,13,13,5,8,15,39,49,1,Matches,Bournemouth,Premier-League
66,Marcos Senesi,ar ARG,DF,27.0,12.3,39,21,23,14,2,14,31,45.2,17,16,7,9,14,53,58,0,Matches,Bournemouth,Premier-League
67,David Brooks,wls WAL,"FW,MF",27.0,10.7,14,6,2,8,4,2,16,12.5,14,18,2,16,5,19,9,1,Matches,Bournemouth,Premier-League
68,Alex Scott,eng ENG,MF,20.0,8.4,27,14,11,8,8,19,42,45.2,23,17,4,13,10,37,15,0,Matches,Bournemouth,Premier-League
69,Julian Araujo,mx MEX,DF,22.0,5.5,10,5,4,6,0,5,12,41.7,7,3,0,3,6,16,18,0,Matches,Bournemouth,Premier-League
70,James Hill,eng ENG,DF,22.0,5.0,15,8,6,6,3,3,11,27.3,8,5,0,5,9,24,31,0,Matches,Bournemouth,Premier-League
71,Mark Travers,ie IRL,GK,25.0,5.0,0,0,0,0,0,0,0,,0,0,0,0,0,0,5,0,Matches,Bournemouth,Premier-League
72,Enes Ünal,tr TUR,"FW,MF",27.0,3.8,1,0,0,0,1,0,3,0.0,3,1,0,1,0,1,6,0,Matches,Bournemouth,Premier-League
73,Neto,br BRA,GK,35.0,2.0,0,0,0,0,0,0,0,,0,0,0,0,0,0,1,1,Matches,Bournemouth,Premier-League
74,Luis Sinisterra,co COL,"FW,MF",25.0,2.6,7,2,3,2,2,0,4,0.0,4,3,0,3,1,8,8,0,Matches,Bournemouth,Premier-League
75,Philip Billing,dk DEN,MF,28.0,2.0,14,5,7,6,1,3,4,75.0,1,3,0,3,5,19,2,0,Matches,Bournemouth,Premier-League
76,Max Aarons,eng ENG,DF,24.0,1.0,2,2,1,1,0,1,1,100.0,0,3,1,2,1,3,0,0,Matches,Bournemouth,Premier-League
77,Daniel Jebbison,ca CAN,FW,20.0,1.3,5,3,3,2,0,4,6,66.7,2,2,1,1,1,6,1,0,Matches,Bournemouth,Premier-League
78,Ben Winterburn,eng ENG,"MF,FW",19.0,0.3,0,0,0,0,0,0,1,0.0,1,0,0,0,2,2,0,0,Matches,Bournemouth,Premier-League
79,Julio Soler,ar ARG,"DF,FW",19.0,0.1,1,1,1,0,0,1,1,100.0,0,1,0,1,0,1,0,0,Matches,Bournemouth,Premier-League
80,Remy Rees-Dottin,eng ENG,FW,18.0,0.0,0,0,0,0,0,0,0,,0,0,0,0,0,0,0,0,Matches,Bournemouth,Premier-League
81,Zain Silcott-Duberry,ms MSR,FW,19.0,0.0,1,1,0,0,1,1,1,100.0,0,0,0,0,0,1,0,0,Matches,Bournemouth,Premier-League
82,Nathan Collins,ie IRL,DF,23.0,38.0,40,24,23,12,5,22,36,61.1,14,77,57,20,34,74,226,3,Matches,Brentford,Premier-League
83,Bryan Mbeumo,cm CMR,FW,24.0,37.9,49,31,18,15,16,21,35,60.0,14,26,3,23,14,63,55,1,Matches,Brentford,Premier-League
84,Mark Flekken,nl NED,GK,31.0,36.4,4,4,4,0,0,3,9,33.3,6,2,0,2,0,4,26,4,Matches,Brentford,Premier-League
85,Keane Lewis-Potter,eng ENG,"DF,FW",23.0,34.4,49,27,26,16,7,31,50,62.0,19,28,10,18,21,70,76,3,Matches,Brentford,Premier-League
86,Yoane Wissa,cd COD,FW,27.0,32.4,22,12,6,8,8,11,27,40.7,16,29,8,21,8,30,21,3,Matches,Brentford,Premier-League
87,Mikkel Damsgaard,dk DEN,"MF,FW",24.0,32.3,83,44,27,29,27,31,81,38.3,50,40,3,37,27,110,31,2,Matches,Brentford,Premier-League
88,Christian Nørgaard,dk DEN,MF,30.0,31.3,79,49,37,35,7,48,81,59.3,33,52,20,32,49,128,70,1,Matches,Brentford,Premier-League
89,Sepp van den Berg,nl NED,DF,22.0,28.7,39,24,25,10,4,19,29,65.5,10,52,38,14,21,60,134,3,Matches,Brentford,Premier-League
90,Vitaly Janelt,de GER,MF,26.0,25.0,38,22,14,13,11,21,36,58.3,15,33,9,24,27,65,53,1,Matches,Brentford,Premier-League
91,Kevin Schade,de GER,FW,22.0,25.5,39,25,17,10,12,13,23,56.5,10,19,4,15,5,44,34,0,Matches,Brentford,Premier-League
92,Ethan Pinnock,jm JAM,DF,31.0,21.3,35,19,15,16,4,13,24,54.2,11,29,18,11,24,59,142,4,Matches,Brentford,Premier-League
93,Kristoffer Ajer,no NOR,DF,26.0,16.0,26,18,14,11,1,14,27,51.9,13,17,4,13,12,38,50,0,Matches,Brentford,Premier-League
94,Yehor Yarmoliuk,ua UKR,MF,20.0,16.1,49,28,21,21,7,28,55,50.9,27,26,9,17,13,62,33,0,Matches,Brentford,Premier-League
95,Mads Roerslev,dk DEN,DF,25.0,12.2,18,8,14,3,1,11,28,39.3,17,12,5,7,4,22,35,0,Matches,Brentford,Premier-League
96,Mathias Jensen,dk DEN,MF,28.0,9.6,14,10,6,6,2,8,16,50.0,8,15,4,11,8,22,13,2,Matches,Brentford,Premier-League
97,Michael Kayode,it ITA,DF,20.0,5.9,17,11,12,5,0,9,13,69.2,4,3,0,3,7,24,19,0,Matches,Brentford,Premier-League
98,Fabio Carvalho,pt POR,"FW,MF",21.0,5.1,13,9,4,4,5,6,13,46.2,7,6,1,5,3,16,2,0,Matches,Brentford,Premier-League
99,Ben Mee,eng ENG,DF,34.0,2.0,2,2,0,2,0,1,1,100.0,0,3,3,0,4,6,7,0,Matches,Brentford,Premier-League
100,Thiago,br BRA,"FW,MF",23.0,1.9,5,3,2,1,2,0,1,0.0,1,3,0,3,2,7,3,1,Matches,Brentford,Premier-League
101,Hákon Rafn Valdimarsson,is ISL,GK,22.0,1.6,0,0,0,0,0,0,0,,0,0,0,0,0,0,2,0,Matches,Brentford,Premier-League
102,Edmond-Paris Maghoma,eng ENG,"MF,FW",23.0,1.3,2,1,0,2,0,1,3,33.3,2,2,2,0,1,3,2,0,Matches,Brentford,Premier-League
103,Rico Henry,eng ENG,DF,27.0,1.1,2,2,1,0,1,0,4,0.0,4,4,1,3,1,3,2,0,Matches,Brentford,Premier-League
104,Yunus Emre Konak,tr TUR,"FW,MF",18.0,0.5,4,4,0,4,0,1,2,50.0,1,2,0,2,0,4,0,0,Matches,Brentford,Premier-League
105,Kim Jisoo,kr KOR,DF,19.0,0.3,0,0,0,0,0,0,0,,0,0,0,0,0,0,2,0,Matches,Brentford,Premier-League
106,Frank Onyeka,ng NGA,MF,26.0,0.3,0,0,0,0,0,0,0,,0,0,0,0,0,0,0,0,Matches,Brentford,Premier-League
107,Gustavo Nunes,br BRA,"FW,MF",18.0,0.1,3,2,2,0,1,2,2,100.0,0,0,0,0,0,3,2,0,Matches,Brentford,Premier-League
108,Jayden Meghoma,eng ENG,DF,18.0,0.1,0,0,0,0,0,0,0,,0,0,0,0,0,0,0,0,Matches,Brentford,Premier-League
109,Ryan Trevitt,eng ENG,MF,21.0,0.0,1,1,1,0,0,0,0,,0,0,0,0,0,1,0,0,Matches,Brentford,Premier-League
110,Bart Verbruggen,nl NED,GK,21.0,36.0,0,0,0,0,0,0,3,0.0,3,1,0,1,0,0,29,5,Matches,Brighton-and-Hove-Albion,Premier-League
111,Jan Paul van Hecke,nl NED,DF,24.0,32.9,45,29,24,19,2,23,41,56.1,18,37,22,15,24,69,142,2,Matches,Brighton-and-Hove-Albion,Premier-League
112,Carlos Baleba,cm CMR,MF,20.0,29.6,79,46,26,37,16,48,80,60.0,32,47,11,36,46,125,44,1,Matches,Brighton-and-Hove-Albion,Premier-League
113,Kaoru Mitoma,jp JPN,"FW,MF",27.0,28.9,45,27,15,14,16,19,49,38.8,30,48,3,45,14,59,10,0,Matches,Brighton-and-Hove-Albion,Premier-League
114,Pervis Estupiñán,ec ECU,DF,26.0,26.7,65,43,33,25,7,34,51,66.7,17,20,5,15,37,102,65,2,Matches,Brighton-and-Hove-Albion,Premier-League
115,Danny Welbeck,eng ENG,FW,33.0,23.5,26,16,6,15,5,8,20,40.0,12,19,4,15,5,31,14,0,Matches,Brighton-and-Hove-Albion,Premier-League
116,Lewis Dunk,eng ENG,DF,32.0,23.1,17,10,8,7,2,11,19,57.9,8,28,18,10,13,30,79,2,Matches,Brighton-and-Hove-Albion,Premier-League
117,João Pedro,br BRA,"FW,MF",22.0,21.6,16,12,6,6,4,4,11,36.4,7,12,0,12,9,25,12,0,Matches,Brighton-and-Hove-Albion,Premier-League
118,Yasin Ayari,se SWE,MF,20.0,21.8,59,32,15,31,13,26,56,46.4,30,24,6,18,20,79,26,0,Matches,Brighton-and-Hove-Albion,Premier-League
119,Jack Hinshelwood,eng ENG,"MF,DF",19.0,20.5,27,19,8,10,9,11,27,40.7,16,10,3,7,16,43,37,1,Matches,Brighton-and-Hove-Albion,Premier-League
120,Yankuba Minteh,gm GAM,"FW,MF",20.0,20.4,48,35,25,13,10,17,45,37.8,28,22,0,22,11,59,31,0,Matches,Brighton-and-Hove-Albion,Premier-League
121,Joël Veltman,nl NED,DF,32.0,18.9,43,29,24,16,3,31,52,59.6,21,22,7,15,19,62,66,0,Matches,Brighton-and-Hove-Albion,Premier-League
122,Georginio Rutter,fr FRA,"MF,FW",22.0,18.4,39,15,13,18,8,14,36,38.9,22,20,3,17,10,49,13,2,Matches,Brighton-and-Hove-Albion,Premier-League
123,Simon Adingra,ci CIV,"FW,MF",22.0,12.2,23,14,10,8,5,10,26,38.5,16,12,0,12,8,31,6,2,Matches,Brighton-and-Hove-Albion,Premier-League
124,Matt O'Riley,dk DEN,MF,23.0,10.4,16,9,4,8,4,4,13,30.8,9,7,3,4,13,29,9,1,Matches,Brighton-and-Hove-Albion,Premier-League
125,Adam Webster,eng ENG,DF,29.0,9.9,10,6,5,4,1,6,14,42.9,8,16,9,7,20,30,41,2,Matches,Brighton-and-Hove-Albion,Premier-League
126,Mats Wieffer,nl NED,"DF,MF",24.0,11.3,58,34,27,27,4,32,47,68.1,15,18,2,16,17,75,28,3,Matches,Brighton-and-Hove-Albion,Premier-League
127,Igor,br BRA,DF,26.0,10.7,5,5,2,2,1,4,10,40.0,6,24,14,10,4,9,39,1,Matches,Brighton-and-Hove-Albion,Premier-League
128,Tariq Lamptey,gh GHA,DF,23.0,9.6,17,11,8,9,0,9,25,36.0,16,15,7,8,7,24,23,1,Matches,Brighton-and-Hove-Albion,Premier-League
129,Brajan Gruda,de GER,"MF,FW",20.0,7.6,16,8,6,6,4,7,14,50.0,7,8,0,8,2,18,5,1,Matches,Brighton-and-Hove-Albion,Premier-League
130,Ferdi Kadioglu,tr TUR,"DF,MF",24.0,4.3,10,6,4,5,1,6,15,40.0,9,2,2,0,8,18,17,0,Matches,Brighton-and-Hove-Albion,Premier-League
131,Diego Gómez,py PAR,MF,21.0,5.7,21,13,11,8,2,12,22,54.5,10,13,0,13,8,29,10,1,Matches,Brighton-and-Hove-Albion,Premier-League
132,James Milner,eng ENG,MF,38.0,1.9,5,2,1,3,1,3,3,100.0,0,4,2,2,2,7,2,1,Matches,Brighton-and-Hove-Albion,Premier-League
133,Julio Enciso,py PAR,"MF,FW",20.0,3.3,0,0,0,0,0,0,2,0.0,2,2,0,2,0,0,1,0,Matches,Brighton-and-Hove-Albion,Premier-League
134,Evan Ferguson,ie IRL,FW,19.0,2.7,4,3,0,3,1,2,5,40.0,3,3,1,2,0,4,4,0,Matches,Brighton-and-Hove-Albion,Premier-League
135,Jason Steele,eng ENG,GK,33.0,2.0,0,0,0,0,0,0,0,,0,0,0,0,0,0,1,0,Matches,Brighton-and-Hove-Albion,Premier-League
136,Solly March,eng ENG,"FW,MF",30.0,1.9,6,3,2,2,2,5,8,62.5,3,3,0,3,2,8,2,1,Matches,Brighton-and-Hove-Albion,Premier-League
137,Billy Gilmour,sct SCO,MF,23.0,1.1,3,3,2,1,0,3,4,75.0,1,1,0,1,0,3,1,0,Matches,Brighton-and-Hove-Albion,Premier-League
138,Eiran Cashin,ie IRL,DF,22.0,0.2,0,0,0,0,0,0,1,0.0,1,0,0,0,0,0,2,0,Matches,Brighton-and-Hove-Albion,Premier-League
139,Jakub Moder,pl POL,MF,25.0,0.1,1,0,1,0,0,0,2,0.0,2,0,0,0,0,1,3,0,Matches,Brighton-and-Hove-Albion,Premier-League
140,Jeremy Sarmiento,ec ECU,MF,22.0,0.1,0,0,0,0,0,0,0,,0,0,0,0,0,0,0,0,Matches,Brighton-and-Hove-Albion,Premier-League
141,Harry Howell,eng ENG,FW,15.0,0.1,1,1,1,0,0,1,2,50.0,1,1,0,1,0,1,0,0,Matches,Brighton-and-Hove-Albion,Premier-League
142,Moisés Caicedo,ec ECU,"MF,DF",22.0,37.2,114,73,44,54,16,54,86,62.8,32,49,10,39,49,163,60,1,Matches,Chelsea,Premier-League
143,Cole Palmer,eng ENG,"MF,FW",22.0,35.5,34,20,12,10,12,12,27,44.4,15,16,1,15,11,45,20,1,Matches,Chelsea,Premier-League
144,Levi Colwill,eng ENG,DF,21.0,35.0,47,34,25,19,3,18,27,66.7,9,37,25,12,33,80,118,4,Matches,Chelsea,Premier-League
145,Marc Cucurella,es ESP,DF,26.0,33.2,67,45,31,31,5,32,61,52.5,29,49,16,33,28,95,95,3,Matches,Chelsea,Premier-League
146,Enzo Fernández,ar ARG,MF,23.0,32.7,65,33,17,30,18,31,84,36.9,53,43,7,36,13,78,23,4,Matches,Chelsea,Premier-League
147,Robert Sánchez,es ESP,GK,26.0,32.0,0,0,0,0,0,0,1,0.0,1,0,0,0,2,2,24,10,Matches,Chelsea,Premier-League
148,Nicolas Jackson,sn SEN,FW,23.0,24.7,22,13,6,7,9,5,10,50.0,5,15,2,13,3,25,15,0,Matches,Chelsea,Premier-League
149,Noni Madueke,eng ENG,FW,22.0,22.6,25,18,8,12,5,14,38,36.8,24,17,0,17,10,35,11,0,Matches,Chelsea,Premier-League
150,Pedro Neto,pt POR,FW,24.0,25.2,23,9,9,9,5,9,21,42.9,12,14,2,12,9,32,6,0,Matches,Chelsea,Premier-League
151,Malo Gusto,fr FRA,DF,21.0,20.7,45,29,27,15,3,25,48,52.1,23,29,8,21,24,69,49,5,Matches,Chelsea,Premier-League
152,Jadon Sancho,eng ENG,FW,24.0,19.6,13,7,3,3,7,5,12,41.7,7,11,0,11,2,15,8,2,Matches,Chelsea,Premier-League
153,Tosin Adarabioyo,eng ENG,DF,26.0,15.7,17,13,11,6,0,8,12,66.7,4,9,7,2,11,28,80,0,Matches,Chelsea,Premier-League
154,Wesley Fofana,fr FRA,DF,23.0,13.0,13,12,6,7,0,6,14,42.9,8,14,9,5,14,27,55,2,Matches,Chelsea,Premier-League
155,Reece James,eng ENG,"DF,MF",24.0,11.8,10,9,6,3,1,3,9,33.3,6,14,6,8,13,23,23,4,Matches,Chelsea,Premier-League
156,Trevoh Chalobah,eng ENG,DF,25.0,10.1,11,7,5,6,0,7,8,87.5,1,6,3,3,10,21,48,1,Matches,Chelsea,Premier-League
157,Roméo Lavia,be BEL,MF,20.0,8.9,22,13,5,13,4,10,21,47.6,11,6,0,6,16,38,10,1,Matches,Chelsea,Premier-League
158,Christopher Nkunku,fr FRA,FW,26.0,10.2,12,8,3,4,5,6,8,75.0,2,9,2,7,7,19,10,0,Matches,Chelsea,Premier-League
159,Filip Jørgensen,dk DEN,GK,22.0,6.0,0,0,0,0,0,0,0,,0,0,0,0,0,0,0,3,Matches,Chelsea,Premier-League
160,Axel Disasi,fr FRA,DF,26.0,4.0,7,4,5,1,1,6,11,54.5,5,4,1,3,2,9,11,1,Matches,Chelsea,Premier-League
161,João Félix,pt POR,"FW,MF",24.0,4.1,8,3,2,5,1,5,9,55.6,4,2,0,2,3,11,2,0,Matches,Chelsea,Premier-League
162,Benoît Badiashile,fr FRA,DF,23.0,3.7,9,6,5,4,0,4,5,80.0,1,2,2,0,6,15,12,2,Matches,Chelsea,Premier-League
163,Kiernan Dewsbury-Hall,eng ENG,"MF,FW",25.0,2.9,8,5,1,1,6,4,6,66.7,2,2,0,2,2,10,9,1,Matches,Chelsea,Premier-League
164,Joshua Acheampong,eng ENG,DF,18.0,1.9,2,1,2,0,0,2,2,100.0,0,1,0,1,1,3,2,0,Matches,Chelsea,Premier-League
165,Tyrique George,eng ENG,FW,18.0,2.0,2,0,2,0,0,2,3,66.7,1,1,0,1,2,4,1,0,Matches,Chelsea,Premier-League
166,Renato Veiga,pt POR,"DF,MF",21.0,2.0,9,6,6,3,0,4,12,33.3,8,3,1,2,1,10,2,0,Matches,Chelsea,Premier-League
167,Mykhailo Mudryk,ua UKR,FW,23.0,1.7,2,2,2,0,0,0,0,,0,3,1,2,0,2,1,0,Matches,Chelsea,Premier-League
168,Marc Guiu,es ESP,FW,18.0,0.8,1,1,0,1,0,1,1,100.0,0,0,0,0,0,1,0,0,Matches,Chelsea,Premier-League
169,Mathis Amougou,fr FRA,MF,18.0,0.1,0,0,0,0,0,0,0,,0,0,0,0,0,0,0,0,Matches,Chelsea,Premier-League
170,Shumaira Mheuka,eng ENG,MF,16.0,0.0,0,0,0,0,0,0,0,,0,0,0,0,0,0,0,0,Matches,Chelsea,Premier-League
171,Dean Henderson,eng ENG,GK,27.0,38.0,2,1,2,0,0,2,6,33.3,4,0,0,0,0,2,22,0,Matches,Crystal-Palace,Premier-League
172,Daniel Muñoz,co COL,DF,28.0,35.9,123,80,57,41,25,55,97,56.7,42,40,6,34,44,167,108,1,Matches,Crystal-Palace,Premier-League
173,Tyrick Mitchell,eng ENG,DF,24.0,34.4,91,55,57,27,7,25,46,54.3,21,68,12,56,19,110,108,2,Matches,Crystal-Palace,Premier-League
174,Maxence Lacroix,fr FRA,DF,24.0,34.6,68,41,52,15,1,32,47,68.1,15,48,22,26,54,122,207,2,Matches,Crystal-Palace,Premier-League
175,Marc Guéhi,eng ENG,DF,24.0,34.0,61,34,36,23,2,31,47,66.0,16,55,23,32,28,89,163,2,Matches,Crystal-Palace,Premier-League
176,Jean-Philippe Mateta,fr FRA,FW,27.0,29.4,18,12,5,11,2,3,16,18.8,13,19,4,15,2,20,23,0,Matches,Crystal-Palace,Premier-League
177,Eberechi Eze,eng ENG,"MF,FW",26.0,28.8,39,22,14,16,9,17,36,47.2,19,27,0,27,11,50,10,3,Matches,Crystal-Palace,Premier-League
178,Ismaila Sarr,sn SEN,MF,26.0,30.1,22,10,10,9,3,8,25,32.0,17,27,8,19,9,31,40,0,Matches,Crystal-Palace,Premier-League
179,Jefferson Lerma,co COL,"MF,DF",29.0,25.3,35,17,15,16,4,19,36,52.8,17,38,18,20,42,77,80,1,Matches,Crystal-Palace,Premier-League
180,Will Hughes,eng ENG,MF,29.0,23.4,66,36,20,33,13,28,62,45.2,34,31,14,17,22,88,28,3,Matches,Crystal-Palace,Premier-League
181,Chris Richards,us USA,DF,24.0,21.4,47,30,24,17,6,24,41,58.5,17,40,14,26,19,66,121,0,Matches,Crystal-Palace,Premier-League
182,Adam Wharton,eng ENG,MF,20.0,14.6,34,14,14,16,4,17,44,38.6,27,11,2,9,20,54,27,0,Matches,Crystal-Palace,Premier-League
183,Daichi Kamada,jp JPN,MF,27.0,17.4,47,29,19,24,4,14,41,34.1,27,22,5,17,18,65,14,0,Matches,Crystal-Palace,Premier-League
184,Trevoh Chalobah,eng ENG,DF,25.0,11.8,20,16,7,12,1,12,23,52.2,11,19,9,10,19,39,57,3,Matches,Crystal-Palace,Premier-League
185,Eddie Nketiah,eng ENG,"FW,MF",25.0,11.5,15,8,7,4,4,7,13,53.8,6,10,1,9,3,18,12,0,Matches,Crystal-Palace,Premier-League
186,Nathaniel Clyne,eng ENG,"DF,MF",33.0,5.4,12,8,8,3,1,6,11,54.5,5,4,2,2,3,15,14,1,Matches,Crystal-Palace,Premier-League
187,Justin Devenny,nir NIR,MF,20.0,5.6,17,12,7,9,1,8,19,42.1,11,6,1,5,0,17,11,0,Matches,Crystal-Palace,Premier-League
188,Cheick Doucouré,ml MLI,MF,24.0,5.0,16,8,6,8,2,5,11,45.5,6,4,0,4,11,27,10,1,Matches,Crystal-Palace,Premier-League
189,Ben Chilwell,eng ENG,DF,27.0,2.9,7,6,4,3,0,1,5,20.0,4,6,2,4,6,13,16,0,Matches,Crystal-Palace,Premier-League
190,Romain Esse,eng ENG,MF,19.0,1.5,9,6,4,3,2,5,5,100.0,0,2,0,2,1,10,2,0,Matches,Crystal-Palace,Premier-League
191,Odsonne Édouard,fr FRA,"MF,FW",26.0,1.3,1,0,0,1,0,0,2,0.0,2,1,0,1,0,1,1,0,Matches,Crystal-Palace,Premier-League
192,Joachim Andersen,dk DEN,DF,28.0,1.0,1,1,1,0,0,1,2,50.0,1,0,0,0,0,1,7,0,Matches,Crystal-Palace,Premier-League
193,Chadi Riad,ma MAR,DF,21.0,1.0,5,2,2,2,1,2,3,66.7,1,0,0,0,2,7,0,0,Matches,Crystal-Palace,Premier-League
194,Joel Ward,eng ENG,DF,34.0,0.8,2,0,0,2,0,0,0,,0,0,0,0,0,2,3,0,Matches,Crystal-Palace,Premier-League
195,Jeffrey Schlupp,gh GHA,"MF,DF",31.0,1.1,2,0,1,0,1,0,3,0.0,3,6,0,6,0,2,2,0,Matches,Crystal-Palace,Premier-League
196,Matheus França,br BRA,"MF,FW",20.0,0.6,2,0,0,2,0,0,0,,0,1,1,0,1,3,1,0,Matches,Crystal-Palace,Premier-League
197,Jordan Ayew,gh GHA,"FW,MF",32.0,0.2,1,0,0,0,1,0,0,,0,0,0,0,0,1,0,0,Matches,Crystal-Palace,Premier-League
198,Caleb Kporha,eng ENG,DF,18.0,0.1,2,1,2,0,0,2,2,100.0,0,0,0,0,0,2,1,0,Matches,Crystal-Palace,Premier-League
199,Asher Agbinone,eng ENG,MF,18.0,0.1,2,1,0,2,0,0,0,,0,0,0,0,0,2,0,0,Matches,Crystal-Palace,Premier-League
200,Jordan Pickford,eng ENG,GK,30.0,38.0,1,0,1,0,0,1,2,50.0,1,0,0,0,1,2,30,2,Matches,Everton,Premier-League
201,Vitaliy Mykolenko,ua UKR,DF,25.0,34.2,63,38,39,14,10,29,56,51.8,27,25,10,15,44,107,145,2,Matches,Everton,Premier-League
202,Idrissa Gana Gueye,sn SEN,MF,34.0,34.0,133,80,61,55,17,58,99,58.6,41,48,9,39,48,181,36,1,Matches,Everton,Premier-League
203,James Tarkowski,eng ENG,DF,31.0,32.5,64,40,39,22,3,24,39,61.5,15,57,42,15,41,105,213,4,Matches,Everton,Premier-League
204,Abdoulaye Doucouré,ml MLI,MF,31.0,28.5,48,28,21,20,7,14,43,32.6,29,31,6,25,10,58,20,1,Matches,Everton,Premier-League
205,Iliman Ndiaye,sn SEN,FW,24.0,27.0,53,28,20,16,17,22,49,44.9,27,30,5,25,20,73,24,1,Matches,Everton,Premier-League
206,Jarrad Branthwaite,eng ENG,DF,22.0,27.9,36,20,26,10,0,20,28,71.4,8,31,23,8,27,63,191,4,Matches,Everton,Premier-League
207,Jack Harrison,eng ENG,FW,27.0,23.1,32,22,12,12,8,15,46,32.6,31,18,2,16,10,42,35,2,Matches,Everton,Premier-League
208,Ashley Young,eng ENG,DF,39.0,20.8,58,33,25,25,8,35,57,61.4,22,14,4,10,25,83,64,2,Matches,Everton,Premier-League
209,Dominic Calvert-Lewin,eng ENG,FW,27.0,17.9,9,7,1,4,4,2,6,33.3,4,7,2,5,7,16,23,0,Matches,Everton,Premier-League
210,James Garner,eng ENG,"MF,DF",23.0,17.7,47,31,25,20,2,24,41,58.5,17,20,4,16,23,70,37,0,Matches,Everton,Premier-League
211,Jake O'Brien,ie IRL,DF,23.0,17.5,26,17,21,5,0,17,25,68.0,8,17,4,13,4,30,93,0,Matches,Everton,Premier-League
212,Beto,gw GNB,FW,26.0,17.0,14,6,2,8,4,5,8,62.5,3,12,2,10,4,18,24,1,Matches,Everton,Premier-League
213,Dwight McNeil,eng ENG,"MF,FW",24.0,15.2,13,8,6,5,2,9,21,42.9,12,7,0,7,6,19,2,1,Matches,Everton,Premier-League
214,Jesper Lindstrøm,dk DEN,FW,24.0,13.8,45,25,24,19,2,19,55,34.5,36,15,3,12,12,57,17,0,Matches,Everton,Premier-League
215,Orel Mangala,be BEL,MF,26.0,14.0,16,8,3,11,2,5,8,62.5,3,8,3,5,21,37,24,1,Matches,Everton,Premier-League
216,Michael Keane,eng ENG,DF,31.0,11.7,12,9,8,2,2,8,15,53.3,7,14,10,4,16,28,65,2,Matches,Everton,Premier-League
217,Carlos Alcaraz,ar ARG,"FW,MF",21.0,8.5,11,5,5,3,3,3,11,27.3,8,9,2,7,5,16,10,0,Matches,Everton,Premier-League
218,Tim Iroegbunam,eng ENG,MF,21.0,6.4,29,14,14,10,5,14,23,60.9,9,18,4,14,16,45,12,1,Matches,Everton,Premier-League
219,Armando Broja,al ALB,FW,22.0,3.7,3,1,1,1,1,0,0,,0,3,0,3,1,4,4,0,Matches,Everton,Premier-League
220,Nathan Patterson,sct SCO,DF,22.0,3.9,11,6,7,4,0,7,14,50.0,7,2,0,2,2,13,7,0,Matches,Everton,Premier-League
221,Séamus Coleman,ie IRL,DF,35.0,2.4,3,2,2,1,0,3,4,75.0,1,5,3,2,1,4,8,0,Matches,Everton,Premier-League
222,Roman Dixon,eng ENG,DF,19.0,1.0,5,5,3,2,0,4,4,100.0,0,1,0,1,1,6,3,0,Matches,Everton,Premier-League
223,Harrison Armstrong,eng ENG,MF,17.0,0.5,0,0,0,0,0,0,1,0.0,1,0,0,0,0,0,1,0,Matches,Everton,Premier-League
224,Youssef Chermiti,pt POR,"FW,MF",20.0,0.5,0,0,0,0,0,0,1,0.0,1,0,0,0,0,0,0,0,Matches,Everton,Premier-League
225,Mason Holgate,jm JAM,"FW,DF",27.0,0.1,0,0,0,0,0,0,0,,0,0,0,0,0,0,0,0,Matches,Everton,Premier-League
226,Bernd Leno,de GER,GK,32.0,38.0,2,2,2,0,0,2,2,100.0,0,1,0,1,0,2,11,5,Matches,Fulham,Premier-League
227,Antonee Robinson,us USA,DF,26.0,35.2,95,61,57,31,7,45,95,47.4,50,43,9,34,62,157,133,2,Matches,Fulham,Premier-League
228,Alex Iwobi,ng NGA,"FW,MF",28.0,33.1,44,25,14,21,9,22,34,64.7,12,26,1,25,14,58,29,1,Matches,Fulham,Premier-League
229,Calvin Bassey,ng NGA,DF,24.0,34.2,54,34,35,19,0,22,31,71.0,9,40,17,23,20,74,118,8,Matches,Fulham,Premier-League
230,Raúl Jiménez,mx MEX,FW,33.0,27.7,35,24,9,17,9,8,22,36.4,14,21,5,16,10,45,23,3,Matches,Fulham,Premier-League
231,Joachim Andersen,dk DEN,DF,28.0,28.7,27,18,20,6,1,15,24,62.5,9,37,28,9,34,61,188,1,Matches,Fulham,Premier-League
232,Saša Lukić,rs SRB,MF,27.0,26.0,68,39,22,40,6,23,55,41.8,32,20,7,13,28,96,35,1,Matches,Fulham,Premier-League
233,Sander Berge,no NOR,MF,26.0,24.7,50,30,23,23,4,27,39,69.2,12,27,8,19,21,71,38,1,Matches,Fulham,Premier-League
234,Emile Smith Rowe,eng ENG,MF,24.0,22.7,31,18,7,14,10,8,24,33.3,16,22,2,20,11,42,16,0,Matches,Fulham,Premier-League
235,Andreas Pereira,br BRA,MF,28.0,22.4,24,13,8,11,5,10,42,23.8,32,17,2,15,8,32,17,3,Matches,Fulham,Premier-League
236,Kenny Tete,nl NED,DF,28.0,19.7,56,38,29,14,13,23,38,60.5,15,31,12,19,32,88,67,0,Matches,Fulham,Premier-League
237,Adama Traoré,es ESP,"FW,MF",28.0,19.7,20,13,9,6,5,5,13,38.5,8,7,0,7,1,21,6,4,Matches,Fulham,Premier-League
238,Timothy Castagne,be BEL,DF,28.0,18.3,46,29,28,15,3,26,45,57.8,19,15,6,9,22,68,83,0,Matches,Fulham,Premier-League
239,Issa Diop,fr FRA,DF,27.0,14.9,26,12,18,8,0,13,18,72.2,5,10,7,3,9,35,72,2,Matches,Fulham,Premier-League
240,Harry Wilson,wls WAL,"FW,MF",27.0,12.9,20,14,13,3,4,12,18,66.7,6,15,1,14,7,27,10,1,Matches,Fulham,Premier-League
241,Rodrigo Muniz,br BRA,FW,23.0,10.7,10,5,3,5,2,4,4,100.0,0,9,2,7,5,15,14,0,Matches,Fulham,Premier-League
242,Ryan Sessegnon,eng ENG,"FW,DF",24.0,6.4,27,13,11,11,5,9,20,45.0,11,13,1,12,3,30,18,0,Matches,Fulham,Premier-League
243,Reiss Nelson,eng ENG,FW,24.0,5.4,8,6,3,3,2,5,13,38.5,8,11,0,11,5,13,2,0,Matches,Fulham,Premier-League
244,Jorge Cuenca,es ESP,DF,24.0,3.9,6,2,5,1,0,3,8,37.5,5,4,4,0,2,8,26,0,Matches,Fulham,Premier-League
245,Tom Cairney,sct SCO,MF,33.0,7.0,13,5,5,2,6,4,7,57.1,3,7,1,6,4,17,3,1,Matches,Fulham,Premier-League
246,Willian,br BRA,"FW,MF",35.0,2.9,4,2,0,3,1,2,6,33.3,4,0,0,0,1,5,1,0,Matches,Fulham,Premier-League
247,Joshua King,eng ENG,MF,17.0,1.4,7,5,3,4,0,0,3,0.0,3,3,0,3,1,8,1,0,Matches,Fulham,Premier-League
248,Harrison Reed,eng ENG,MF,29.0,1.2,6,3,3,2,1,1,3,33.3,2,1,0,1,1,7,3,0,Matches,Fulham,Premier-League
249,Martial Godo,eng ENG,"FW,DF",21.0,0.3,0,0,0,0,0,0,0,,0,1,0,1,1,1,0,0,Matches,Fulham,Premier-League
250,Carlos Vinícius,br BRA,"MF,FW",29.0,0.2,0,0,0,0,0,0,1,0.0,1,1,0,1,0,0,0,0,Matches,Fulham,Premier-League
251,Jay Stansfield,eng ENG,MF,21.0,0.0,0,0,0,0,0,0,0,,0,0,0,0,0,0,0,0,Matches,Fulham,Premier-League
252,Dara O'Shea,ie IRL,DF,25.0,34.7,49,31,33,13,3,22,34,64.7,12,62,50,12,33,82,225,4,Matches,Ipswich-Town,Premier-League
253,Leif Davis,eng ENG,DF,24.0,30.5,46,27,33,9,4,30,48,62.5,18,25,8,17,25,71,77,3,Matches,Ipswich-Town,Premier-League
254,Liam Delap,eng ENG,FW,21.0,28.8,11,8,3,3,5,2,15,13.3,13,8,0,8,2,13,28,0,Matches,Ipswich-Town,Premier-League
255,Sam Morsy,eg EGY,MF,32.0,30.6,68,41,40,24,4,27,62,43.5,35,34,13,21,29,97,47,5,Matches,Ipswich-Town,Premier-League
256,Omari Hutchinson,eng ENG,"MF,FW",20.0,28.7,32,13,14,10,8,13,48,27.1,35,27,2,25,11,43,15,1,Matches,Ipswich-Town,Premier-League
257,Jacob Greaves,eng ENG,DF,23.0,24.5,40,21,20,17,3,22,35,62.9,13,41,26,15,21,61,148,3,Matches,Ipswich-Town,Premier-League
258,Jens Cajuste,se SWE,MF,24.0,21.8,44,22,19,23,2,21,49,42.9,28,25,10,15,28,72,33,2,Matches,Ipswich-Town,Premier-League
259,Axel Tuanzebe,cd COD,DF,26.0,19.0,31,19,21,4,6,17,26,65.4,9,21,10,11,23,54,56,1,Matches,Ipswich-Town,Premier-League
260,Arijanet Muric,xk KVX,GK,25.0,18.0,0,0,0,0,0,0,2,0.0,2,0,0,0,0,0,10,5,Matches,Ipswich-Town,Premier-League
261,Cameron Burgess,au AUS,DF,28.0,17.1,17,12,14,3,0,9,11,81.8,2,20,15,5,14,31,128,3,Matches,Ipswich-Town,Premier-League
262,Ben Johnson,eng ENG,"DF,FW",24.0,15.0,38,22,23,12,3,20,41,48.8,21,22,5,17,13,51,54,1,Matches,Ipswich-Town,Premier-League
263,Kalvin Phillips,eng ENG,MF,28.0,13.7,35,19,8,20,7,15,39,38.5,24,35,6,29,19,54,37,2,Matches,Ipswich-Town,Premier-League
264,Alex Palmer,eng ENG,GK,27.0,13.0,0,0,0,0,0,0,0,,0,0,0,0,0,0,12,0,Matches,Ipswich-Town,Premier-League
265,Sammie Szmodics,ie IRL,"FW,MF",28.0,11.0,16,10,4,10,2,7,26,26.9,19,10,2,8,6,22,14,0,Matches,Ipswich-Town,Premier-League
266,Luke Woolfenden,eng ENG,DF,25.0,13.2,9,6,5,4,0,2,5,40.0,3,21,14,7,19,28,76,0,Matches,Ipswich-Town,Premier-League
267,Jack Clarke,eng ENG,"FW,MF",23.0,13.1,32,20,11,10,11,17,34,50.0,17,9,0,9,7,39,29,2,Matches,Ipswich-Town,Premier-League
268,Wes Burns,wls WAL,"FW,DF",29.0,10.3,13,11,1,9,3,4,10,40.0,6,7,2,5,10,23,13,2,Matches,Ipswich-Town,Premier-League
269,Julio Enciso,py PAR,"MF,FW",20.0,9.7,12,9,3,6,3,4,11,36.4,7,8,1,7,1,13,6,0,Matches,Ipswich-Town,Premier-League
270,Conor Chaplin,eng ENG,"MF,FW",27.0,9.5,15,5,6,6,3,6,14,42.9,8,8,1,7,4,19,3,0,Matches,Ipswich-Town,Premier-League
271,Nathan Broadhead,wls WAL,"MF,FW",26.0,7.8,9,4,3,6,0,3,12,25.0,9,8,1,7,4,13,5,0,Matches,Ipswich-Town,Premier-League
272,Christian Walton,eng ENG,GK,28.0,7.0,0,0,0,0,0,0,1,0.0,1,0,0,0,0,0,2,1,Matches,Ipswich-Town,Premier-League
273,George Hirst,sct SCO,FW,25.0,7.3,3,3,1,0,2,1,4,25.0,3,1,1,0,2,5,10,0,Matches,Ipswich-Town,Premier-League
274,Jaden Philogene Bidace,eng ENG,"FW,DF",22.0,5.3,14,7,6,6,2,8,15,53.3,7,11,1,10,10,24,9,1,Matches,Ipswich-Town,Premier-League
275,Jack Taylor,ie IRL,MF,26.0,9.6,20,10,6,11,3,12,27,44.4,15,12,3,9,9,29,24,0,Matches,Ipswich-Town,Premier-League
276,Harry Clarke,eng ENG,DF,23.0,4.2,5,3,3,2,0,3,6,50.0,3,5,4,1,4,9,14,3,Matches,Ipswich-Town,Premier-League
277,Conor Townsend,eng ENG,DF,31.0,3.7,11,8,9,2,0,8,11,72.7,3,8,6,2,4,15,16,0,Matches,Ipswich-Town,Premier-League
278,Chiedozie Ogbene,ie IRL,FW,27.0,2.6,7,3,1,2,4,2,4,50.0,2,1,0,1,1,8,3,0,Matches,Ipswich-Town,Premier-League
279,Massimo Luongo,au AUS,MF,31.0,2.2,9,6,6,2,1,5,8,62.5,3,4,2,2,2,11,2,0,Matches,Ipswich-Town,Premier-League
280,Ben Godfrey,eng ENG,DF,26.0,1.8,1,0,1,0,0,1,1,100.0,0,1,1,0,2,3,3,0,Matches,Ipswich-Town,Premier-League
281,Ali Al Hamadi,iq IRQ,FW,22.0,1.5,1,0,0,0,1,0,2,0.0,2,0,0,0,0,1,2,0,Matches,Ipswich-Town,Premier-League
282,Marcus Harness,eng ENG,MF,28.0,0.5,1,0,0,0,1,0,3,0.0,3,2,1,1,0,1,1,0,Matches,Ipswich-Town,Premier-League
283,George Edmundson,eng ENG,DF,26.0,0.0,0,0,0,0,0,0,0,,0,0,0,0,0,0,0,0,Matches,Ipswich-Town,Premier-League
284,Jamie Vardy,eng ENG,FW,37.0,31.4,19,13,7,7,5,4,13,30.8,9,8,4,4,5,24,24,0,Matches,Leicester-City,Premier-League
285,James Justin,eng ENG,DF,26.0,32.4,58,37,29,23,6,32,55,58.2,23,48,17,31,46,104,141,3,Matches,Leicester-City,Premier-League
286,Wout Faes,be BEL,DF,26.0,31.3,42,26,26,14,2,25,48,52.1,23,48,35,13,26,68,185,4,Matches,Leicester-City,Premier-League
287,Victor Bernth Kristiansen,dk DEN,DF,21.0,27.6,87,51,56,26,5,49,91,53.8,42,38,15,23,42,129,75,3,Matches,Leicester-City,Premier-League
288,Wilfred Ndidi,ng NGA,MF,27.0,25.8,85,51,45,32,8,30,61,49.2,31,47,19,28,31,116,80,0,Matches,Leicester-City,Premier-League
289,Mads Hermansen,dk DEN,GK,24.0,26.5,1,1,1,0,0,1,1,100.0,0,1,0,1,0,1,13,4,Matches,Leicester-City,Premier-League
290,Bilal El Khannouss,ma MAR,"MF,FW",20.0,24.2,50,30,16,29,5,17,32,53.1,15,22,4,18,6,56,10,3,Matches,Leicester-City,Premier-League
291,Boubakary Soumaré,fr FRA,MF,25.0,24.1,37,20,24,12,1,21,33,63.6,12,22,10,12,27,64,34,4,Matches,Leicester-City,Premier-League
292,Conor Coady,eng ENG,DF,31.0,19.0,13,9,6,6,1,3,6,50.0,3,32,24,8,13,26,71,2,Matches,Leicester-City,Premier-League
293,Jordan Ayew,gh GHA,"FW,MF",32.0,18.2,27,15,8,14,5,7,23,30.4,16,21,2,19,12,39,19,0,Matches,Leicester-City,Premier-League
294,Harry Winks,eng ENG,MF,28.0,17.1,24,11,12,10,2,13,30,43.3,17,19,7,12,9,33,20,0,Matches,Leicester-City,Premier-League
295,Stephy Mavididi,eng ENG,FW,26.0,17.9,34,19,16,10,8,14,42,33.3,28,26,2,24,11,45,15,0,Matches,Leicester-City,Premier-League
296,Jannik Vestergaard,dk DEN,DF,31.0,15.5,22,10,16,6,0,9,15,60.0,6,21,14,7,16,38,74,1,Matches,Leicester-City,Premier-League
297,Facundo Buonanotte,ar ARG,"FW,MF",19.0,16.9,53,32,17,22,14,21,67,31.3,46,34,6,28,12,65,14,0,Matches,Leicester-City,Premier-League
298,Luke Thomas,eng ENG,DF,23.0,12.3,31,25,23,5,3,21,41,51.2,20,15,6,9,21,52,49,1,Matches,Leicester-City,Premier-League
299,Caleb Okoli,it ITA,DF,23.0,12.5,25,14,8,15,2,11,18,61.1,7,24,14,10,15,40,79,3,Matches,Leicester-City,Premier-League
300,Oliver Skipp,eng ENG,MF,23.0,12.5,21,4,6,12,3,9,15,60.0,6,23,7,16,11,32,11,2,Matches,Leicester-City,Premier-League
301,Jakub Stolarczyk,pl POL,GK,23.0,10.0,2,1,2,0,0,1,2,50.0,1,0,0,0,0,2,6,1,Matches,Leicester-City,Premier-League
302,Kasey McAteer,ie IRL,FW,22.0,9.5,23,16,11,9,3,14,29,48.3,15,18,2,16,5,28,15,0,Matches,Leicester-City,Premier-League
303,Bobby De Cordova-Reid,jm JAM,FW,31.0,8.3,9,4,3,6,0,4,14,28.6,10,6,1,5,0,9,10,0,Matches,Leicester-City,Premier-League
304,Patson Daka,zm ZAM,"FW,MF",25.0,8.2,19,10,6,9,4,7,18,38.9,11,7,1,6,1,20,12,0,Matches,Leicester-City,Premier-League
305,Abdul Fatawu Issahaku,gh GHA,FW,20.0,6.4,21,15,13,2,6,11,19,57.9,8,7,0,7,4,25,12,0,Matches,Leicester-City,Premier-League
306,Ricardo Pereira,pt POR,DF,30.0,4.3,13,8,4,6,3,7,14,50.0,7,8,3,5,4,17,11,0,Matches,Leicester-City,Premier-League
307,Danny Ward,wls WAL,GK,31.0,1.5,0,0,0,0,0,0,0,,0,0,0,0,0,0,1,0,Matches,Leicester-City,Premier-League
308,Hamza Choudhury,bd BAN,"MF,DF",26.0,1.5,1,1,1,0,0,1,3,33.3,2,4,2,2,5,6,2,0,Matches,Leicester-City,Premier-League
309,Woyo Coulibaly,ml MLI,DF,25.0,1.2,6,4,4,2,0,2,2,100.0,0,3,1,2,5,11,1,0,Matches,Leicester-City,Premier-League
310,Jeremy Monga,,"FW,MF",,1.2,2,1,0,1,1,1,1,100.0,0,3,2,1,0,2,1,0,Matches,Leicester-City,Premier-League
311,Odsonne Édouard,fr FRA,FW,26.0,0.3,1,1,1,0,0,0,0,,0,0,0,0,0,1,1,0,Matches,Leicester-City,Premier-League
312,Jake Evans,,FW,,0.3,1,1,0,0,1,0,1,0.0,1,0,0,0,0,1,1,0,Matches,Leicester-City,Premier-League
313,Olabade Aluko,,DF,,0.0,1,1,0,0,1,1,1,100.0,0,0,0,0,0,1,0,0,Matches,Leicester-City,Premier-League
314,Will Alves,eng ENG,FW,19.0,0.0,0,0,0,0,0,0,0,,0,0,0,0,0,0,0,0,Matches,Leicester-City,Premier-League
315,Michael Golding,eng ENG,MF,18.0,0.0,0,0,0,0,0,0,0,,0,0,0,0,0,0,0,0,Matches,Leicester-City,Premier-League
316,Mohamed Salah,eg EGY,FW,32.0,37.5,21,11,7,5,9,8,17,47.1,9,12,0,12,9,30,5,0,Matches,Liverpool,Premier-League
317,Virgil van Dijk,nl NED,DF,33.0,37.0,38,20,17,19,2,13,22,59.1,9,27,16,11,56,94,190,4,Matches,Liverpool,Premier-League
318,Ryan Gravenberch,nl NED,MF,22.0,35.1,69,35,27,29,13,32,56,57.1,24,35,10,25,60,129,59,2,Matches,Liverpool,Premier-League
319,Alexis Mac Allister,ar ARG,MF,25.0,28.9,95,58,28,51,16,55,104,52.9,49,61,6,55,22,117,29,1,Matches,Liverpool,Premier-League
320,Ibrahima Konaté,fr FRA,DF,25.0,28.4,40,26,25,13,2,25,35,71.4,10,29,15,14,17,57,133,3,Matches,Liverpool,Premier-League
321,Dominik Szoboszlai,hu HUN,MF,23.0,27.7,38,20,14,19,5,17,45,37.8,28,39,5,34,9,47,19,2,Matches,Liverpool,Premier-League
322,Andrew Robertson,sct SCO,DF,30.0,27.6,39,22,25,10,4,31,51,60.8,20,10,4,6,21,60,54,2,Matches,Liverpool,Premier-League
323,Alisson,br BRA,GK,31.0,27.9,1,0,1,0,0,0,1,0.0,1,0,0,0,0,1,13,1,Matches,Liverpool,Premier-League
324,Luis Díaz,co COL,FW,27.0,26.7,39,26,13,20,6,15,39,38.5,24,19,0,19,7,46,7,1,Matches,Liverpool,Premier-League
325,Trent Alexander-Arnold,eng ENG,DF,25.0,26.3,72,50,44,19,9,49,105,46.7,56,26,9,17,31,103,55,4,Matches,Liverpool,Premier-League
326,Cody Gakpo,nl NED,FW,25.0,21.5,28,16,6,13,9,13,25,52.0,12,23,3,20,12,40,19,1,Matches,Liverpool,Premier-League
327,Curtis Jones,eng ENG,"MF,DF",23.0,19.0,39,22,6,23,10,17,27,63.0,10,22,9,13,7,46,10,3,Matches,Liverpool,Premier-League
328,Diogo Jota,pt POR,FW,27.0,13.3,14,8,2,8,4,7,19,36.8,12,9,0,9,8,22,6,0,Matches,Liverpool,Premier-League
329,Caoimhín Kelleher,ie IRL,GK,25.0,10.0,0,0,0,0,0,0,0,,0,0,0,0,0,0,1,2,Matches,Liverpool,Premier-League
330,Kostas Tsimikas,gr GRE,DF,28.0,9.3,31,20,15,11,5,14,23,60.9,9,5,2,3,11,42,20,0,Matches,Liverpool,Premier-League
331,Darwin Núñez,uy URU,FW,25.0,12.6,21,18,11,4,6,7,18,38.9,11,6,0,6,4,25,12,0,Matches,Liverpool,Premier-League
332,Conor Bradley,nir NIR,DF,21.0,8.4,14,10,7,5,2,11,22,50.0,11,9,2,7,4,18,31,0,Matches,Liverpool,Premier-League
333,Joe Gomez,eng ENG,DF,27.0,5.8,13,10,5,7,1,11,16,68.8,5,9,6,3,7,20,20,2,Matches,Liverpool,Premier-League
334,Jarell Quansah,eng ENG,DF,21.0,5.5,12,8,8,4,0,7,10,70.0,3,10,7,3,7,19,28,1,Matches,Liverpool,Premier-League
335,Harvey Elliott,eng ENG,MF,21.0,4.1,5,3,3,1,1,2,8,25.0,6,7,2,5,1,6,3,1,Matches,Liverpool,Premier-League
336,Wataru Endo,jp JPN,"MF,DF",31.0,3.0,12,8,7,5,0,6,10,60.0,4,8,1,7,6,18,9,0,Matches,Liverpool,Premier-League
337,Federico Chiesa,it ITA,FW,26.0,1.2,1,0,0,1,0,0,2,0.0,2,1,0,1,0,1,1,1,Matches,Liverpool,Premier-League
338,Vitezslav Jaros,cz CZE,GK,23.0,0.1,0,0,0,0,0,0,0,,0,0,0,0,0,0,0,0,Matches,Liverpool,Premier-League
339,Jayden Danns,eng ENG,MF,18.0,0.1,0,0,0,0,0,0,1,0.0,1,0,0,0,0,0,0,0,Matches,Liverpool,Premier-League
340,Joško Gvardiol,hr CRO,DF,22.0,36.4,58,39,25,21,12,21,40,52.5,19,42,20,22,44,102,122,8,Matches,Manchester-City,Premier-League
341,Erling Haaland,no NOR,FW,24.0,30.4,11,6,3,3,5,3,8,37.5,5,12,1,11,5,16,23,0,Matches,Manchester-City,Premier-League
342,Bernardo Silva,pt POR,"MF,FW",29.0,29.7,56,37,17,30,9,25,56,44.6,31,36,7,29,23,79,32,3,Matches,Manchester-City,Premier-League
343,Ederson,br BRA,GK,30.0,25.8,0,0,0,0,0,0,2,0.0,2,0,0,0,1,1,11,4,Matches,Manchester-City,Premier-League
344,Rúben Dias,pt POR,DF,27.0,25.2,17,11,7,9,1,7,13,53.8,6,23,20,3,20,37,71,4,Matches,Manchester-City,Premier-League
345,İlkay Gündoğan,de GER,MF,33.0,24.7,25,13,5,15,5,10,24,41.7,14,15,0,15,13,38,23,0,Matches,Manchester-City,Premier-League
346,Mateo Kovačić,hr CRO,MF,30.0,24.4,69,38,23,38,8,31,65,47.7,34,20,0,20,24,93,21,1,Matches,Manchester-City,Premier-League
347,Manuel Akanji,ch SUI,DF,29.0,22.4,19,12,12,4,3,11,17,64.7,6,11,8,3,9,28,64,3,Matches,Manchester-City,Premier-League
348,Rico Lewis,eng ENG,"DF,MF",19.0,21.0,30,19,13,12,5,13,21,61.9,8,28,7,21,13,43,45,1,Matches,Manchester-City,Premier-League
349,Sávio,br BRA,"FW,MF",20.0,19.6,23,17,5,10,8,10,19,52.6,9,14,2,12,6,29,9,1,Matches,Manchester-City,Premier-League
350,Phil Foden,eng ENG,"MF,FW",24.0,19.7,13,5,5,4,4,7,18,38.9,11,13,1,12,9,22,7,1,Matches,Manchester-City,Premier-League
351,Kevin De Bruyne,be BEL,"MF,FW",33.0,18.9,17,9,7,5,5,5,23,21.7,18,8,0,8,7,24,10,1,Matches,Manchester-City,Premier-League
352,Matheus Nunes,pt POR,"DF,MF",25.0,18.6,35,22,15,14,6,16,38,42.1,22,17,4,13,15,50,38,2,Matches,Manchester-City,Premier-League
353,Jeremy Doku,be BEL,"FW,MF",22.0,16.8,31,22,9,12,10,8,15,53.3,7,11,1,10,4,35,2,0,Matches,Manchester-City,Premier-League
354,Omar Marmoush,eg EGY,"FW,MF",25.0,13.1,13,8,2,9,2,8,16,50.0,8,15,1,14,6,19,3,0,Matches,Manchester-City,Premier-League
355,Stefan Ortega,de GER,GK,31.0,12.2,0,0,0,0,0,0,1,0.0,1,0,0,0,0,0,11,1,Matches,Manchester-City,Premier-League
356,Kyle Walker,eng ENG,DF,34.0,10.8,17,10,7,7,3,14,26,53.8,12,13,4,9,3,20,13,1,Matches,Manchester-City,Premier-League
357,Nicolás González,es ESP,MF,22.0,8.4,16,6,5,7,4,6,11,54.5,5,9,0,9,8,24,21,0,Matches,Manchester-City,Premier-League
358,Nathan Aké,nl NED,DF,29.0,7.5,9,7,7,2,0,4,6,66.7,2,7,2,5,3,12,22,1,Matches,Manchester-City,Premier-League
359,Jack Grealish,eng ENG,"FW,MF",28.0,8.0,9,5,4,2,3,2,5,40.0,3,12,2,10,2,11,6,1,Matches,Manchester-City,Premier-League
360,John Stones,eng ENG,"DF,MF",30.0,6.1,6,2,3,2,1,5,5,100.0,0,5,3,2,4,10,19,1,Matches,Manchester-City,Premier-League
361,Nico O’Reilly,eng ENG,DF,19.0,5.9,9,4,3,3,3,4,8,50.0,4,5,1,4,4,13,12,0,Matches,Manchester-City,Premier-League
362,Abdukodir Khusanov,uz UZB,DF,20.0,5.6,5,4,4,1,0,2,3,66.7,1,5,4,1,3,8,29,1,Matches,Manchester-City,Premier-League
363,James Mcatee,eng ENG,"MF,FW",21.0,3.9,5,2,0,4,1,1,7,14.3,6,8,0,8,2,7,1,0,Matches,Manchester-City,Premier-League
364,Jahmai Simpson-Pusey,eng ENG,DF,18.0,1.1,1,0,1,0,0,0,1,0.0,1,1,1,0,0,1,2,0,Matches,Manchester-City,Premier-League
365,Rodri,es ESP,MF,28.0,0.8,2,1,1,1,0,0,0,,0,1,0,1,1,3,1,0,Matches,Manchester-City,Premier-League
366,Divin Mubama,eng ENG,FW,19.0,0.3,0,0,0,0,0,0,0,,0,0,0,0,0,0,0,0,Matches,Manchester-City,Premier-League
367,Oscar Bobb,no NOR,FW,21.0,0.2,0,0,0,0,0,0,0,,0,0,0,0,0,0,0,0,Matches,Manchester-City,Premier-League
368,Claudio Echeverri,ar ARG,FW,18.0,0.1,1,0,0,1,0,1,1,100.0,0,0,0,0,0,1,0,0,Matches,Manchester-City,Premier-League
369,Vitor Reis,br BRA,DF,18.0,0.0,0,0,0,0,0,0,0,,0,0,0,0,0,0,1,0,Matches,Manchester-City,Premier-League
370,Bruno Fernandes,pt POR,MF,29.0,33.5,84,50,27,38,19,34,85,40.0,51,35,6,29,26,110,35,3,Matches,Manchester-United,Premier-League
371,André Onana,cm CMR,GK,28.0,34.0,2,2,2,0,0,2,4,50.0,2,0,0,0,0,2,11,4,Matches,Manchester-United,Premier-League
372,Noussair Mazraoui,ma MAR,DF,26.0,31.5,115,68,58,42,15,59,94,62.8,35,36,9,27,34,149,95,1,Matches,Manchester-United,Premier-League
373,Diogo Dalot,pt POR,DF,25.0,31.3,68,40,40,22,6,34,52,65.4,18,22,9,13,37,105,72,0,Matches,Manchester-United,Premier-League
374,Matthijs de Ligt,nl NED,DF,24.0,23.6,30,22,17,12,1,23,32,71.9,9,29,21,8,33,63,96,0,Matches,Manchester-United,Premier-League
375,Alejandro Garnacho,ar ARG,"MF,FW",20.0,24.4,30,18,11,6,13,12,37,32.4,25,19,0,19,13,43,11,2,Matches,Manchester-United,Premier-League
376,Rasmus Højlund,dk DEN,FW,21.0,22.3,3,1,0,2,1,0,5,0.0,5,6,0,6,2,5,6,0,Matches,Manchester-United,Premier-League
377,Manuel Ugarte Ribeiro,uy URU,MF,23.0,19.8,77,49,34,34,9,30,68,44.1,38,33,4,29,27,104,17,2,Matches,Manchester-United,Premier-League
378,Amad Diallo,ci CIV,"MF,FW",22.0,21.1,38,31,9,20,9,19,32,59.4,13,15,2,13,11,49,19,1,Matches,Manchester-United,Premier-League
379,Lisandro Martínez,ar ARG,DF,26.0,19.5,40,24,25,12,3,21,36,58.3,15,22,8,14,32,72,57,1,Matches,Manchester-United,Premier-League
380,Harry Maguire,eng ENG,DF,31.0,19.5,30,15,23,6,1,17,23,73.9,6,15,12,3,40,70,78,1,Matches,Manchester-United,Premier-League
381,Kobbie Mainoo,eng ENG,MF,19.0,18.3,46,29,18,14,14,24,40,60.0,16,16,2,14,19,65,14,1,Matches,Manchester-United,Premier-League
382,Casemiro,br BRA,MF,32.0,16.6,83,50,50,23,10,45,74,60.8,29,39,10,29,14,97,51,3,Matches,Manchester-United,Premier-League
383,Joshua Zirkzee,nl NED,"FW,MF",23.0,15.6,14,8,3,8,3,5,10,50.0,5,15,4,11,6,20,8,1,Matches,Manchester-United,Premier-League
384,Leny Yoro,fr FRA,DF,18.0,12.9,29,11,19,9,1,13,19,68.4,6,5,3,2,18,47,43,0,Matches,Manchester-United,Premier-League
385,Marcus Rashford,eng ENG,"FW,MF",26.0,10.9,7,4,2,2,3,3,9,33.3,6,8,0,8,4,11,7,0,Matches,Manchester-United,Premier-League
386,Christian Eriksen,dk DEN,MF,32.0,11.8,19,9,4,12,3,11,27,40.7,16,15,5,10,7,26,8,0,Matches,Manchester-United,Premier-League
387,Patrick Dorgu,dk DEN,DF,19.0,9.4,31,24,15,14,2,16,23,69.6,7,11,0,11,4,35,23,2,Matches,Manchester-United,Premier-League
388,Mason Mount,eng ENG,MF,25.0,6.9,15,5,5,8,2,9,12,75.0,3,11,1,10,4,19,4,0,Matches,Manchester-United,Premier-League
389,Victor Lindelöf,se SWE,DF,30.0,7.8,7,2,5,1,1,3,4,75.0,1,6,4,2,8,15,36,2,Matches,Manchester-United,Premier-League
390,Altay Bayındır,tr TUR,GK,26.0,4.0,0,0,0,0,0,0,1,0.0,1,0,0,0,0,0,9,1,Matches,Manchester-United,Premier-League
391,Luke Shaw,eng ENG,DF,29.0,3.9,4,3,2,2,0,2,2,100.0,0,6,1,5,2,6,7,0,Matches,Manchester-United,Premier-League
392,Harry Amass,eng ENG,DF,17.0,3.8,6,2,5,1,0,2,8,25.0,6,11,1,10,2,8,11,0,Matches,Manchester-United,Premier-League
393,Jonny Evans,nir NIR,DF,36.0,3.5,8,6,4,4,0,3,6,50.0,3,3,2,1,5,13,15,0,Matches,Manchester-United,Premier-League
394,Ayden Heaven,eng ENG,DF,17.0,1.9,4,3,1,3,0,2,2,100.0,0,2,2,0,4,8,9,0,Matches,Manchester-United,Premier-League
395,Tyler Fredricson,eng ENG,DF,19.0,1.8,5,3,3,2,0,1,2,50.0,1,2,0,2,1,6,11,0,Matches,Manchester-United,Premier-League
396,Tyrell Malacia,nl NED,DF,24.0,1.1,2,1,2,0,0,1,2,50.0,1,0,0,0,1,3,1,1,Matches,Manchester-United,Premier-League
397,Chidozie Obi-Martin,dk DEN,FW,16.0,1.8,2,1,0,0,2,2,2,100.0,0,0,0,0,0,2,1,0,Matches,Manchester-United,Premier-League
398,Toby Collyer,eng ENG,MF,20.0,2.0,12,9,6,6,0,5,6,83.3,1,2,1,1,2,14,3,0,Matches,Manchester-United,Premier-League
399,Antony,br BRA,"DF,MF",24.0,1.6,6,3,4,2,0,2,5,40.0,3,2,0,2,2,8,0,0,Matches,Manchester-United,Premier-League
400,Scott McTominay,sct SCO,MF,27.0,0.2,0,0,0,0,0,0,1,0.0,1,0,0,0,0,0,1,0,Matches,Manchester-United,Premier-League
401,Bruno Guimarães,br BRA,MF,26.0,36.3,83,47,41,30,12,33,69,47.8,36,36,10,26,29,112,44,5,Matches,Newcastle-United,Premier-League
402,Dan Burn,eng ENG,DF,32.0,37.0,39,24,22,15,2,20,36,55.6,16,36,26,10,27,66,197,4,Matches,Newcastle-United,Premier-League
403,Alexander Isak,se SWE,FW,24.0,30.6,12,5,2,3,7,5,15,33.3,10,18,2,16,3,15,17,1,Matches,Newcastle-United,Premier-League
404,Fabian Schär,ch SUI,DF,32.0,32.6,36,21,16,18,2,14,35,40.0,21,38,25,13,45,81,138,3,Matches,Newcastle-United,Premier-League
405,Valentino Livramento,eng ENG,DF,21.0,31.6,54,36,35,15,4,32,59,54.2,27,37,11,26,23,77,108,1,Matches,Newcastle-United,Premier-League
406,Jacob Murphy,eng ENG,FW,29.0,26.2,28,19,10,12,6,20,44,45.5,24,31,0,31,13,41,35,1,Matches,Newcastle-United,Premier-League
407,Joelinton,br BRA,"MF,FW",27.0,26.6,57,35,23,23,11,25,44,56.8,19,37,7,30,23,80,47,2,Matches,Newcastle-United,Premier-League
408,Sandro Tonali,it ITA,MF,24.0,29.2,51,32,22,23,6,25,51,49.0,26,34,11,23,34,85,33,2,Matches,Newcastle-United,Premier-League
409,Nick Pope,eng ENG,GK,32.0,28.0,0,0,0,0,0,0,0,,0,1,0,1,1,1,32,5,Matches,Newcastle-United,Premier-League
410,Anthony Gordon,eng ENG,"FW,MF",23.0,27.0,32,18,9,18,5,12,37,32.4,25,25,2,23,7,39,9,3,Matches,Newcastle-United,Premier-League
411,Lewis Hall,eng ENG,DF,19.0,24.3,58,41,28,22,8,40,74,54.1,34,33,18,15,18,76,75,3,Matches,Newcastle-United,Premier-League
412,Harvey Barnes,eng ENG,FW,26.0,19.5,16,9,4,6,6,3,11,27.3,8,8,2,6,6,22,15,1,Matches,Newcastle-United,Premier-League
413,Kieran Trippier,eng ENG,DF,33.0,14.5,38,21,18,14,6,22,36,61.1,14,11,3,8,12,50,49,0,Matches,Newcastle-United,Premier-League
414,Joe Willock,eng ENG,"MF,FW",24.0,12.1,30,17,15,12,3,18,31,58.1,13,24,6,18,6,36,7,0,Matches,Newcastle-United,Premier-League
415,Martin Dúbravka,sk SVK,GK,35.0,10.0,0,0,0,0,0,0,0,,0,0,0,0,0,0,3,0,Matches,Newcastle-United,Premier-League
416,Sean Longstaff,eng ENG,MF,26.0,8.9,27,16,10,9,8,18,27,66.7,9,17,5,12,7,34,8,0,Matches,Newcastle-United,Premier-League
417,Sven Botman,nl NED,DF,24.0,4.6,12,9,6,5,1,7,9,77.8,2,5,4,1,5,17,25,1,Matches,Newcastle-United,Premier-League
418,Lloyd Kelly,eng ENG,DF,25.0,3.4,5,4,4,1,0,1,1,100.0,0,6,4,2,1,6,17,0,Matches,Newcastle-United,Premier-League
419,Callum Wilson,eng ENG,FW,32.0,4.1,2,2,0,1,1,0,2,0.0,2,2,0,2,1,3,1,0,Matches,Newcastle-United,Premier-League
420,Emil Krafth,se SWE,DF,29.0,3.8,4,2,2,1,1,2,3,66.7,1,5,4,1,2,6,16,0,Matches,Newcastle-United,Premier-League
421,Lewis Miley,eng ENG,MF,18.0,3.5,14,11,5,7,2,7,14,50.0,7,5,1,4,2,16,5,2,Matches,Newcastle-United,Premier-League
422,Miguel Almirón,py PAR,FW,30.0,1.7,3,2,2,0,1,2,3,66.7,1,2,0,2,0,3,0,0,Matches,Newcastle-United,Premier-League
423,William Osula,dk DEN,FW,20.0,1.5,2,0,1,0,1,0,2,0.0,2,0,0,0,4,6,2,0,Matches,Newcastle-United,Premier-League
424,Matt Targett,eng ENG,DF,28.0,0.2,0,0,0,0,0,0,1,0.0,1,0,0,0,1,1,1,0,Matches,Newcastle-United,Premier-League
425,Matz Sels,be BEL,GK,32.0,38.0,1,1,1,0,0,1,1,100.0,0,0,0,0,0,1,26,1,Matches,Nottingham-Forest,Premier-League
426,Nikola Milenković,rs SRB,DF,26.0,37.0,51,29,36,13,2,27,34,79.4,7,41,24,17,27,78,209,1,Matches,Nottingham-Forest,Premier-League
427,Murillo,br BRA,DF,22.0,35.4,53,36,38,12,3,27,46,58.7,19,69,45,24,36,89,249,3,Matches,Nottingham-Forest,Premier-League
428,Ola Aina,ng NGA,DF,27.0,33.3,55,42,39,15,1,36,64,56.3,28,34,12,22,33,88,115,4,Matches,Nottingham-Forest,Premier-League
429,Chris Wood,nz NZL,FW,32.0,32.9,6,5,2,2,2,3,11,27.3,8,12,7,5,5,11,29,1,Matches,Nottingham-Forest,Premier-League
430,Morgan Gibbs-White,eng ENG,MF,24.0,31.1,43,22,14,23,6,17,33,51.5,16,18,5,13,23,66,29,1,Matches,Nottingham-Forest,Premier-League
431,Elliot Anderson,eng ENG,MF,21.0,30.3,92,56,54,29,9,48,111,43.2,63,48,9,39,31,123,76,4,Matches,Nottingham-Forest,Premier-League
432,Anthony Elanga,se SWE,"FW,MF",22.0,27.8,19,14,8,8,3,5,17,29.4,12,11,1,10,6,25,25,0,Matches,Nottingham-Forest,Premier-League
433,Neco Williams,wls WAL,DF,23.0,28.8,90,57,63,19,8,53,86,61.6,33,42,10,32,31,121,137,3,Matches,Nottingham-Forest,Premier-League
434,Callum Hudson-Odoi,eng ENG,"FW,MF",23.0,24.4,22,14,8,8,6,12,18,66.7,6,11,0,11,13,35,12,1,Matches,Nottingham-Forest,Premier-League
435,Nicolás Domínguez,ar ARG,"MF,FW",26.0,21.8,86,45,40,35,11,36,76,47.4,40,38,12,26,29,115,54,1,Matches,Nottingham-Forest,Premier-League
436,Ryan Yates,eng ENG,MF,26.0,21.3,42,21,24,14,4,17,37,45.9,20,38,10,28,26,68,61,1,Matches,Nottingham-Forest,Premier-League
437,Álex Moreno,es ESP,"DF,MF",31.0,10.6,25,18,20,5,0,15,39,38.5,24,11,5,6,15,40,43,0,Matches,Nottingham-Forest,Premier-League
438,Ibrahim Sangaré,ci CIV,MF,26.0,6.6,28,14,8,17,3,8,17,47.1,9,10,4,6,6,34,13,1,Matches,Nottingham-Forest,Premier-League
439,Morato,br BRA,DF,23.0,10.1,22,14,18,3,1,13,21,61.9,8,14,5,9,10,32,78,2,Matches,Nottingham-Forest,Premier-League
440,Jota Silva,pt POR,"FW,MF",24.0,9.5,27,14,12,13,2,6,27,22.2,21,9,1,8,12,39,17,0,Matches,Nottingham-Forest,Premier-League
441,James Ward-Prowse,eng ENG,MF,29.0,4.4,4,1,1,3,0,2,2,100.0,0,3,2,1,5,9,8,0,Matches,Nottingham-Forest,Premier-League
442,Danilo,br BRA,"MF,FW",23.0,3.1,8,4,7,1,0,3,6,50.0,3,2,1,1,4,12,3,0,Matches,Nottingham-Forest,Premier-League
443,Taiwo Awoniyi,ng NGA,FW,26.0,4.6,6,3,0,3,3,4,5,80.0,1,1,0,1,0,6,7,0,Matches,Nottingham-Forest,Premier-League
444,Ramón Sosa,py PAR,"FW,MF",24.0,3.3,5,3,3,0,2,1,5,20.0,4,9,0,9,4,9,5,0,Matches,Nottingham-Forest,Premier-League
445,Willy Boly,ci CIV,DF,33.0,1.7,6,1,5,1,0,4,4,100.0,0,4,2,2,3,9,12,0,Matches,Nottingham-Forest,Premier-League
446,Harry Toffolo,eng ENG,DF,28.0,1.5,5,3,3,1,1,3,4,75.0,1,2,2,0,2,7,12,0,Matches,Nottingham-Forest,Premier-League
447,Eric da Silva Moreira,de GER,"MF,DF",18.0,0.3,2,2,2,0,0,2,6,33.3,4,0,0,0,1,3,0,0,Matches,Nottingham-Forest,Premier-League
448,Mateus Fernandes,pt POR,MF,20.0,32.3,89,48,45,28,16,33,72,45.8,39,43,8,35,28,117,35,7,Matches,Southampton,Premier-League
449,Kyle Walker-Peters,eng ENG,DF,27.0,32.4,44,29,22,15,7,16,35,45.7,19,27,15,12,19,63,90,1,Matches,Southampton,Premier-League
450,Taylor Harwood-Bellis,eng ENG,DF,22.0,31.4,28,20,13,12,3,19,35,54.3,16,65,43,22,30,58,141,6,Matches,Southampton,Premier-League
451,Aaron Ramsdale,eng ENG,GK,26.0,30.0,0,0,0,0,0,0,3,0.0,3,0,0,0,2,2,10,3,Matches,Southampton,Premier-League
452,Jan Bednarek,pl POL,DF,28.0,28.1,36,19,23,13,0,16,31,51.6,15,47,36,11,56,92,190,5,Matches,Southampton,Premier-League
453,Flynn Downes,eng ENG,MF,25.0,23.9,49,25,23,21,5,15,36,41.7,21,28,9,19,32,81,51,4,Matches,Southampton,Premier-League
454,Joe Aribo,ng NGA,"MF,DF",28.0,22.4,47,33,17,24,6,17,35,48.6,18,28,11,17,20,67,32,3,Matches,Southampton,Premier-League
455,Tyler Dibling,eng ENG,"FW,MF",18.0,20.8,34,20,13,18,3,16,26,61.5,10,19,5,14,8,42,16,1,Matches,Southampton,Premier-League
456,Lesley Ugochukwu,fr FRA,MF,20.0,18.4,50,24,16,30,4,18,36,50.0,18,27,10,17,14,64,23,2,Matches,Southampton,Premier-League
457,Ryan Manning,ie IRL,"DF,MF",28.0,16.2,28,17,16,10,2,14,26,53.8,12,20,11,9,17,45,47,0,Matches,Southampton,Premier-League
458,Kamaldeen Sulemana,gh GHA,"FW,MF",22.0,15.6,22,17,9,5,8,10,15,66.7,5,16,4,12,6,28,9,0,Matches,Southampton,Premier-League
459,Jack Stephens,eng ENG,DF,30.0,15.4,34,20,25,9,0,17,30,56.7,13,20,13,7,13,47,53,2,Matches,Southampton,Premier-League
460,Yukinari Sugawara,jp JPN,"DF,MF",24.0,17.3,31,18,16,14,1,19,31,61.3,12,21,10,11,11,42,53,3,Matches,Southampton,Premier-League
461,Adam Armstrong,eng ENG,"FW,MF",27.0,13.9,12,3,2,7,3,3,14,21.4,11,6,1,5,3,15,8,0,Matches,Southampton,Premier-League
462,Cameron Archer,eng ENG,FW,23.0,16.0,13,8,8,3,2,2,9,22.2,7,5,1,4,2,15,11,0,Matches,Southampton,Premier-League
463,James Bree,eng ENG,DF,26.0,11.9,19,14,8,10,1,10,25,40.0,15,10,3,7,9,28,29,0,Matches,Southampton,Premier-League
464,Paul Onuachu,ng NGA,FW,30.0,11.7,7,2,1,5,1,3,7,42.9,4,7,2,5,1,8,16,1,Matches,Southampton,Premier-League
465,Nathan Wood-Gordon,eng ENG,DF,22.0,8.6,14,8,8,5,1,8,11,72.7,3,9,6,3,5,19,39,2,Matches,Southampton,Premier-League
466,William Smallbone,ie IRL,MF,24.0,7.7,20,13,9,9,2,7,22,31.8,15,8,0,8,2,22,14,2,Matches,Southampton,Premier-League
467,Welington,br BRA,DF,23.0,5.4,21,9,15,5,1,12,19,63.2,7,5,1,4,7,28,36,0,Matches,Southampton,Premier-League
468,Alex McCarthy,eng ENG,GK,34.0,5.0,0,0,0,0,0,0,0,,0,0,0,0,0,0,1,4,Matches,Southampton,Premier-League
469,Adam Lallana,eng ENG,MF,36.0,4.0,8,5,4,4,0,2,12,16.7,10,4,1,3,5,13,5,0,Matches,Southampton,Premier-League
470,Ben Brereton,cl CHI,FW,25.0,5.0,3,2,0,2,1,1,9,11.1,8,2,1,1,0,3,4,0,Matches,Southampton,Premier-League
471,Ross Stewart,sct SCO,FW,28.0,4.3,6,4,1,1,4,3,8,37.5,5,3,0,3,1,7,7,0,Matches,Southampton,Premier-League
472,Ryan Fraser,sct SCO,"FW,DF",30.0,3.4,6,2,2,4,0,4,6,66.7,2,1,1,0,1,7,9,0,Matches,Southampton,Premier-League
473,Charlie Taylor,eng ENG,DF,30.0,4.0,7,5,4,3,0,5,7,71.4,2,8,5,3,5,12,31,1,Matches,Southampton,Premier-League
474,Joe Lumley,eng ENG,GK,29.0,3.0,0,0,0,0,0,0,0,,0,0,0,0,0,0,3,3,Matches,Southampton,Premier-League
475,Armel Bella Kotchap,de GER,DF,22.0,3.7,7,5,5,2,0,3,6,50.0,3,2,2,0,5,12,21,1,Matches,Southampton,Premier-League
476,Albert Grønbaek,dk DEN,"FW,MF",23.0,1.6,4,1,1,1,2,3,10,30.0,7,1,1,0,0,4,1,0,Matches,Southampton,Premier-League
477,Jay Robinson,eng ENG,"MF,FW",17.0,1.5,4,1,3,0,1,1,1,100.0,0,0,0,0,0,4,1,0,Matches,Southampton,Premier-League
478,Maxwel Cornet,ci CIV,FW,27.0,0.8,5,5,1,4,0,0,4,0.0,4,0,0,0,0,5,2,0,Matches,Southampton,Premier-League
479,Samuel Edozie,eng ENG,"DF,FW",21.0,0.7,3,1,0,1,2,2,2,100.0,0,0,0,0,0,3,0,0,Matches,Southampton,Premier-League
480,Samuel Amo-Ameyaw,eng ENG,"FW,DF",18.0,0.3,1,0,0,1,0,1,1,100.0,0,0,0,0,0,1,0,0,Matches,Southampton,Premier-League
481,Joachim Kayi Sanda,fr FRA,DF,17.0,0.2,0,0,0,0,0,0,0,,0,0,0,0,2,2,0,0,Matches,Southampton,Premier-League
482,Ronnie Edwards,eng ENG,DF,21.0,0.1,0,0,0,0,0,0,0,,0,1,1,0,0,0,0,0,Matches,Southampton,Premier-League
483,Carlos Alcaraz,ar ARG,MF,21.0,0.1,0,0,0,0,0,0,0,,0,0,0,0,1,1,0,0,Matches,Southampton,Premier-League
484,Pedro Porro,es ESP,DF,24.0,29.0,66,49,34,22,10,44,77,57.1,33,44,17,27,36,102,84,2,Matches,Tottenham-Hotspur,Premier-League
485,Dejan Kulusevski,se SWE,"MF,FW",24.0,26.5,45,23,17,13,15,19,51,37.3,32,34,5,29,13,58,10,1,Matches,Tottenham-Hotspur,Premier-League
486,Dominic Solanke,eng ENG,FW,26.0,24.5,18,11,1,12,5,4,16,25.0,12,20,9,11,1,19,23,0,Matches,Tottenham-Hotspur,Premier-League
487,Brennan Johnson,wls WAL,FW,23.0,24.2,39,26,9,20,10,16,34,47.1,18,25,3,22,4,43,14,0,Matches,Tottenham-Hotspur,Premier-League
488,Guglielmo Vicario,it ITA,GK,27.0,24.0,0,0,0,0,0,0,0,,0,0,0,0,1,1,14,6,Matches,Tottenham-Hotspur,Premier-League
489,Son Heung-min,kr KOR,FW,32.0,23.4,17,9,3,8,6,5,27,18.5,22,11,0,11,5,22,17,1,Matches,Tottenham-Hotspur,Premier-League
490,Destiny Udogie,it ITA,DF,21.0,21.4,75,47,42,26,7,33,48,68.8,15,40,6,34,22,97,36,1,Matches,Tottenham-Hotspur,Premier-League
491,Pape Matar Sarr,sn SEN,MF,21.0,21.3,49,36,19,23,7,12,25,48.0,13,26,10,16,30,79,25,1,Matches,Tottenham-Hotspur,Premier-League
492,James Maddison,eng ENG,MF,27.0,20.1,31,19,8,16,7,9,29,31.0,20,15,4,11,12,43,19,1,Matches,Tottenham-Hotspur,Premier-League
493,Rodrigo Bentancur,uy URU,MF,27.0,18.3,40,22,19,17,4,19,40,47.5,21,25,8,17,40,80,38,1,Matches,Tottenham-Hotspur,Premier-League
494,Djed Spence,eng ENG,DF,23.0,19.9,47,34,25,15,7,23,30,76.7,7,28,9,19,21,68,74,2,Matches,Tottenham-Hotspur,Premier-League
495,Archie Gray,eng ENG,"DF,MF",18.0,19.5,16,8,4,8,4,7,17,41.2,10,22,11,11,19,35,50,2,Matches,Tottenham-Hotspur,Premier-League
496,Cristian Romero,ar ARG,DF,26.0,15.7,35,29,26,8,1,21,30,70.0,9,18,3,15,21,56,57,2,Matches,Tottenham-Hotspur,Premier-League
497,Yves Bissouma,ml MLI,MF,27.0,15.6,49,31,20,25,4,19,34,55.9,15,11,6,5,18,67,40,4,Matches,Tottenham-Hotspur,Premier-League
498,Ben Davies,wls WAL,DF,31.0,14.8,17,11,8,8,1,9,17,52.9,8,28,19,9,12,29,81,1,Matches,Tottenham-Hotspur,Premier-League
499,Radu Drăgușin,ro ROU,DF,22.0,13.9,10,6,8,2,0,6,12,50.0,6,22,16,6,15,25,49,4,Matches,Tottenham-Hotspur,Premier-League
500,Micky van de Ven,nl NED,DF,23.0,11.3,10,6,5,4,1,8,14,57.1,6,12,8,4,10,20,39,1,Matches,Tottenham-Hotspur,Premier-League
501,Lucas Bergvall,se SWE,MF,18.0,13.5,39,19,14,20,5,17,32,53.1,15,18,8,10,24,63,22,3,Matches,Tottenham-Hotspur,Premier-League
502,Mathys Tel,fr FRA,FW,19.0,10.1,16,6,5,6,5,5,13,38.5,8,8,1,7,2,18,8,2,Matches,Tottenham-Hotspur,Premier-League
503,Wilson Odobert,fr FRA,"FW,MF",19.0,9.4,14,5,5,4,5,8,14,57.1,6,6,0,6,4,18,5,1,Matches,Tottenham-Hotspur,Premier-League
504,Kevin Danso,at AUT,DF,25.0,9.4,7,5,4,3,0,6,11,54.5,5,15,14,1,6,13,71,1,Matches,Tottenham-Hotspur,Premier-League
505,Fraser Forster,eng ENG,GK,36.0,7.0,0,0,0,0,0,0,1,0.0,1,0,0,0,0,0,7,3,Matches,Tottenham-Hotspur,Premier-League
506,Antonín Kinský,cz CZE,GK,21.0,6.0,3,1,3,0,0,1,1,100.0,0,0,0,0,0,3,9,1,Matches,Tottenham-Hotspur,Premier-League
507,Timo Werner,de GER,"FW,MF",28.0,5.7,6,4,3,3,0,3,13,23.1,10,10,1,9,1,7,7,0,Matches,Tottenham-Hotspur,Premier-League
508,Richarlison,br BRA,FW,27.0,5.6,5,3,0,4,1,0,3,0.0,3,1,1,0,0,5,8,0,Matches,Tottenham-Hotspur,Premier-League
509,Mikey Moore,eng ENG,FW,16.0,4.1,2,1,2,0,0,0,4,0.0,4,2,0,2,1,3,4,0,Matches,Tottenham-Hotspur,Premier-League
510,Sergio Reguilón,es ESP,DF,27.0,2.2,4,3,1,3,0,2,5,40.0,3,7,0,7,4,8,8,0,Matches,Tottenham-Hotspur,Premier-League
511,Brandon Austin,eng ENG,GK,25.0,1.0,0,0,0,0,0,0,0,,0,0,0,0,0,0,1,0,Matches,Tottenham-Hotspur,Premier-League
512,Dane Scarlett,eng ENG,"FW,MF",20.0,0.4,1,0,0,1,0,0,0,,0,0,0,0,0,1,1,0,Matches,Tottenham-Hotspur,Premier-League
513,Alfie Dorrington,eng ENG,DF,19.0,0.2,0,0,0,0,0,0,0,,0,0,0,0,0,0,0,0,Matches,Tottenham-Hotspur,Premier-League
514,Will Lankshear,eng ENG,"FW,MF",19.0,0.1,0,0,0,0,0,0,0,,0,0,0,0,0,0,0,0,Matches,Tottenham-Hotspur,Premier-League
515,Max Kilman,eng ENG,DF,27.0,37.2,39,24,16,20,3,23,27,85.2,4,58,40,18,38,77,212,6,Matches,West-Ham-United,Premier-League
516,Aaron Wan-Bissaka,eng ENG,DF,26.0,35.0,70,49,33,32,5,23,32,71.9,9,37,11,26,66,136,125,0,Matches,West-Ham-United,Premier-League
517,Jarrod Bowen,eng ENG,"FW,MF",27.0,33.0,41,26,13,12,16,19,40,47.5,21,22,4,18,16,57,25,0,Matches,West-Ham-United,Premier-League
518,Mohammed Kudus,gh GHA,"FW,MF",23.0,28.8,38,23,9,18,11,10,27,37.0,17,24,1,23,4,42,8,2,Matches,West-Ham-United,Premier-League
519,Tomáš Souček,cz CZE,MF,29.0,28.5,46,21,20,23,3,26,44,59.1,18,41,21,20,20,66,85,1,Matches,West-Ham-United,Premier-League
520,Lucas Paquetá,br BRA,"MF,FW",26.0,26.4,66,37,25,30,11,27,55,49.1,28,29,4,25,18,84,37,6,Matches,West-Ham-United,Premier-League
521,Emerson Palmieri,it ITA,DF,29.0,23.5,60,31,37,18,5,27,48,56.3,21,32,8,24,21,81,59,0,Matches,West-Ham-United,Premier-League
522,Alphonse Areola,fr FRA,GK,31.0,25.1,2,2,2,0,0,2,3,66.7,1,0,0,0,0,2,15,3,Matches,West-Ham-United,Premier-League
523,Konstantinos Mavropanos,gr GRE,DF,26.0,22.7,35,24,24,10,1,16,27,59.3,11,25,18,7,40,75,126,1,Matches,West-Ham-United,Premier-League
524,Jean-Clair Todibo,fr FRA,DF,24.0,20.3,47,28,30,15,2,26,36,72.2,10,25,13,12,26,73,83,3,Matches,West-Ham-United,Premier-League
525,Edson Álvarez,mx MEX,MF,26.0,19.7,50,27,27,15,8,17,35,48.6,18,23,8,15,18,68,46,1,Matches,West-Ham-United,Premier-League
526,Guido Rodríguez,ar ARG,MF,30.0,12.8,36,19,21,15,0,17,33,51.5,16,23,9,14,13,49,35,1,Matches,West-Ham-United,Premier-League
527,Carlos Soler,es ESP,"MF,FW",27.0,15.7,16,11,9,6,1,7,23,30.4,16,19,6,13,8,24,21,2,Matches,West-Ham-United,Premier-League
528,Łukasz Fabiański,pl POL,GK,39.0,12.9,0,0,0,0,0,0,1,0.0,1,0,0,0,0,0,5,1,Matches,West-Ham-United,Premier-League
529,James Ward-Prowse,eng ENG,MF,29.0,11.5,20,14,8,8,4,7,19,36.8,12,6,3,3,8,28,15,0,Matches,West-Ham-United,Premier-League
530,Vladimír Coufal,cz CZE,DF,31.0,11.9,22,15,13,7,2,10,22,45.5,12,13,11,2,8,30,39,1,Matches,West-Ham-United,Premier-League
531,Michail Antonio,jm JAM,FW,34.0,9.3,2,2,0,1,1,2,3,66.7,1,6,0,6,0,2,2,0,Matches,West-Ham-United,Premier-League
532,Aaron Cresswell,eng ENG,DF,34.0,9.2,11,7,5,5,1,9,11,81.8,2,9,4,5,8,19,37,0,Matches,West-Ham-United,Premier-League
533,Crysencio Summerville,nl NED,"FW,MF",22.0,8.7,13,7,2,8,3,3,9,33.3,6,13,4,9,0,13,7,0,Matches,West-Ham-United,Premier-League
534,Oliver Scarles,eng ENG,"DF,FW",18.0,7.4,21,11,17,3,1,14,22,63.6,8,14,2,12,11,32,26,0,Matches,West-Ham-United,Premier-League
535,Niclas Füllkrug,de GER,FW,31.0,8.8,4,3,0,1,3,3,4,75.0,1,1,0,1,1,5,16,0,Matches,West-Ham-United,Premier-League
536,Danny Ings,eng ENG,"FW,MF",32.0,3.2,4,2,2,2,0,1,3,33.3,2,5,0,5,1,5,4,0,Matches,West-Ham-United,Premier-League
537,Andy Irving,sct SCO,MF,24.0,1.8,7,4,3,3,1,1,5,20.0,4,5,1,4,1,8,5,0,Matches,West-Ham-United,Premier-League
538,Evan Ferguson,ie IRL,FW,19.0,1.7,3,1,0,1,2,0,0,,0,2,1,1,1,4,1,0,Matches,West-Ham-United,Premier-League
539,Luis Guilherme,br BRA,"MF,FW",18.0,1.7,1,0,1,0,0,0,3,0.0,3,7,0,7,3,4,2,0,Matches,West-Ham-United,Premier-League
540,Lewis Orford,eng ENG,MF,18.0,0.5,0,0,0,0,0,0,0,,0,1,0,1,1,1,0,0,Matches,West-Ham-United,Premier-League
541,Kaelan Casey,eng ENG,DF,19.0,0.0,0,0,0,0,0,0,0,,0,0,0,0,0,0,1,0,Matches,West-Ham-United,Premier-League
542,Rayan Aït-Nouri,dz ALG,DF,23.0,34.5,89,57,52,28,9,43,70,61.4,27,42,6,36,26,115,75,2,Matches,Wolverhampton-Wanderers,Premier-League
543,João Gomes,br BRA,MF,23.0,33.0,116,71,55,53,8,48,110,43.6,62,42,4,38,25,141,33,0,Matches,Wolverhampton-Wanderers,Premier-League
544,Nélson Semedo,pt POR,DF,30.0,32.1,62,36,32,21,9,34,57,59.6,23,32,10,22,23,85,104,3,Matches,Wolverhampton-Wanderers,Premier-League
545,André,br BRA,MF,23.0,27.5,91,55,41,41,9,37,63,58.7,26,42,8,34,37,128,30,1,Matches,Wolverhampton-Wanderers,Premier-League
546,Toti Gomes,pt POR,DF,25.0,29.0,61,43,42,15,4,37,46,80.4,9,29,17,12,25,86,152,5,Matches,Wolverhampton-Wanderers,Premier-League
547,Jørgen Strand Larsen,no NOR,FW,24.0,28.7,10,6,2,3,5,4,27,14.8,23,19,4,15,6,16,29,0,Matches,Wolverhampton-Wanderers,Premier-League
548,José Sá,pt POR,GK,31.0,29.0,2,2,2,0,0,2,2,100.0,0,0,0,0,0,2,15,1,Matches,Wolverhampton-Wanderers,Premier-League
549,Matheus Cunha,br BRA,"MF,FW",25.0,28.9,38,22,17,16,5,13,39,33.3,26,21,1,20,17,55,23,0,Matches,Wolverhampton-Wanderers,Premier-League
550,Matt Doherty,ie IRL,DF,32.0,23.4,38,21,25,13,0,17,25,68.0,8,28,15,13,22,60,102,3,Matches,Wolverhampton-Wanderers,Premier-League
551,Jean-Ricner Bellegarde,fr FRA,"MF,FW",26.0,18.6,39,24,17,19,3,14,20,70.0,6,19,3,16,10,49,18,1,Matches,Wolverhampton-Wanderers,Premier-League
552,Santiago Bueno,uy URU,DF,25.0,18.7,41,21,22,18,1,17,22,77.3,5,36,21,15,15,56,70,0,Matches,Wolverhampton-Wanderers,Premier-League
553,Emmanuel Agbadou,ci CIV,DF,27.0,15.7,30,19,21,9,0,13,20,65.0,7,19,13,6,12,42,90,0,Matches,Wolverhampton-Wanderers,Premier-League
554,Mario Lemina,ga GAB,"MF,DF",30.0,15.2,51,31,27,19,5,20,29,69.0,9,12,7,5,27,78,50,3,Matches,Wolverhampton-Wanderers,Premier-League
555,Marshall Munetsi,zw ZIM,"MF,FW",28.0,12.0,24,10,7,11,6,13,23,56.5,10,14,1,13,6,30,18,0,Matches,Wolverhampton-Wanderers,Premier-League
556,Gonçalo Guedes,pt POR,"MF,FW",27.0,11.1,16,5,2,6,8,4,16,25.0,12,11,0,11,5,21,4,0,Matches,Wolverhampton-Wanderers,Premier-League
557,Craig Dawson,eng ENG,DF,34.0,10.8,15,3,8,6,1,12,15,80.0,3,16,11,5,9,24,52,1,Matches,Wolverhampton-Wanderers,Premier-League
558,Pablo Sarabia,es ESP,"MF,FW",32.0,9.0,16,8,4,8,4,10,16,62.5,6,10,0,10,4,20,7,1,Matches,Wolverhampton-Wanderers,Premier-League
559,Rodrigo Gomes,pt POR,"DF,FW",21.0,9.0,23,15,14,9,0,12,21,57.1,9,8,1,7,7,30,20,1,Matches,Wolverhampton-Wanderers,Premier-League
560,Sam Johnstone,eng ENG,GK,31.0,7.0,0,0,0,0,0,0,1,0.0,1,0,0,0,0,0,7,0,Matches,Wolverhampton-Wanderers,Premier-League
561,Hwang Hee-chan,kr KOR,"MF,FW",28.0,7.3,6,4,2,1,3,2,6,33.3,4,9,0,9,2,8,11,0,Matches,Wolverhampton-Wanderers,Premier-League
562,Yerson Mosquera,co COL,DF,23.0,4.9,11,7,9,2,0,9,14,64.3,5,13,10,3,10,21,14,0,Matches,Wolverhampton-Wanderers,Premier-League
563,Tommy Doyle,eng ENG,MF,22.0,5.4,11,6,6,3,2,6,15,40.0,9,11,5,6,5,16,11,1,Matches,Wolverhampton-Wanderers,Premier-League
564,Daniel Bentley,eng ENG,GK,31.0,2.0,0,0,0,0,0,0,0,,0,0,0,0,0,0,1,0,Matches,Wolverhampton-Wanderers,Premier-League
565,Carlos Forbs,pt POR,"MF,FW",20.0,2.7,8,5,5,2,1,4,6,66.7,2,3,0,3,1,9,2,1,Matches,Wolverhampton-Wanderers,Premier-League
566,Pedro Lima,br BRA,DF,18.0,0.8,1,0,0,0,1,1,3,33.3,2,0,0,0,2,3,5,0,Matches,Wolverhampton-Wanderers,Premier-League
567,Nasser Djiga,bf BFA,DF,21.0,0.7,0,0,0,0,0,0,1,0.0,1,0,0,0,2,2,4,1,Matches,Wolverhampton-Wanderers,Premier-League
568,Daniel Podence,pt POR,"MF,FW",28.0,0.5,0,0,0,0,0,0,1,0.0,1,0,0,0,0,0,0,0,Matches,Wolverhampton-Wanderers,Premier-League
569,Chiquinho,pt POR,MF,24.0,0.1,0,0,0,0,0,0,0,,0,0,0,0,0,0,0,0,Matches,Wolverhampton-Wanderers,Premier-League
570,Mateus Mane,,MF,,0.0,0,0,0,0,0,0,0,,0,1,0,1,0,0,0,0,Matches,Wolverhampton-Wanderers,Premier-League
571,Tom King,wls WAL,GK,29.0,0.0,0,0,0,0,0,0,0,,0,0,0,0,0,0,0,0,Matches,Wolverhampton-Wanderers,Premier-League
572,Alfie Pond,eng ENG,DF,20.0,0.0,0,0,0,0,0,0,0,,0,0,0,0,0,0,0,0,Matches,Wolverhampton-Wanderers,Premier-League
573,Boubacar Traoré,ml MLI,MF,22.0,0.0,2,0,0,2,0,1,1,100.0,0,0,0,0,0,2,0,0,Matches,Wolverhampton-Wanderers,Premier-League
574,Carlos Vicente,es ESP,"FW,MF",25.0,34.4,47,31,26,11,10,25,64,39.1,39,34,2,32,14,61,40,0,Matches,Alaves,La-Liga
575,Nahuel Tenaglia,ar ARG,DF,28.0,32.5,96,61,61,30,5,53,88,60.2,35,33,9,24,47,143,123,2,Matches,Alaves,La-Liga
576,Antonio Sivera,es ESP,GK,27.0,31.2,2,1,2,0,0,2,2,100.0,0,1,0,1,0,2,20,0,Matches,Alaves,La-Liga
577,Antonio Blanco,es ESP,MF,24.0,30.3,67,40,23,37,7,32,83,38.6,51,30,7,23,42,109,48,1,Matches,Alaves,La-Liga
578,Manu Sánchez,es ESP,DF,23.0,29.3,83,56,40,33,10,41,69,59.4,28,51,12,39,30,113,76,1,Matches,Alaves,La-Liga
579,Kiké,es ESP,FW,34.0,28.2,19,14,1,12,6,6,17,35.3,11,11,4,7,1,20,23,0,Matches,Alaves,La-Liga
580,Abdel Abqar,ma MAR,DF,25.0,27.4,36,23,24,11,1,20,34,58.8,14,28,18,10,39,75,146,1,Matches,Alaves,La-Liga
581,Jon Guridi,es ESP,"MF,FW",29.0,23.1,40,22,7,26,7,18,44,40.9,26,19,1,18,14,54,16,0,Matches,Alaves,La-Liga
582,Ander Guevara,es ESP,MF,27.0,21.6,49,30,19,29,1,20,48,41.7,28,21,5,16,14,63,43,1,Matches,Alaves,La-Liga
583,Moussa Diarra,ml MLI,DF,23.0,20.7,40,24,19,18,3,17,29,58.6,12,15,5,10,21,61,46,1,Matches,Alaves,La-Liga
584,Santiago Mouriño,uy URU,DF,22.0,20.5,43,28,31,12,0,21,38,55.3,17,27,12,15,29,72,120,0,Matches,Alaves,La-Liga
585,Carlos Martín,es ESP,"FW,MF",22.0,14.8,43,21,18,16,9,13,49,26.5,36,30,1,29,5,48,20,0,Matches,Alaves,La-Liga
586,Joan Jordán,es ESP,MF,30.0,15.7,32,18,11,17,4,17,30,56.7,13,12,0,12,9,41,21,0,Matches,Alaves,La-Liga
587,Carles Aleñá,es ESP,"MF,FW",26.0,12.1,19,12,6,7,6,7,17,41.2,10,11,0,11,2,21,4,0,Matches,Alaves,La-Liga
588,Toni Martínez,es ESP,FW,27.0,11.2,12,7,5,4,3,4,8,50.0,4,8,2,6,1,13,15,0,Matches,Alaves,La-Liga
589,Tomás Conechny,ar ARG,"FW,MF",26.0,9.4,15,12,6,7,2,9,27,33.3,18,14,2,12,6,21,10,0,Matches,Alaves,La-Liga
590,Facundo Garcés,my MAS,DF,24.0,7.5,6,2,4,2,0,3,5,60.0,2,8,6,2,5,11,51,0,Matches,Alaves,La-Liga
591,Aleksandar Sedlar,rs SRB,DF,32.0,6.6,18,10,7,11,0,8,10,80.0,2,2,1,1,10,28,24,1,Matches,Alaves,La-Liga
592,Stoichkov,es ESP,"MF,FW",30.0,7.8,14,9,6,7,1,6,11,54.5,5,2,0,2,1,15,7,0,Matches,Alaves,La-Liga
593,Carlos Benavídez,uy URU,MF,26.0,5.4,19,14,10,6,3,6,11,54.5,5,5,2,3,8,27,14,1,Matches,Alaves,La-Liga
594,Pica,es ESP,DF,22.0,5.5,9,7,7,2,0,4,9,44.4,5,7,6,1,9,18,26,0,Matches,Alaves,La-Liga
595,Jesús Owono,gq EQG,GK,23.0,5.4,1,1,1,0,0,1,1,100.0,0,0,0,0,0,1,2,0,Matches,Alaves,La-Liga
596,Abderrahman Rebbach,dz ALG,"FW,MF",25.0,4.3,3,2,3,0,0,0,6,0.0,6,4,0,4,0,3,6,0,Matches,Alaves,La-Liga
597,Asier Villalibre,es ESP,FW,26.0,3.7,2,2,0,1,1,1,2,50.0,1,1,0,1,1,3,7,0,Matches,Alaves,La-Liga
598,Hugo Novoa,es ESP,"DF,MF",21.0,2.6,8,5,4,3,1,5,5,100.0,0,2,1,1,0,8,6,0,Matches,Alaves,La-Liga
599,Luka Romero,ar ARG,"FW,MF",19.0,2.2,4,4,1,1,2,2,3,66.7,1,2,0,2,1,5,0,0,Matches,Alaves,La-Liga
600,Pau Cabanes,es ESP,"MF,FW",19.0,2.1,8,2,4,3,1,6,13,46.2,7,2,0,2,0,8,1,0,Matches,Alaves,La-Liga
601,Adrian Rodriguez,es ESP,GK,23.0,1.4,0,0,0,0,0,0,1,0.0,1,0,0,0,0,0,3,1,Matches,Alaves,La-Liga
602,Luis Rioja,es ESP,FW,30.0,0.3,2,1,0,1,1,1,2,50.0,1,2,0,2,0,2,0,0,Matches,Alaves,La-Liga
603,Iñaki Williams,gh GHA,FW,30.0,29.5,17,10,4,8,5,12,23,52.2,11,34,5,29,12,29,32,0,Matches,Athletic-Club,La-Liga
604,Daniel Vivian,es ESP,DF,25.0,29.0,40,26,23,14,3,21,32,65.6,11,26,10,16,47,87,152,2,Matches,Athletic-Club,La-Liga
605,Álex Berenguer,es ESP,"FW,MF",29.0,26.0,32,16,6,16,10,14,31,45.2,17,23,2,21,10,42,18,0,Matches,Athletic-Club,La-Liga
606,Mikel Jauregizar,es ESP,MF,20.0,24.9,84,48,25,45,14,41,83,49.4,42,24,4,20,29,113,36,2,Matches,Athletic-Club,La-Liga
607,Yuri Berchiche,es ESP,DF,34.0,22.7,33,21,19,11,3,19,33,57.6,14,25,5,20,27,60,72,3,Matches,Athletic-Club,La-Liga
608,Nico Williams,es ESP,FW,22.0,22.2,28,18,10,11,7,11,32,34.4,21,20,1,19,7,35,9,0,Matches,Athletic-Club,La-Liga
609,Unai Simón,es ESP,GK,27.0,21.0,0,0,0,0,0,0,0,,0,1,0,1,1,1,14,4,Matches,Athletic-Club,La-Liga
610,Gorka Guruzeta,es ESP,FW,27.0,20.4,16,8,1,13,2,7,31,22.6,24,28,4,24,9,25,23,0,Matches,Athletic-Club,La-Liga
611,Aitor Paredes,es ESP,DF,24.0,20.1,15,13,10,5,0,8,15,53.3,7,26,15,11,22,37,114,4,Matches,Athletic-Club,La-Liga
612,Beñat Prados,es ESP,MF,23.0,19.1,55,36,20,27,8,25,53,47.2,28,21,2,19,28,83,26,0,Matches,Athletic-Club,La-Liga
613,Yeray Álvarez,es ESP,DF,29.0,19.8,25,13,14,9,2,15,22,68.2,7,10,6,4,34,59,129,1,Matches,Athletic-Club,La-Liga
614,Oihan Sancet,es ESP,MF,24.0,18.0,13,8,6,6,1,5,14,35.7,9,10,0,10,5,18,6,0,Matches,Athletic-Club,La-Liga
615,Iñigo Ruiz de Galarreta,es ESP,MF,30.0,16.4,36,22,11,17,8,20,31,64.5,11,11,4,7,16,52,14,2,Matches,Athletic-Club,La-Liga
616,Óscar de Marcos,es ESP,DF,35.0,17.4,32,15,15,13,4,21,37,56.8,16,17,1,16,16,48,35,0,Matches,Athletic-Club,La-Liga
617,Andoni Gorosabel,es ESP,DF,27.0,16.5,47,28,31,9,7,30,45,66.7,15,18,2,16,18,65,62,0,Matches,Athletic-Club,La-Liga
618,Unai Gómez,es ESP,"MF,FW",21.0,14.3,12,8,3,7,2,4,7,57.1,3,13,1,12,2,14,15,1,Matches,Athletic-Club,La-Liga
619,Julen Agirrezabala,es ESP,GK,23.0,13.4,0,0,0,0,0,0,1,0.0,1,0,0,0,0,0,4,0,Matches,Athletic-Club,La-Liga
620,Adama Boiro,es ESP,"DF,FW",22.0,12.2,20,11,11,7,2,10,15,66.7,5,10,3,7,12,32,27,1,Matches,Athletic-Club,La-Liga
621,Mikel Vesga,es ESP,MF,31.0,11.0,22,15,7,13,2,12,28,42.9,16,10,1,9,15,37,26,0,Matches,Athletic-Club,La-Liga
622,Iñigo Lekue,es ESP,DF,31.0,8.6,15,12,12,3,0,9,17,52.9,8,7,2,5,9,24,29,2,Matches,Athletic-Club,La-Liga
623,Maroan Sannadi,ma MAR,FW,23.0,8.4,5,0,1,4,0,2,7,28.6,5,1,0,1,1,6,2,1,Matches,Athletic-Club,La-Liga
624,Álvaro djaló,es ESP,FW,24.0,7.3,8,5,3,2,3,1,3,33.3,2,4,0,4,1,9,4,0,Matches,Athletic-Club,La-Liga
625,Unai Núñez,es ESP,DF,27.0,7.2,10,5,7,3,0,4,7,57.1,3,4,4,0,17,27,46,1,Matches,Athletic-Club,La-Liga
626,Alex Padilla,es ESP,GK,20.0,3.6,0,0,0,0,0,0,0,,0,0,0,0,0,0,2,1,Matches,Athletic-Club,La-Liga
627,Ander Herrera,es ESP,MF,34.0,3.0,8,4,1,7,0,3,6,50.0,3,1,0,1,2,10,10,0,Matches,Athletic-Club,La-Liga
628,Peio Canales,es ESP,"MF,FW",19.0,2.9,3,2,0,1,2,1,1,100.0,0,3,0,3,2,5,2,0,Matches,Athletic-Club,La-Liga
629,Nicolás Serrano,es ESP,FW,21.0,1.2,1,1,0,1,0,1,3,33.3,2,4,0,4,1,2,1,0,Matches,Athletic-Club,La-Liga
630,Aingeru Olabarrieta,es ESP,FW,18.0,0.6,0,0,0,0,0,0,0,,0,2,0,2,1,1,1,0,Matches,Athletic-Club,La-Liga
631,Javi Martón,es ESP,"FW,MF",25.0,0.6,0,0,0,0,0,0,0,,0,0,0,0,0,0,0,0,Matches,Athletic-Club,La-Liga
632,Adu Ares,es ESP,FW,22.0,0.2,0,0,0,0,0,0,1,0.0,1,0,0,0,0,0,0,0,Matches,Athletic-Club,La-Liga
633,Endika Buján,es ESP,FW,21.0,0.1,0,0,0,0,0,0,1,0.0,1,0,0,0,0,0,0,0,Matches,Athletic-Club,La-Liga
634,Jan Oblak,si SVN,GK,31.0,36.0,0,0,0,0,0,0,0,,0,0,0,0,0,0,17,2,Matches,Atletico-Madrid,La-Liga
635,Julián Álvarez,ar ARG,FW,24.0,27.9,25,17,5,11,9,8,30,26.7,22,14,0,14,2,27,12,1,Matches,Atletico-Madrid,La-Liga
636,Antoine Griezmann,fr FRA,"FW,MF",33.0,27.4,30,17,13,13,4,7,29,24.1,22,20,1,19,6,36,23,1,Matches,Atletico-Madrid,La-Liga
637,Marcos Llorente,es ESP,"DF,MF",29.0,27.9,69,52,38,27,4,36,55,65.5,19,32,7,25,27,96,51,1,Matches,Atletico-Madrid,La-Liga
638,Pablo Barrios,es ESP,MF,21.0,25.9,46,26,23,20,3,23,47,48.9,24,18,5,13,34,80,33,9,Matches,Atletico-Madrid,La-Liga
639,Giuliano Simeone,ar ARG,MF,21.0,21.4,27,13,6,11,10,15,30,50.0,15,22,3,19,14,41,22,1,Matches,Atletico-Madrid,La-Liga
640,Robin Le Normand,es ESP,DF,27.0,23.9,27,18,23,4,0,12,20,60.0,8,20,9,11,10,37,120,1,Matches,Atletico-Madrid,La-Liga
641,Rodrigo De Paul,ar ARG,MF,30.0,23.4,33,26,12,16,5,14,33,42.4,19,25,2,23,6,39,15,3,Matches,Atletico-Madrid,La-Liga
642,Clément Lenglet,fr FRA,DF,29.0,21.9,27,17,19,8,0,11,15,73.3,4,24,18,6,22,49,104,1,Matches,Atletico-Madrid,La-Liga
643,Javi Galán,es ESP,DF,29.0,19.8,51,31,31,15,5,25,49,51.0,24,13,3,10,12,63,47,0,Matches,Atletico-Madrid,La-Liga
644,Samuel Lino,br BRA,"MF,DF",24.0,17.2,33,17,25,4,4,22,52,42.3,30,23,4,19,8,41,13,0,Matches,Atletico-Madrid,La-Liga
645,José María Giménez,uy URU,DF,29.0,22.2,26,16,18,8,0,17,28,60.7,11,29,19,10,27,53,115,2,Matches,Atletico-Madrid,La-Liga
646,Koke,es ESP,MF,32.0,21.4,46,23,18,22,6,21,43,48.8,22,24,2,22,20,66,29,2,Matches,Atletico-Madrid,La-Liga
647,Conor Gallagher,eng ENG,MF,24.0,18.1,45,32,16,19,10,22,49,44.9,27,23,5,18,20,65,23,0,Matches,Atletico-Madrid,La-Liga
648,Nahuel Molina,ar ARG,DF,26.0,17.7,44,19,21,21,2,31,56,55.4,25,16,3,13,13,57,53,0,Matches,Atletico-Madrid,La-Liga
649,Alexander Sørloth,no NOR,FW,28.0,17.4,9,5,2,5,2,3,6,50.0,3,6,1,5,1,10,28,0,Matches,Atletico-Madrid,La-Liga
650,Reinildo Mandava,mz MOZ,DF,30.0,10.5,18,11,10,7,1,10,18,55.6,8,11,5,6,16,34,35,0,Matches,Atletico-Madrid,La-Liga
651,César Azpilicueta,es ESP,DF,34.0,9.7,25,14,12,9,4,17,23,73.9,6,10,2,8,5,30,32,0,Matches,Atletico-Madrid,La-Liga
652,Axel Witsel,be BEL,DF,35.0,9.5,16,12,4,10,2,12,14,85.7,2,15,8,7,11,27,34,1,Matches,Atletico-Madrid,La-Liga
653,Rodrigo Riquelme,es ESP,"MF,DF",24.0,5.7,11,5,4,6,1,6,11,54.5,5,3,0,3,2,13,3,0,Matches,Atletico-Madrid,La-Liga
654,Ángel Correa,ar ARG,"FW,MF",29.0,8.9,9,3,4,1,4,5,15,33.3,10,10,0,10,4,13,8,0,Matches,Atletico-Madrid,La-Liga
655,Juan Musso,ar ARG,GK,30.0,2.0,0,0,0,0,0,0,0,,0,0,0,0,0,0,0,0,Matches,Atletico-Madrid,La-Liga
656,Thomas Lemar,fr FRA,MF,28.0,0.9,2,1,1,1,0,2,4,50.0,2,0,0,0,0,2,1,0,Matches,Atletico-Madrid,La-Liga
657,Adrian Niño,es ESP,FW,20.0,0.1,0,0,0,0,0,0,0,,0,0,0,0,0,0,0,0,Matches,Atletico-Madrid,La-Liga
658,Pedri,es ESP,MF,21.0,32.0,61,34,14,38,9,24,70,34.3,46,45,3,42,26,87,21,1,Matches,Barcelona,La-Liga
659,Raphinha,br BRA,"FW,MF",27.0,31.5,36,22,6,19,11,19,39,48.7,20,29,2,27,11,47,26,0,Matches,Barcelona,La-Liga
660,Robert Lewandowski,pl POL,FW,35.0,29.6,10,5,1,5,4,5,11,45.5,6,14,2,12,3,13,26,0,Matches,Barcelona,La-Liga
661,Lamine Yamal,es ESP,FW,17.0,31.7,42,28,8,17,17,16,38,42.1,22,12,0,12,16,58,3,0,Matches,Barcelona,La-Liga
662,Pau Cubarsí,es ESP,DF,17.0,29.1,34,23,21,10,3,19,30,63.3,11,12,9,3,16,50,86,1,Matches,Barcelona,La-Liga
663,Jules Koundé,fr FRA,DF,25.0,28.9,63,43,29,23,11,44,66,66.7,22,35,5,30,20,83,68,2,Matches,Barcelona,La-Liga
664,Iñigo Martínez,es ESP,DF,33.0,27.7,25,14,20,5,0,16,22,72.7,6,18,7,11,18,43,108,1,Matches,Barcelona,La-Liga
665,Alejandro Balde,es ESP,DF,20.0,25.4,18,10,10,5,3,11,17,64.7,6,24,5,19,5,23,27,0,Matches,Barcelona,La-Liga
666,Marc Casado,es ESP,MF,20.0,17.9,44,25,7,30,7,20,41,48.8,21,20,5,15,22,66,22,1,Matches,Barcelona,La-Liga
667,Iñaki Peña,es ESP,GK,25.0,15.5,0,0,0,0,0,0,2,0.0,2,0,0,0,0,0,20,1,Matches,Barcelona,La-Liga
668,Wojciech Szczęsny,pl POL,GK,34.0,15.0,1,1,1,0,0,0,0,,0,0,0,0,0,1,20,1,Matches,Barcelona,La-Liga
669,Eric García,es ESP,"DF,MF",23.0,17.4,38,21,11,24,3,20,29,69.0,9,24,8,16,14,52,41,0,Matches,Barcelona,La-Liga
670,Gavi,es ESP,"MF,FW",19.0,12.1,30,21,10,15,5,15,26,57.7,11,14,1,13,10,40,7,0,Matches,Barcelona,La-Liga
671,Dani Olmo,es ESP,"MF,FW",26.0,13.5,16,11,8,5,3,4,14,28.6,10,6,3,3,3,19,11,1,Matches,Barcelona,La-Liga
672,Fermin López,es ESP,"MF,FW",21.0,13.9,19,15,3,9,7,8,32,25.0,24,11,0,11,5,24,3,0,Matches,Barcelona,La-Liga
673,Ferrán Torres,es ESP,"FW,MF",24.0,12.3,8,4,2,3,3,3,8,37.5,5,7,1,6,4,12,5,0,Matches,Barcelona,La-Liga
674,Gerard Martín,es ESP,DF,22.0,11.5,22,10,10,7,5,11,16,68.8,5,16,2,14,13,35,27,0,Matches,Barcelona,La-Liga
675,Ronald Araújo,uy URU,DF,25.0,8.4,12,9,6,5,1,4,5,80.0,1,6,4,2,9,21,25,0,Matches,Barcelona,La-Liga
676,Frenkie de Jong,nl NED,MF,27.0,12.7,19,11,5,8,6,8,16,50.0,8,9,1,8,12,31,7,1,Matches,Barcelona,La-Liga
677,Marc-André ter Stegen,de GER,GK,32.0,7.5,0,0,0,0,0,0,1,0.0,1,0,0,0,0,0,2,2,Matches,Barcelona,La-Liga
678,Héctor Fort,es ESP,DF,17.0,6.5,13,8,6,4,3,10,16,62.5,6,12,0,12,6,19,16,0,Matches,Barcelona,La-Liga
679,Pablo Torre,es ESP,"MF,FW",21.0,3.4,5,4,1,3,1,2,4,50.0,2,0,0,0,3,8,5,1,Matches,Barcelona,La-Liga
680,Marc Bernal,es ESP,MF,17.0,2.7,8,6,2,5,1,7,8,87.5,1,5,1,4,1,9,4,0,Matches,Barcelona,La-Liga
681,Ansu Fati,es ESP,FW,21.0,2.6,4,1,0,2,2,1,2,50.0,1,1,0,1,1,5,0,1,Matches,Barcelona,La-Liga
682,Pau Victor,es ESP,FW,22.0,3.5,3,1,0,2,1,0,3,0.0,3,6,1,5,2,5,5,0,Matches,Barcelona,La-Liga
683,Andreas Christensen,dk DEN,DF,28.0,2.8,6,4,4,1,1,4,4,100.0,0,2,0,2,4,10,9,0,Matches,Barcelona,La-Liga
684,Sergi Dominguez,es ESP,DF,19.0,1.9,1,1,1,0,0,0,0,,0,0,0,0,3,4,7,0,Matches,Barcelona,La-Liga
685,Daniel Rodriguez,es ESP,FW,18.0,0.4,0,0,0,0,0,0,0,,0,1,0,1,0,0,0,0,Matches,Barcelona,La-Liga
686,Diego Llorente,es ESP,DF,30.0,28.0,36,20,23,12,1,25,38,65.8,13,29,20,9,43,79,154,1,Matches,Real-Betis,La-Liga
687,Johnny Cardoso,us USA,MF,22.0,23.8,55,31,12,35,8,20,52,38.5,32,27,12,15,48,103,64,1,Matches,Real-Betis,La-Liga
688,Natan,br BRA,DF,23.0,24.2,35,24,24,9,2,26,30,86.7,4,24,14,10,28,63,123,2,Matches,Real-Betis,La-Liga
689,Marc Bartra,es ESP,DF,33.0,23.3,33,19,20,13,0,15,26,57.7,11,41,25,16,33,66,148,0,Matches,Real-Betis,La-Liga
690,Abde Ezzalzouli,ma MAR,"FW,MF",22.0,22.0,37,25,17,16,4,15,27,55.6,12,22,3,19,7,44,19,0,Matches,Real-Betis,La-Liga
691,Romain Perraud,fr FRA,DF,26.0,22.2,36,22,15,16,5,21,46,45.7,25,18,4,14,22,58,71,1,Matches,Real-Betis,La-Liga
692,Sergi Altimira,es ESP,MF,22.0,21.9,61,37,17,38,6,36,60,60.0,24,28,1,27,24,85,43,3,Matches,Real-Betis,La-Liga
693,Pablo Fornals,es ESP,"MF,FW",28.0,20.3,21,13,12,6,3,10,30,33.3,20,24,4,20,23,44,15,1,Matches,Real-Betis,La-Liga
694,Youssouf Sabaly,sn SEN,DF,31.0,17.6,40,25,21,15,4,24,32,75.0,8,21,4,17,13,53,40,0,Matches,Real-Betis,La-Liga
695,Adrián,es ESP,GK,37.0,19.0,0,0,0,0,0,0,3,0.0,3,0,0,0,0,0,14,3,Matches,Real-Betis,La-Liga
696,Isco,es ESP,MF,32.0,17.2,20,13,3,13,4,7,28,25.0,21,10,0,10,11,31,7,0,Matches,Real-Betis,La-Liga
697,Giovani Lo Celso,ar ARG,"MF,FW",28.0,16.2,34,22,8,17,9,17,25,68.0,8,14,2,12,5,39,3,1,Matches,Real-Betis,La-Liga
698,Antony,br BRA,FW,24.0,15.1,25,11,6,9,10,8,22,36.4,14,12,1,11,10,35,9,1,Matches,Real-Betis,La-Liga
699,Rui Silva,pt POR,GK,30.0,15.0,0,0,0,0,0,0,1,0.0,1,1,0,1,0,0,7,0,Matches,Real-Betis,La-Liga
700,Ricardo Rodríguez,ch SUI,DF,31.0,14.2,28,15,16,5,7,17,26,65.4,9,10,1,9,8,36,51,0,Matches,Real-Betis,La-Liga
701,Jesus Rodríguez,es ESP,FW,18.0,12.3,16,14,6,6,4,5,18,27.8,13,16,0,16,6,22,3,0,Matches,Real-Betis,La-Liga
702,Vitor Roque,br BRA,FW,19.0,13.7,11,6,1,6,4,1,5,20.0,4,5,0,5,7,18,4,0,Matches,Real-Betis,La-Liga
703,Cucho,co COL,FW,25.0,12.7,15,10,2,5,8,6,11,54.5,5,13,1,12,7,22,4,0,Matches,Real-Betis,La-Liga
704,Aitor Ruibal,es ESP,"DF,FW",28.0,14.6,32,23,22,4,6,25,47,53.2,22,20,5,15,14,46,40,1,Matches,Real-Betis,La-Liga
705,Marc Roca,es ESP,MF,27.0,10.1,20,14,10,9,1,9,17,52.9,8,17,5,12,14,34,14,2,Matches,Real-Betis,La-Liga
706,Cédric Bakambu,cd COD,FW,33.0,7.9,6,4,0,5,1,3,7,42.9,4,13,2,11,0,6,5,0,Matches,Real-Betis,La-Liga
707,Ezequiel Ávila,ar ARG,FW,30.0,7.5,8,3,2,2,4,4,10,40.0,6,4,0,4,2,10,8,0,Matches,Real-Betis,La-Liga
708,Héctor Bellerín,es ESP,DF,29.0,6.4,13,7,7,4,2,10,17,58.8,7,5,3,2,6,19,21,0,Matches,Real-Betis,La-Liga
709,William Carvalho,pt POR,MF,32.0,5.4,9,6,3,6,0,4,6,66.7,2,6,2,4,3,12,6,0,Matches,Real-Betis,La-Liga
710,Fran Vieites,es ESP,GK,25.0,4.0,0,0,0,0,0,0,0,,0,0,0,0,0,0,1,0,Matches,Real-Betis,La-Liga
711,Ángel Ortíz,es ESP,DF,20.0,3.9,12,8,8,3,1,8,17,47.1,9,6,0,6,5,17,7,0,Matches,Real-Betis,La-Liga
712,Iker Losada,es ESP,"MF,FW",22.0,3.7,10,7,2,4,4,5,10,50.0,5,2,0,2,3,13,2,0,Matches,Real-Betis,La-Liga
713,Assane Diao,sn SEN,FW,18.0,3.1,5,3,1,3,1,4,9,44.4,5,3,0,3,0,5,3,0,Matches,Real-Betis,La-Liga
714,Juanmi,es ESP,"FW,MF",31.0,2.7,7,4,3,3,1,4,6,66.7,2,4,0,4,1,8,4,0,Matches,Real-Betis,La-Liga
715,Nabil Fekir,fr FRA,MF,31.0,2.0,3,2,1,1,1,1,2,50.0,1,2,0,2,0,3,0,0,Matches,Real-Betis,La-Liga
716,Carlos Guirao,es ESP,MF,21.0,1.2,5,3,1,4,0,4,6,66.7,2,1,1,0,3,8,2,0,Matches,Real-Betis,La-Liga
717,Mateo Flores,es ESP,MF,20.0,1.7,3,1,3,0,0,1,1,100.0,0,1,0,1,2,5,3,0,Matches,Real-Betis,La-Liga
718,Rodri,es ESP,FW,24.0,1.3,2,1,1,1,0,1,2,50.0,1,2,1,1,1,3,1,1,Matches,Real-Betis,La-Liga
719,Nobel Mendy,fr FRA,DF,19.0,1.2,0,0,0,0,0,0,0,,0,2,0,2,4,4,10,1,Matches,Real-Betis,La-Liga
720,Sergio Arribas,es ESP,DF,21.0,1.0,7,4,4,3,0,6,7,85.7,1,2,2,0,3,10,4,0,Matches,Real-Betis,La-Liga
721,Pablo Garcia,es ESP,FW,17.0,0.4,0,0,0,0,0,0,0,,0,1,0,1,0,0,0,0,Matches,Real-Betis,La-Liga
722,Vicente Guaita,es ESP,GK,37.0,34.0,0,0,0,0,0,0,0,,0,0,0,0,0,0,21,3,Matches,Celta-Vigo,La-Liga
723,Óscar Mingueza,es ESP,"MF,DF",25.0,30.3,38,24,21,12,5,26,69,37.7,43,35,5,30,22,60,46,7,Matches,Celta-Vigo,La-Liga
724,Marcos Alonso,es ESP,DF,33.0,29.4,35,21,19,13,3,25,44,56.8,19,22,7,15,34,69,126,4,Matches,Celta-Vigo,La-Liga
725,Fran Beltrán,es ESP,MF,25.0,26.9,50,35,24,21,5,24,56,42.9,32,26,6,20,26,76,34,4,Matches,Celta-Vigo,La-Liga
726,Javi Rodríguez,es ESP,DF,21.0,27.9,53,38,35,17,1,33,47,70.2,14,29,10,19,33,86,96,2,Matches,Celta-Vigo,La-Liga
727,Carl Starfelt,se SWE,DF,29.0,25.2,40,20,25,14,1,18,27,66.7,9,29,21,8,31,71,129,3,Matches,Celta-Vigo,La-Liga
728,Borja Iglesias,es ESP,FW,31.0,21.7,10,9,2,5,3,4,15,26.7,11,9,2,7,7,17,10,0,Matches,Celta-Vigo,La-Liga
729,Ilaix Moriba,gn GUI,MF,21.0,23.7,68,42,24,30,14,32,57,56.1,25,29,4,25,14,82,33,1,Matches,Celta-Vigo,La-Liga
730,Iago Aspas,es ESP,"FW,MF",36.0,19.4,13,8,4,5,4,8,20,40.0,12,18,1,17,8,21,5,0,Matches,Celta-Vigo,La-Liga
731,Sergio Carreira,es ESP,"MF,DF",23.0,18.4,28,16,16,6,6,14,26,53.8,12,20,2,18,17,45,37,0,Matches,Celta-Vigo,La-Liga
732,Hugo Álvarez,es ESP,"MF,DF",21.0,17.5,26,9,12,10,4,10,19,52.6,9,19,2,17,8,34,29,1,Matches,Celta-Vigo,La-Liga
733,Pablo Durán,es ESP,"FW,MF",23.0,15.5,17,9,4,7,6,5,16,31.3,11,12,3,9,8,25,18,0,Matches,Celta-Vigo,La-Liga
734,Williot Swedberg,se SWE,"FW,MF",20.0,15.0,23,16,9,10,4,13,20,65.0,7,12,1,11,3,26,10,1,Matches,Celta-Vigo,La-Liga
735,Hugo Sotelo,es ESP,MF,20.0,13.9,28,17,8,10,10,13,31,41.9,18,9,1,8,5,33,9,1,Matches,Celta-Vigo,La-Liga
736,Alfon,es ESP,"FW,MF",25.0,15.2,8,3,3,2,3,4,12,33.3,8,8,0,8,5,13,5,1,Matches,Celta-Vigo,La-Liga
737,Carlos Dominguez,es ESP,DF,23.0,13.1,23,11,14,9,0,15,21,71.4,6,16,11,5,13,36,80,1,Matches,Celta-Vigo,La-Liga
738,Damián Rodríguez,es ESP,MF,21.0,10.3,14,9,3,10,1,6,16,37.5,10,6,1,5,7,21,13,0,Matches,Celta-Vigo,La-Liga
739,Jonathan Bamba,ci CIV,"FW,MF",28.0,9.0,12,7,4,6,2,5,12,41.7,7,6,0,6,5,17,6,0,Matches,Celta-Vigo,La-Liga
740,Fer López,,"FW,MF",,7.5,9,5,1,6,2,2,13,15.4,11,10,0,10,2,11,7,0,Matches,Celta-Vigo,La-Liga
741,Yoel Lago,es ESP,DF,20.0,6.5,12,8,8,3,1,7,9,77.8,2,5,4,1,4,16,30,0,Matches,Celta-Vigo,La-Liga
742,Javier Manquillo,es ESP,DF,30.0,5.7,7,5,4,3,0,2,10,20.0,8,5,3,2,7,14,14,0,Matches,Celta-Vigo,La-Liga
743,Anastasios Douvikas,gr GRE,FW,24.0,7.8,9,4,2,6,1,3,6,50.0,3,5,2,3,3,12,6,0,Matches,Celta-Vigo,La-Liga
744,Jailson Siqueira,br BRA,"DF,MF",28.0,6.8,13,11,9,3,1,9,11,81.8,2,6,4,2,9,22,28,1,Matches,Celta-Vigo,La-Liga
745,Mihailo Ristić,rs SRB,"DF,MF",28.0,4.8,7,7,4,2,1,4,6,66.7,2,1,0,1,2,9,18,0,Matches,Celta-Vigo,La-Liga
746,Iván Villar,es ESP,GK,27.0,4.0,0,0,0,0,0,0,0,,0,0,0,0,0,0,3,0,Matches,Celta-Vigo,La-Liga
747,Iker Losada,es ESP,"FW,MF",22.0,4.0,3,3,0,1,2,1,5,20.0,4,4,1,3,1,4,8,0,Matches,Celta-Vigo,La-Liga
748,Franco Cervi,ar ARG,"FW,MF",30.0,3.0,8,3,2,6,0,3,8,37.5,5,4,0,4,8,16,7,0,Matches,Celta-Vigo,La-Liga
749,Luca de la Torre,us USA,MF,26.0,0.0,0,0,0,0,0,0,0,,0,0,0,0,0,0,0,0,Matches,Celta-Vigo,La-Liga
750,Joseph Aidoo,gh GHA,DF,28.0,0.0,1,0,1,0,0,0,0,,0,0,0,0,0,1,0,0,Matches,Celta-Vigo,La-Liga
751,Tadeo Allende,ar ARG,FW,25.0,0.0,0,0,0,0,0,0,0,,0,0,0,0,0,0,0,0,Matches,Celta-Vigo,La-Liga
752,Joan García,es ESP,GK,23.0,38.0,0,0,0,0,0,0,1,0.0,1,1,0,1,0,0,18,4,Matches,Espanyol,La-Liga
753,Omar El Hilali,ma MAR,DF,20.0,35.0,111,79,81,24,6,64,95,67.4,31,53,13,40,46,157,145,2,Matches,Espanyol,La-Liga
754,Javi Puado,es ESP,"FW,MF",26.0,33.0,22,17,14,4,4,8,20,40.0,12,18,3,15,5,27,19,0,Matches,Espanyol,La-Liga
755,Marash Kumbulla,al ALB,DF,24.0,33.0,51,26,35,14,2,24,41,58.5,17,48,35,13,34,85,224,2,Matches,Espanyol,La-Liga
756,Leandro Cabrera,uy URU,DF,33.0,31.9,40,23,29,8,3,19,33,57.6,14,35,25,10,30,70,199,2,Matches,Espanyol,La-Liga
757,Alex Král,cz CZE,MF,26.0,30.2,55,37,28,24,3,16,30,53.3,14,34,14,20,28,83,51,2,Matches,Espanyol,La-Liga
758,Carlos Romero,es ESP,DF,22.0,28.4,73,47,49,16,8,45,82,54.9,37,50,15,35,30,103,102,1,Matches,Espanyol,La-Liga
759,Pol Lozano,es ESP,MF,24.0,21.6,53,34,23,25,5,25,58,43.1,33,32,6,26,22,75,31,0,Matches,Espanyol,La-Liga
760,Jofre,es ESP,"MF,FW",23.0,24.1,22,16,14,5,3,13,23,56.5,10,13,0,13,15,37,29,0,Matches,Espanyol,La-Liga
761,Roberto Férnandez,es ESP,FW,22.0,16.6,4,4,2,1,1,0,5,0.0,5,9,1,8,3,7,26,0,Matches,Espanyol,La-Liga
762,Urko González,es ESP,MF,23.0,15.3,46,28,24,21,1,28,44,63.6,16,27,12,15,8,54,39,1,Matches,Espanyol,La-Liga
763,Álvaro Tejero,es ESP,"MF,DF",28.0,13.8,14,4,7,6,1,7,23,30.4,16,9,1,8,13,27,34,1,Matches,Espanyol,La-Liga
764,Antoniu,es ESP,"FW,MF",21.0,11.4,21,10,9,8,4,9,21,42.9,12,14,2,12,8,29,11,1,Matches,Espanyol,La-Liga
765,Edu Expósito,es ESP,MF,27.0,11.6,23,13,9,13,1,9,23,39.1,14,3,0,3,15,38,21,2,Matches,Espanyol,La-Liga
766,Brian Oliván,es ESP,DF,30.0,11.3,13,10,7,6,0,4,13,30.8,9,6,2,4,10,23,23,0,Matches,Espanyol,La-Liga
767,Alejo Véliz,ar ARG,FW,20.0,12.5,1,1,0,1,0,1,7,14.3,6,12,2,10,4,5,23,1,Matches,Espanyol,La-Liga
768,José Gragera,es ESP,MF,23.0,6.3,25,16,11,14,0,9,17,52.9,8,9,1,8,5,30,13,0,Matches,Espanyol,La-Liga
769,Fernando Calero,es ESP,"DF,MF",28.0,7.9,18,10,13,4,1,8,12,66.7,4,16,9,7,16,34,50,1,Matches,Espanyol,La-Liga
770,Sergi Gómez,es ESP,DF,32.0,7.4,8,5,7,1,0,2,3,66.7,1,12,8,4,7,15,38,0,Matches,Espanyol,La-Liga
771,Walid Cheddira,ma MAR,FW,26.0,7.1,5,0,1,1,3,0,1,0.0,1,4,0,4,1,6,6,0,Matches,Espanyol,La-Liga
772,Irvin Cardona,fr FRA,"FW,MF",26.0,6.7,8,5,2,4,2,6,16,37.5,10,5,1,4,4,12,10,0,Matches,Espanyol,La-Liga
773,Álvaro Aguado,es ESP,MF,28.0,4.9,5,2,3,2,0,3,9,33.3,6,7,1,6,4,9,5,1,Matches,Espanyol,La-Liga
774,Justin Smith,ca CAN,MF,21.0,2.3,9,3,3,6,0,4,6,66.7,2,5,1,4,4,13,3,0,Matches,Espanyol,La-Liga
775,Rafael Bauza,es ESP,MF,19.0,2.0,5,3,3,1,1,4,7,57.1,3,3,1,2,0,5,5,0,Matches,Espanyol,La-Liga
776,Pere Milla,es ESP,"MF,FW",31.0,5.1,6,2,5,0,1,1,18,5.6,17,10,2,8,3,9,5,0,Matches,Espanyol,La-Liga
777,Naci Ünüvar,nl NED,"MF,DF",21.0,0.3,2,2,1,1,0,1,2,50.0,1,0,0,0,0,2,0,0,Matches,Espanyol,La-Liga
778,Roger Hinojo,es ESP,DF,19.0,0.1,0,0,0,0,0,0,0,,0,0,0,0,0,0,1,0,Matches,Espanyol,La-Liga
779,David Soria,es ESP,GK,31.0,38.0,4,4,4,0,0,4,5,80.0,1,0,0,0,1,5,21,3,Matches,Getafe,La-Liga
780,Omar Alderete,py PAR,DF,27.0,33.0,43,29,30,11,2,20,30,66.7,10,38,22,16,40,83,241,1,Matches,Getafe,La-Liga
781,Iglesias,es ESP,DF,26.0,32.1,81,47,42,33,6,46,90,51.1,44,47,8,39,50,131,133,1,Matches,Getafe,La-Liga
782,Luis Milla,es ESP,MF,29.0,31.9,61,40,28,25,8,35,72,48.6,37,25,0,25,24,85,28,3,Matches,Getafe,La-Liga
783,Diego Rico,es ESP,DF,31.0,31.3,81,49,47,29,5,47,85,55.3,38,41,3,38,34,115,102,2,Matches,Getafe,La-Liga
784,Mauro Arambarri,uy URU,MF,28.0,29.6,48,29,10,33,5,22,48,45.8,26,35,6,29,15,63,46,0,Matches,Getafe,La-Liga
785,Djené,tg TOG,"DF,MF",32.0,28.3,25,13,12,11,2,12,32,37.5,20,18,8,10,21,46,107,3,Matches,Getafe,La-Liga
786,Christantus Uche,ng NGA,"FW,MF",21.0,27.6,35,21,8,19,8,9,20,45.0,11,20,2,18,10,45,19,0,Matches,Getafe,La-Liga
787,Domingos Duarte,pt POR,DF,29.0,20.7,28,15,22,4,2,17,21,81.0,4,28,16,12,18,46,152,1,Matches,Getafe,La-Liga
788,Carles Pérez,es ESP,"MF,FW",26.0,15.9,33,23,11,14,8,21,48,43.8,27,19,2,17,6,39,22,0,Matches,Getafe,La-Liga
789,Ramón Terrats,es ESP,"MF,FW",23.0,13.5,20,10,7,8,5,8,28,28.6,20,9,2,7,8,28,16,0,Matches,Getafe,La-Liga
790,Bertuğ Yıldırım,tr TUR,FW,22.0,12.0,10,5,0,7,3,2,7,28.6,5,13,2,11,1,11,16,0,Matches,Getafe,La-Liga
791,Alex Sola,es ESP,"MF,FW",25.0,11.4,21,14,9,12,0,9,25,36.0,16,8,0,8,7,28,11,1,Matches,Getafe,La-Liga
792,Coba da Costa,es ESP,"MF,FW",22.0,11.2,29,13,9,16,4,13,26,50.0,13,24,0,24,8,37,10,0,Matches,Getafe,La-Liga
793,Juan Berrocal,es ESP,DF,25.0,11.8,14,7,10,4,0,10,14,71.4,4,6,3,3,15,29,59,0,Matches,Getafe,La-Liga
794,Allan Nyom,cm CMR,"DF,MF",36.0,9.9,18,11,7,9,2,15,17,88.2,2,4,2,2,4,22,23,0,Matches,Getafe,La-Liga
795,Juan Bernat,es ESP,"MF,DF",31.0,7.8,19,13,9,5,5,7,12,58.3,5,9,3,6,2,21,12,0,Matches,Getafe,La-Liga
796,Juanmi,es ESP,"FW,MF",31.0,7.7,14,11,4,7,3,6,19,31.6,13,6,0,6,2,16,3,0,Matches,Getafe,La-Liga
797,Borja Mayoral,es ESP,FW,27.0,12.4,5,4,2,2,1,3,9,33.3,6,4,0,4,2,7,6,0,Matches,Getafe,La-Liga
798,Álvaro Rodríguez,uy URU,FW,20.0,9.5,10,7,0,7,3,5,10,50.0,5,23,0,23,3,13,12,0,Matches,Getafe,La-Liga
799,Carles Aleñá,es ESP,"MF,FW",26.0,5.0,6,3,2,3,1,4,13,30.8,9,9,1,8,0,6,7,0,Matches,Getafe,La-Liga
800,Yellu Santiago,es ESP,MF,20.0,4.1,14,8,6,8,0,5,10,50.0,5,6,2,4,1,15,3,0,Matches,Getafe,La-Liga
801,Nabil Aberdin,fr FRA,MF,21.0,2.9,6,4,3,3,0,1,1,100.0,0,3,0,3,0,6,5,0,Matches,Getafe,La-Liga
802,Peter González,do DOM,"MF,FW",22.0,5.3,11,6,2,5,4,6,9,66.7,3,8,0,8,2,13,5,0,Matches,Getafe,La-Liga
803,Abdoulaye Keita,es ESP,"FW,MF",21.0,1.1,2,2,0,1,1,2,4,50.0,2,1,0,1,0,2,3,0,Matches,Getafe,La-Liga
804,Ismael Bekhoucha,ma MAR,"MF,DF",19.0,0.8,1,1,1,0,0,1,2,50.0,1,2,1,1,2,3,2,0,Matches,Getafe,La-Liga
805,Alberto Risco,es ESP,"MF,FW",18.0,0.8,4,4,2,0,2,1,6,16.7,5,2,0,2,0,4,0,0,Matches,Getafe,La-Liga
806,John Joe,ie IRL,"MF,FW",20.0,0.5,0,0,0,0,0,0,0,,0,1,1,0,0,0,1,0,Matches,Getafe,La-Liga
807,Gorka Rivera Alonso,es ESP,"DF,MF",19.0,0.2,2,0,0,2,0,2,2,100.0,0,0,0,0,0,2,0,0,Matches,Getafe,La-Liga
808,David Argüelles,es ESP,MF,22.0,0.1,0,0,0,0,0,0,0,,0,2,0,2,0,0,0,0,Matches,Getafe,La-Liga
809,Paulo Gazzaniga,ar ARG,GK,32.0,35.5,1,1,1,0,0,1,1,100.0,0,1,0,1,0,1,17,3,Matches,Girona,La-Liga
810,Daley Blind,nl NED,DF,34.0,30.9,49,27,26,19,4,31,48,64.6,17,32,9,23,32,81,94,2,Matches,Girona,La-Liga
811,Arnau Martinez,es ESP,"DF,MF",21.0,29.2,51,28,30,15,6,32,63,50.8,31,18,6,12,31,82,76,2,Matches,Girona,La-Liga
812,Miguel Gutiérrez,es ESP,"DF,MF",23.0,27.3,37,24,18,16,3,17,37,45.9,20,17,7,10,16,53,34,3,Matches,Girona,La-Liga
813,Ladislav Krejčí,cz CZE,DF,25.0,27.1,23,16,19,4,0,14,26,53.8,12,24,19,5,34,57,93,5,Matches,Girona,La-Liga
814,David López,es ESP,DF,34.0,27.0,32,24,22,7,3,18,31,58.1,13,22,12,10,14,46,111,2,Matches,Girona,La-Liga
815,Yangel Herrera,ve VEN,MF,26.0,25.1,66,39,31,27,8,30,59,50.8,29,24,8,16,31,97,50,2,Matches,Girona,La-Liga
816,Iván Martín,es ESP,MF,25.0,22.7,32,19,14,14,4,15,34,44.1,19,20,6,14,11,43,15,1,Matches,Girona,La-Liga
817,Viktor Tsyhankov,ua UKR,"FW,MF",26.0,21.3,19,12,4,7,8,9,19,47.4,10,7,1,6,15,34,16,1,Matches,Girona,La-Liga
818,Bryan Gil,es ESP,"FW,MF",23.0,19.1,34,20,10,15,9,14,30,46.7,16,24,0,24,10,44,9,4,Matches,Girona,La-Liga
819,Oriol Romeu,es ESP,MF,32.0,15.1,38,25,14,19,5,14,26,53.8,12,22,8,14,12,50,20,4,Matches,Girona,La-Liga
820,Abel Ruiz,es ESP,FW,24.0,15.0,6,2,2,2,2,2,5,40.0,3,7,2,5,5,11,7,0,Matches,Girona,La-Liga
821,Donny van de Beek,nl NED,MF,27.0,15.8,29,18,17,7,5,13,26,50.0,13,19,3,16,10,39,12,0,Matches,Girona,La-Liga
822,Yaser Asprilla,co COL,"FW,MF",20.0,15.6,22,12,6,8,8,8,23,34.8,15,14,0,14,7,29,7,1,Matches,Girona,La-Liga
823,Arnaut Danjuma,nl NED,"FW,MF",27.0,14.8,8,6,3,3,2,2,7,28.6,5,5,1,4,2,10,4,0,Matches,Girona,La-Liga
824,Alejandro Francés,es ESP,DF,21.0,13.0,36,24,22,13,1,28,40,70.0,12,17,8,9,17,53,52,0,Matches,Girona,La-Liga
825,Bojan Miovski,mk MKD,FW,25.0,9.7,7,5,2,2,3,2,7,28.6,5,4,0,4,2,9,7,0,Matches,Girona,La-Liga
826,Arthur Melo,br BRA,MF,27.0,10.5,25,11,8,12,5,14,27,51.9,13,5,1,4,8,33,12,1,Matches,Girona,La-Liga
827,Juanpe,es ESP,DF,33.0,8.1,8,5,5,3,0,6,8,75.0,2,15,10,5,8,16,56,1,Matches,Girona,La-Liga
828,Cristhian Stuani,uy URU,FW,37.0,12.0,9,7,1,7,1,5,8,62.5,3,4,1,3,7,16,11,0,Matches,Girona,La-Liga
829,Portu,es ESP,"FW,MF",32.0,8.7,13,7,5,5,3,7,10,70.0,3,8,0,8,0,13,2,0,Matches,Girona,La-Liga
830,Jhon Solis,co COL,MF,19.0,5.9,13,7,3,9,1,6,14,42.9,8,13,1,12,4,17,6,1,Matches,Girona,La-Liga
831,Krapyvtsov Vladyslav,ua UKR,GK,19.0,2.0,0,0,0,0,0,0,0,,0,0,0,0,0,0,1,1,Matches,Girona,La-Liga
832,Silvi Clúa,es ESP,MF,19.0,1.8,8,7,4,3,1,4,6,66.7,2,1,0,1,2,10,6,0,Matches,Girona,La-Liga
833,Gabriel Osei Misehouy,nl NED,"FW,MF",19.0,2.9,1,1,0,1,0,0,1,0.0,1,0,0,0,0,1,0,0,Matches,Girona,La-Liga
834,Iker Almena,es ESP,"FW,DF",20.0,0.5,0,0,0,0,0,0,1,0.0,1,1,0,1,0,0,2,0,Matches,Girona,La-Liga
835,Papa Ba,es ESP,MF,19.0,0.5,1,1,1,0,0,0,0,,0,1,0,1,0,1,1,0,Matches,Girona,La-Liga
836,Pau López,es ESP,GK,29.0,0.5,0,0,0,0,0,0,0,,0,0,0,0,0,0,1,0,Matches,Girona,La-Liga
837,Kim Minsu,kr KOR,"MF,FW",18.0,0.2,1,0,0,1,0,0,0,,0,0,0,0,0,1,0,0,Matches,Girona,La-Liga
838,Ferrán Ruiz,es ESP,MF,21.0,0.2,0,0,0,0,0,0,0,,0,2,1,1,1,1,0,0,Matches,Girona,La-Liga
839,Alberto Moleiro,es ESP,"FW,MF",20.0,30.2,27,12,12,14,1,18,48,37.5,30,24,0,24,18,45,8,0,Matches,Las-Palmas,La-Liga
840,Álex Suárez,es ESP,DF,31.0,27.3,40,23,30,9,1,20,27,74.1,7,39,24,15,13,53,107,2,Matches,Las-Palmas,La-Liga
841,Javier Muñoz,es ESP,"MF,DF",29.0,28.8,45,35,18,17,10,16,46,34.8,30,27,4,23,31,76,39,3,Matches,Las-Palmas,La-Liga
842,Scott McKenna,sct SCO,DF,27.0,27.4,21,13,16,5,0,9,12,75.0,3,36,28,8,9,30,163,2,Matches,Las-Palmas,La-Liga
843,Mika Mármol,es ESP,DF,23.0,26.7,61,29,35,24,2,34,52,65.4,18,46,14,32,38,99,121,2,Matches,Las-Palmas,La-Liga
844,Jasper Cillessen,nl NED,GK,35.0,25.9,1,0,1,0,0,1,4,25.0,3,0,0,0,0,1,11,2,Matches,Las-Palmas,La-Liga
845,Sandro Ramírez,es ESP,"FW,MF",29.0,22.6,27,15,10,13,4,13,30,43.3,17,20,0,20,16,43,22,2,Matches,Las-Palmas,La-Liga
846,Dario Essugo,pt POR,MF,19.0,21.5,59,45,28,26,5,28,46,60.9,18,28,11,17,42,101,47,7,Matches,Las-Palmas,La-Liga
847,Viti,es ESP,DF,26.0,22.0,71,46,43,21,7,31,45,68.9,14,28,7,21,27,98,61,0,Matches,Las-Palmas,La-Liga
848,Fábio Silva,pt POR,FW,22.0,20.7,12,7,4,5,3,4,14,28.6,10,12,0,12,4,16,27,0,Matches,Las-Palmas,La-Liga
849,Kirian Rodríguez,es ESP,MF,28.0,19.5,33,17,12,18,3,22,43,51.2,21,22,4,18,10,43,21,0,Matches,Las-Palmas,La-Liga
850,Oliver McBurnie,sct SCO,FW,28.0,20.4,15,7,5,8,2,5,12,41.7,7,15,5,10,6,21,24,0,Matches,Las-Palmas,La-Liga
851,Álex Muñoz,es ESP,DF,30.0,15.7,39,29,22,16,1,21,38,55.3,17,28,11,17,16,55,69,0,Matches,Las-Palmas,La-Liga
852,Juan Herzog,es ESP,DF,21.0,14.6,12,12,12,0,0,9,16,56.3,7,17,11,6,18,30,86,0,Matches,Las-Palmas,La-Liga
853,José Campaña,es ESP,MF,31.0,13.2,21,16,8,11,2,11,20,55.0,9,9,1,8,19,40,19,2,Matches,Las-Palmas,La-Liga
854,Stefan Bajcetic,es ESP,"MF,DF",19.0,10.8,29,14,13,13,3,12,28,42.9,16,25,4,21,15,44,26,1,Matches,Las-Palmas,La-Liga
855,Dinko Horkaš,hr CRO,GK,25.0,12.1,0,0,0,0,0,0,0,,0,0,0,0,0,0,9,1,Matches,Las-Palmas,La-Liga
856,Marvin,es ESP,"DF,FW",24.0,11.5,25,13,12,9,4,11,26,42.3,15,17,6,11,15,40,34,0,Matches,Las-Palmas,La-Liga
857,Manuel Fuster,es ESP,"FW,MF",26.0,11.1,19,11,5,8,6,15,28,53.6,13,13,3,10,4,23,17,0,Matches,Las-Palmas,La-Liga
858,Enzo Loiodice,fr FRA,MF,23.0,7.6,17,7,8,9,0,3,10,30.0,7,4,1,3,10,27,7,2,Matches,Las-Palmas,La-Liga
859,Adnan Januzaj,be BEL,"MF,FW",29.0,6.6,10,6,1,6,3,5,9,55.6,4,6,0,6,2,12,3,0,Matches,Las-Palmas,La-Liga
860,Jaime Mata,es ESP,"FW,MF",35.0,7.3,8,2,2,6,0,3,9,33.3,6,5,1,4,3,11,11,0,Matches,Las-Palmas,La-Liga
861,Benito Ramírez,es ESP,"DF,FW",29.0,5.3,10,5,4,6,0,9,16,56.3,7,8,3,5,1,11,14,1,Matches,Las-Palmas,La-Liga
862,Andy Pelmard,fr FRA,DF,24.0,2.3,5,0,3,2,0,4,5,80.0,1,3,1,2,2,7,20,0,Matches,Las-Palmas,La-Liga
863,Sergio Viera,es ESP,MF,19.0,1.1,1,1,0,1,0,0,1,0.0,1,1,0,1,1,2,1,0,Matches,Las-Palmas,La-Liga
864,Daley Sinkgraven,nl NED,DF,29.0,1.0,5,1,3,2,0,1,3,33.3,2,1,0,1,1,6,2,0,Matches,Las-Palmas,La-Liga
865,Marc Cardona,es ESP,"FW,DF",29.0,1.5,4,2,1,3,0,0,1,0.0,1,0,0,0,0,4,0,0,Matches,Las-Palmas,La-Liga
866,Fabio González,es ESP,MF,27.0,0.6,0,0,0,0,0,0,1,0.0,1,0,0,0,0,0,0,0,Matches,Las-Palmas,La-Liga
867,Diego Martín,es ESP,FW,20.0,0.4,1,1,0,0,1,1,1,100.0,0,0,0,0,0,1,1,0,Matches,Las-Palmas,La-Liga
868,Arturo Rodríguez,es ESP,FW,17.0,0.2,0,0,0,0,0,0,0,,0,0,0,0,0,0,0,0,Matches,Las-Palmas,La-Liga
869,Pejiño,es ESP,FW,28.0,0.2,1,1,0,1,0,1,1,100.0,0,0,0,0,0,1,0,0,Matches,Las-Palmas,La-Liga
870,José Carlos González,es ESP,DF,18.0,0.1,0,0,0,0,0,0,0,,0,0,0,0,0,0,0,0,Matches,Las-Palmas,La-Liga
871,Valentín Pezzolesi,es ESP,DF,17.0,0.1,0,0,0,0,0,0,0,,0,0,0,0,0,0,1,1,Matches,Las-Palmas,La-Liga
872,Aboubacar Bassinga,ci CIV,MF,19.0,0.0,0,0,0,0,0,0,0,,0,0,0,0,0,0,0,0,Matches,Las-Palmas,La-Liga
873,Sergi,es ESP,DF,32.0,32.9,40,29,22,16,2,18,32,56.3,14,38,29,9,39,79,185,2,Matches,Leganes,La-Liga
874,Marko Dmitrović,rs SRB,GK,32.0,32.0,1,1,1,0,0,1,2,50.0,1,0,0,0,0,1,27,3,Matches,Leganes,La-Liga
875,Seydouba Cissé,gn GUI,MF,23.0,27.1,59,37,18,27,14,23,50,46.0,27,25,1,24,12,71,45,1,Matches,Leganes,La-Liga
876,Valentin Rosier,fr FRA,DF,27.0,28.8,72,52,48,16,8,43,68,63.2,25,40,15,25,52,124,149,2,Matches,Leganes,La-Liga
877,Renato Tapia,pe PER,"MF,DF",29.0,26.9,61,35,30,27,4,24,50,48.0,26,58,23,35,27,88,86,2,Matches,Leganes,La-Liga
878,Javi Hernández,es ESP,DF,26.0,26.5,26,15,16,7,3,17,46,37.0,29,25,5,20,23,49,98,0,Matches,Leganes,La-Liga
879,Yvan Neyou,cm CMR,MF,27.0,25.7,53,33,21,26,6,22,47,46.8,25,35,5,30,26,79,38,1,Matches,Leganes,La-Liga
880,Juan Cruz,es ESP,"FW,MF",24.0,25.1,32,19,14,16,2,17,35,48.6,18,18,2,16,13,45,31,0,Matches,Leganes,La-Liga
881,Matija Nastasić,rs SRB,DF,31.0,23.4,25,11,21,4,0,17,25,68.0,8,39,30,9,21,46,165,0,Matches,Leganes,La-Liga
882,Dani Raba,es ESP,"FW,MF",28.0,20.9,37,23,17,15,5,17,42,40.5,25,27,3,24,14,51,19,1,Matches,Leganes,La-Liga
883,Jorge Sáenz,es ESP,DF,27.0,18.8,37,23,18,18,1,11,20,55.0,9,26,17,9,25,62,161,0,Matches,Leganes,La-Liga
884,Adrià Altimira,es ESP,"DF,FW",23.0,18.1,41,24,26,12,3,24,40,60.0,16,15,6,9,15,56,54,2,Matches,Leganes,La-Liga
885,Miguel,es ESP,FW,24.0,19.2,16,7,6,4,6,4,14,28.6,10,15,4,11,4,20,23,1,Matches,Leganes,La-Liga
886,Darko Brašanac,rs SRB,MF,32.0,18.0,26,11,5,15,6,9,17,52.9,8,24,11,13,16,42,34,0,Matches,Leganes,La-Liga
887,Diego,es ESP,FW,24.0,13.3,1,1,0,0,1,1,7,14.3,6,4,1,3,2,3,11,0,Matches,Leganes,La-Liga
888,Óscar Rodríguez Arnaiz,es ESP,"MF,FW",26.0,14.8,32,17,10,16,6,14,32,43.8,18,10,1,9,20,52,20,0,Matches,Leganes,La-Liga
889,Munir El Haddadi,ma MAR,"FW,MF",28.0,9.6,12,9,5,4,3,3,12,25.0,9,8,1,7,1,13,1,1,Matches,Leganes,La-Liga
890,Enric Franquesa,es ESP,"DF,FW",27.0,6.8,17,9,9,6,2,9,13,69.2,4,7,1,6,5,22,12,0,Matches,Leganes,La-Liga
891,Yan Diomandé,ci CIV,"MF,FW",17.0,6.1,14,9,1,8,5,5,15,33.3,10,8,0,8,8,22,6,0,Matches,Leganes,La-Liga
892,Juan Soriano,es ESP,GK,26.0,6.0,1,1,1,0,0,1,1,100.0,0,0,0,0,0,1,2,0,Matches,Leganes,La-Liga
893,Sébastien Haller,ci CIV,FW,30.0,4.5,2,0,1,0,1,1,2,50.0,1,1,0,1,0,2,7,0,Matches,Leganes,La-Liga
894,Roberto López,es ESP,MF,24.0,4.4,8,6,4,4,0,5,15,33.3,10,5,0,5,1,9,7,2,Matches,Leganes,La-Liga
895,Julián Chicco,ar ARG,"MF,DF",26.0,3.4,11,7,3,6,2,5,8,62.5,3,2,0,2,4,15,10,0,Matches,Leganes,La-Liga
896,Aritz Arambarri,es ESP,DF,26.0,2.0,1,1,1,0,0,1,1,100.0,0,2,2,0,3,4,8,0,Matches,Leganes,La-Liga
897,Duk,cv CPV,"MF,FW",24.0,2.0,8,4,3,3,2,3,5,60.0,2,4,0,4,1,9,2,0,Matches,Leganes,La-Liga
898,Borna Barišić,hr CRO,DF,31.0,0.1,0,0,0,0,0,0,0,,0,0,0,0,0,0,0,0,Matches,Leganes,La-Liga
899,Antonio Raillo,es ESP,DF,32.0,35.6,31,18,18,10,3,14,20,70.0,6,51,38,13,29,60,222,1,Matches,Mallorca,La-Liga
900,Sergi Darder,es ESP,"MF,FW",30.0,30.5,40,26,15,16,9,17,46,37.0,29,19,1,18,16,56,23,1,Matches,Mallorca,La-Liga
901,Dominik Greif,sk SVK,GK,27.0,31.0,0,0,0,0,0,0,0,,0,0,0,0,0,0,13,1,Matches,Mallorca,La-Liga
902,Martin Valjent,sk SVK,DF,28.0,30.7,30,21,22,7,1,15,25,60.0,10,32,21,11,18,48,195,1,Matches,Mallorca,La-Liga
903,Samu Costa,pt POR,MF,23.0,29.4,90,44,45,42,3,35,79,44.3,44,48,15,33,32,122,85,1,Matches,Mallorca,La-Liga
904,Johan Mojica,co COL,DF,31.0,30.6,35,23,26,6,3,19,40,47.5,21,13,5,8,26,61,84,3,Matches,Mallorca,La-Liga
905,Pablo Maffeo,es ESP,DF,27.0,26.3,60,40,43,14,3,34,46,73.9,12,32,11,21,25,85,103,1,Matches,Mallorca,La-Liga
906,Dani Rodríguez,es ESP,"MF,FW",36.0,24.0,49,29,18,21,10,14,27,51.9,13,22,3,19,12,61,30,0,Matches,Mallorca,La-Liga
907,Vedat Muriqi,xk KVX,FW,30.0,22.9,7,5,3,2,2,3,7,42.9,4,7,1,6,7,14,43,0,Matches,Mallorca,La-Liga
908,Omar Mascarell,gq EQG,MF,31.0,22.1,27,13,13,13,1,14,35,40.0,21,33,21,12,49,76,59,3,Matches,Mallorca,La-Liga
909,Cyle Larin,ca CAN,FW,29.0,19.6,12,6,1,6,5,3,9,33.3,6,12,3,9,1,13,16,0,Matches,Mallorca,La-Liga
910,Copete,es ESP,DF,24.0,17.0,29,17,18,10,1,11,12,91.7,1,24,16,8,17,46,123,2,Matches,Mallorca,La-Liga
911,Manu Morlanes,es ESP,MF,25.0,14.9,43,27,18,20,5,18,30,60.0,12,19,8,11,24,67,16,0,Matches,Mallorca,La-Liga
912,Roberto Navarro,es ESP,"MF,FW",22.0,14.2,29,22,14,11,4,9,19,47.4,10,18,0,18,19,48,12,0,Matches,Mallorca,La-Liga
913,Takuma Asano,jp JPN,"FW,MF",29.0,11.7,13,9,5,7,1,6,11,54.5,5,7,0,7,6,19,9,0,Matches,Mallorca,La-Liga
914,Antonio Sánchez,es ESP,"MF,DF",27.0,15.5,28,16,16,8,4,14,36,38.9,22,16,2,14,18,46,36,1,Matches,Mallorca,La-Liga
915,Mateu Morey,es ESP,DF,24.0,8.2,22,18,13,6,3,12,22,54.5,10,11,0,11,15,37,32,2,Matches,Mallorca,La-Liga
916,Leo Román,es ESP,GK,24.0,7.0,0,0,0,0,0,0,0,,0,0,0,0,0,0,6,0,Matches,Mallorca,La-Liga
917,Toni Lato,es ESP,DF,26.0,6.9,17,11,6,5,6,7,11,63.6,4,10,4,6,6,23,33,0,Matches,Mallorca,La-Liga
918,Abdón Prats,es ESP,"FW,MF",31.0,5.1,2,1,1,1,0,1,2,50.0,1,2,1,1,1,3,5,0,Matches,Mallorca,La-Liga
919,Marc Domenech,es ESP,"FW,MF",18.0,3.4,4,4,2,1,1,2,5,40.0,3,2,0,2,0,4,2,0,Matches,Mallorca,La-Liga
920,David López,es ESP,DF,21.0,1.9,3,2,3,0,0,2,2,100.0,0,2,2,0,1,4,10,0,Matches,Mallorca,La-Liga
921,Valery Fernández,es ESP,"MF,FW",24.0,3.4,8,7,3,2,3,5,7,71.4,2,3,1,2,0,8,1,0,Matches,Mallorca,La-Liga
922,Chiquinho,pt POR,"MF,FW",24.0,1.6,1,0,0,1,0,0,7,0.0,7,3,0,3,2,3,0,0,Matches,Mallorca,La-Liga
923,Siebe Van Der Heyden,be BEL,"DF,MF",26.0,1.1,1,1,0,1,0,0,0,,0,1,0,1,2,3,3,0,Matches,Mallorca,La-Liga
924,Javier Llabrés,es ESP,FW,21.0,0.6,0,0,0,0,0,0,0,,0,1,0,1,0,0,0,0,Matches,Mallorca,La-Liga
925,Jan Salas,es ESP,"MF,FW",18.0,0.5,3,1,2,1,0,2,2,100.0,0,0,0,0,0,3,0,0,Matches,Mallorca,La-Liga
926,Daniel Luna,co COL,MF,21.0,0.2,0,0,0,0,0,0,0,,0,1,0,1,0,0,0,0,Matches,Mallorca,La-Liga
927,Sergio Herrera,es ESP,GK,31.0,37.0,2,1,2,0,0,2,6,33.3,4,1,0,1,0,2,29,1,Matches,Osasuna,La-Liga
928,Jesús Areso,es ESP,DF,25.0,34.2,53,38,31,14,8,39,56,69.6,17,26,4,22,8,61,92,0,Matches,Osasuna,La-Liga
929,Catena,es ESP,DF,29.0,34.2,46,28,34,10,2,27,44,61.4,17,40,25,15,35,81,221,2,Matches,Osasuna,La-Liga
930,Aimar Oroz,es ESP,MF,22.0,33.0,35,19,16,13,6,14,46,30.4,32,29,2,27,20,55,10,0,Matches,Osasuna,La-Liga
931,Lucas Torró,es ESP,MF,30.0,32.9,74,41,34,35,5,36,64,56.3,28,36,9,27,45,119,70,3,Matches,Osasuna,La-Liga
932,Ante Budimir,hr CRO,FW,33.0,32.8,20,9,3,11,6,3,13,23.1,10,19,4,15,2,22,26,0,Matches,Osasuna,La-Liga
933,Enzo Boyomo,cm CMR,DF,22.0,33.2,68,43,46,18,4,30,39,76.9,9,34,19,15,44,112,137,3,Matches,Osasuna,La-Liga
934,Rubén García,es ESP,"FW,MF",31.0,26.8,52,31,20,21,11,26,60,43.3,34,37,3,34,15,67,34,1,Matches,Osasuna,La-Liga
935,Jon Moncayola,es ESP,MF,26.0,23.3,70,41,29,33,8,31,60,51.7,29,34,3,31,11,81,20,0,Matches,Osasuna,La-Liga
936,Bryan Zaragoza,es ESP,"FW,MF",23.0,20.4,13,9,8,4,1,6,21,28.6,15,10,0,10,4,17,8,0,Matches,Osasuna,La-Liga
937,Abel,es ESP,DF,23.0,23.0,61,37,28,25,8,39,63,61.9,24,29,4,25,18,79,64,2,Matches,Osasuna,La-Liga
938,Juan Cruz Armada,es ESP,DF,32.0,16.6,26,14,11,13,2,15,24,62.5,9,15,4,11,9,35,68,0,Matches,Osasuna,La-Liga
939,Jorge Herrando,es ESP,DF,23.0,15.2,17,11,9,5,3,9,15,60.0,6,20,14,6,12,29,65,2,Matches,Osasuna,La-Liga
940,Pablo Ibáñez,es ESP,MF,25.0,14.4,20,10,7,12,1,10,40,25.0,30,20,7,13,18,38,21,0,Matches,Osasuna,La-Liga
941,Rubén Peña,es ESP,"FW,DF",33.0,8.6,12,5,4,3,5,5,24,20.8,19,11,0,11,6,18,12,0,Matches,Osasuna,La-Liga
942,Moi Gómez,es ESP,"MF,FW",30.0,8.8,13,9,4,7,2,4,8,50.0,4,5,2,3,6,19,7,1,Matches,Osasuna,La-Liga
943,Raúl,es ESP,"FW,MF",23.0,8.3,13,8,3,6,4,5,10,50.0,5,4,0,4,0,13,6,0,Matches,Osasuna,La-Liga
944,Iker Muñoz,es ESP,MF,21.0,6.8,5,2,3,2,0,3,9,33.3,6,9,2,7,4,9,12,1,Matches,Osasuna,La-Liga
945,Kike Barja,es ESP,"FW,MF",27.0,3.5,5,4,1,3,1,2,4,50.0,2,5,0,5,3,8,4,0,Matches,Osasuna,La-Liga
946,José Arnaiz,es ESP,"FW,MF",29.0,1.5,7,5,3,3,1,4,7,57.1,3,2,0,2,5,12,1,0,Matches,Osasuna,La-Liga
947,Nacho Vidal,es ESP,DF,29.0,1.4,2,0,0,1,1,1,4,25.0,3,1,0,1,0,2,6,0,Matches,Osasuna,La-Liga
948,Aitor Fernández,es ESP,GK,33.0,1.0,0,0,0,0,0,0,0,,0,0,0,0,0,0,2,0,Matches,Osasuna,La-Liga
949,Unai García,es ESP,DF,32.0,0.7,0,0,0,0,0,0,0,,0,1,0,1,0,0,1,0,Matches,Osasuna,La-Liga
950,Iker Benito,es ESP,"FW,MF",21.0,0.4,0,0,0,0,0,0,1,0.0,1,0,0,0,1,1,2,0,Matches,Osasuna,La-Liga
951,Javi Martínez,es ESP,MF,24.0,0.1,0,0,0,0,0,0,0,,0,0,0,0,0,0,0,0,Matches,Osasuna,La-Liga
952,Florian Lejeune,fr FRA,DF,33.0,36.9,46,28,30,14,2,23,43,53.5,20,38,32,6,41,87,181,1,Matches,Rayo-Vallecano,La-Liga
953,Andrei Ratiu,ro ROU,DF,26.0,34.1,71,41,40,21,10,42,70,60.0,28,45,5,40,27,98,73,2,Matches,Rayo-Vallecano,La-Liga
954,Augusto Batalla,ar ARG,GK,28.0,32.0,4,2,4,0,0,4,6,66.7,2,0,0,0,0,4,15,4,Matches,Rayo-Vallecano,La-Liga
955,Jorge de Frutos,es ESP,"FW,MF",27.0,27.7,37,21,16,13,8,14,46,30.4,32,22,0,22,19,56,24,1,Matches,Rayo-Vallecano,La-Liga
956,Pep Chavarría,es ESP,"DF,FW",26.0,28.7,46,36,30,14,2,28,45,62.2,17,35,9,26,30,76,108,1,Matches,Rayo-Vallecano,La-Liga
957,Álvaro García,es ESP,"FW,MF",31.0,28.4,33,24,19,8,6,12,31,38.7,19,31,0,31,32,65,42,1,Matches,Rayo-Vallecano,La-Liga
958,Isaac Palazón Camacho,es ESP,"MF,FW",29.0,24.0,22,17,10,6,6,8,34,23.5,26,22,3,19,8,30,13,1,Matches,Rayo-Vallecano,La-Liga
959,Pathé Ciss,sn SEN,"MF,DF",30.0,23.8,49,24,26,22,1,20,41,48.8,21,31,10,21,40,89,61,3,Matches,Rayo-Vallecano,La-Liga
960,Abdul Mumin,gh GHA,DF,26.0,22.4,37,25,30,7,0,17,27,63.0,10,40,29,11,23,60,125,0,Matches,Rayo-Vallecano,La-Liga
961,Unai López,es ESP,MF,28.0,19.0,31,21,14,12,5,17,36,47.2,19,18,6,12,21,52,20,0,Matches,Rayo-Vallecano,La-Liga
962,Óscar Valentín,es ESP,MF,29.0,20.4,55,41,21,20,14,33,76,43.4,43,36,8,28,21,76,51,2,Matches,Rayo-Vallecano,La-Liga
963,Adri Embarba,es ESP,"FW,MF",32.0,17.9,41,20,17,17,7,18,47,38.3,29,18,1,17,13,54,14,2,Matches,Rayo-Vallecano,La-Liga
964,Randy Nteka,ao ANG,FW,26.0,12.5,16,5,3,9,4,5,12,41.7,7,13,2,11,4,20,20,0,Matches,Rayo-Vallecano,La-Liga
965,Sergio Camello,es ESP,FW,23.0,12.6,9,3,2,5,2,4,6,66.7,2,8,1,7,4,13,16,0,Matches,Rayo-Vallecano,La-Liga
966,Pedro Díaz,es ESP,MF,26.0,13.5,23,15,7,14,2,14,41,34.1,27,16,0,16,7,30,7,1,Matches,Rayo-Vallecano,La-Liga
967,Iván Balliu,al ALB,DF,32.0,13.3,17,14,8,5,4,6,18,33.3,12,16,4,12,13,30,39,0,Matches,Rayo-Vallecano,La-Liga
968,Aridane Hernández,es ESP,DF,35.0,11.4,13,11,9,4,0,6,8,75.0,2,10,8,2,6,19,99,2,Matches,Rayo-Vallecano,La-Liga
969,Alfonso Espino,uy URU,DF,32.0,9.3,41,24,31,8,2,26,47,55.3,21,19,6,13,12,53,32,1,Matches,Rayo-Vallecano,La-Liga
970,Gerard Gumbau,es ESP,MF,29.0,9.4,17,12,8,7,2,7,15,46.7,8,13,4,9,5,22,13,0,Matches,Rayo-Vallecano,La-Liga
971,Dani Cárdenas,es ESP,GK,27.0,6.0,0,0,0,0,0,0,0,,0,0,0,0,0,0,3,0,Matches,Rayo-Vallecano,La-Liga
972,Óscar Trejo,ar ARG,MF,36.0,5.5,8,5,1,5,2,3,9,33.3,6,9,0,9,4,12,5,0,Matches,Rayo-Vallecano,La-Liga
973,Sergi Guardiola,es ESP,FW,33.0,4.0,5,3,0,5,0,2,3,66.7,1,1,0,1,1,6,2,0,Matches,Rayo-Vallecano,La-Liga
974,James Rodríguez,co COL,"MF,FW",33.0,1.6,3,2,1,2,0,0,2,0.0,2,2,0,2,1,4,0,0,Matches,Rayo-Vallecano,La-Liga
975,Pelayo Fernandez,es ESP,DF,21.0,1.1,0,0,0,0,0,0,0,,0,0,0,0,2,2,9,0,Matches,Rayo-Vallecano,La-Liga
976,Etienne Eto'o,cm CMR,FW,21.0,0.4,0,0,0,0,0,0,1,0.0,1,0,0,0,0,0,1,0,Matches,Rayo-Vallecano,La-Liga
977,Raúl de Tomás,es ESP,"DF,FW",29.0,0.2,2,2,1,0,1,0,0,,0,0,0,0,0,2,0,0,Matches,Rayo-Vallecano,La-Liga
978,Federico Valverde,uy URU,"MF,DF",26.0,33.7,50,30,22,23,5,29,43,67.4,14,38,8,30,55,105,52,1,Matches,Real-Madrid,La-Liga
979,Kylian Mbappé,fr FRA,FW,25.0,32.3,8,5,1,3,4,1,5,20.0,4,3,0,3,1,9,1,1,Matches,Real-Madrid,La-Liga
980,Aurélien Tchouaméni,fr FRA,"DF,MF",24.0,29.9,47,23,25,19,3,21,41,51.2,20,34,25,9,46,93,92,1,Matches,Real-Madrid,La-Liga
981,Thibaut Courtois,be BEL,GK,32.0,30.0,0,0,0,0,0,0,0,,0,0,0,0,1,1,15,1,Matches,Real-Madrid,La-Liga
982,Jude Bellingham,eng ENG,MF,21.0,27.6,61,33,20,27,14,28,42,66.7,14,37,2,35,28,89,23,1,Matches,Real-Madrid,La-Liga
983,Antonio Rüdiger,de GER,DF,31.0,25.5,20,13,14,6,0,11,15,73.3,4,22,14,8,9,29,96,1,Matches,Real-Madrid,La-Liga
984,Lucas Vázquez,es ESP,DF,33.0,24.3,58,34,33,17,8,27,48,56.3,21,24,6,18,17,75,35,1,Matches,Real-Madrid,La-Liga
985,Vinicius Júnior,br BRA,FW,24.0,25.0,21,10,7,4,10,5,18,27.8,13,9,0,9,3,24,1,2,Matches,Real-Madrid,La-Liga
986,Fran Garcia,es ESP,DF,24.0,24.1,51,36,29,16,6,28,51,54.9,23,27,5,22,28,79,67,1,Matches,Real-Madrid,La-Liga
987,Rodrygo,br BRA,"FW,MF",23.0,21.4,21,14,14,5,2,7,23,30.4,16,18,1,17,11,32,9,0,Matches,Real-Madrid,La-Liga
988,Raúl Asencio,es ESP,DF,21.0,18.6,22,16,18,4,0,10,13,76.9,3,11,6,5,16,38,88,2,Matches,Real-Madrid,La-Liga
989,Luka Modrić,hr CRO,MF,38.0,20.3,31,20,16,13,2,14,32,43.8,18,17,5,12,27,58,17,0,Matches,Real-Madrid,La-Liga
990,Brahim Díaz,ma MAR,"FW,MF",24.0,15.4,25,19,9,13,3,7,19,36.8,12,16,1,15,4,29,2,1,Matches,Real-Madrid,La-Liga
991,Dani Ceballos,es ESP,MF,27.0,13.5,41,21,17,18,6,20,40,50.0,20,16,4,12,14,55,10,2,Matches,Real-Madrid,La-Liga
992,Arda Güler,tr TUR,"MF,FW",19.0,13.9,30,16,11,8,11,9,22,40.9,13,18,0,18,7,37,8,0,Matches,Real-Madrid,La-Liga
993,Ferland Mendy,fr FRA,DF,29.0,11.2,17,14,7,6,4,9,12,75.0,3,11,4,7,9,26,8,1,Matches,Real-Madrid,La-Liga
994,Eduardo Camavinga,fr FRA,"MF,DF",21.0,12.2,42,26,23,16,3,19,33,57.6,14,24,8,16,18,60,23,0,Matches,Real-Madrid,La-Liga
995,Éder Militão,br BRA,DF,26.0,10.4,19,17,14,5,0,7,12,58.3,5,13,8,5,12,31,35,0,Matches,Real-Madrid,La-Liga
996,Andriy Lunin,ua UKR,GK,25.0,7.0,1,0,1,0,0,0,0,,0,0,0,0,0,1,3,0,Matches,Real-Madrid,La-Liga
997,Dani Carvajal,es ESP,DF,32.0,6.8,12,8,7,3,2,9,12,75.0,3,8,3,5,10,22,19,1,Matches,Real-Madrid,La-Liga
998,David Alaba,at AUT,DF,32.0,3.5,1,0,1,0,0,0,0,,0,5,5,0,6,7,7,0,Matches,Real-Madrid,La-Liga
999,Endrick,br BRA,FW,18.0,4.0,1,1,1,0,0,1,3,33.3,2,0,0,0,4,5,1,0,Matches,Real-Madrid,La-Liga
1000,Jacobo Ramón,es ESP,DF,19.0,2.3,7,3,4,3,0,2,2,100.0,0,1,0,1,3,10,8,2,Matches,Real-Madrid,La-Liga
1001,Jesús Vallejo,es ESP,DF,27.0,1.5,0,0,0,0,0,0,0,,0,0,0,0,2,2,8,0,Matches,Real-Madrid,La-Liga
1002,Fran,es ESP,GK,19.0,1.0,0,0,0,0,0,0,0,,0,0,0,0,0,0,2,0,Matches,Real-Madrid,La-Liga
1003,Gonzalo García,es ESP,"FW,DF",20.0,0.6,0,0,0,0,0,0,0,,0,1,0,1,0,0,0,0,Matches,Real-Madrid,La-Liga
1004,Víctor Muñoz,es ESP,"FW,DF",21.0,0.4,0,0,0,0,0,0,0,,0,0,0,0,0,0,0,0,Matches,Real-Madrid,La-Liga
1005,Chema,es ESP,MF,19.0,0.1,0,0,0,0,0,0,0,,0,0,0,0,0,0,1,0,Matches,Real-Madrid,La-Liga
1006,Lorenzo Aguado,es ESP,DF,21.0,0.1,0,0,0,0,0,0,0,,0,0,0,0,0,0,2,0,Matches,Real-Madrid,La-Liga
1007,Daniel Yáñez,es ESP,FW,17.0,0.0,0,0,0,0,0,0,0,,0,0,0,0,0,0,0,0,Matches,Real-Madrid,La-Liga
1008,Álex Remiro,es ESP,GK,29.0,36.0,1,0,1,0,0,1,2,50.0,1,0,0,0,0,1,18,4,Matches,Real-Sociedad,La-Liga
1009,Martín Zubimendi,es ESP,MF,25.0,32.9,73,37,31,29,13,28,44,63.6,16,42,16,26,44,117,79,3,Matches,Real-Sociedad,La-Liga
1010,Sergio Gómez,es ESP,"MF,DF",23.0,30.4,71,39,30,29,12,30,56,53.6,26,44,3,41,19,90,30,2,Matches,Real-Sociedad,La-Liga
1011,Jon Aramburu,ve VEN,DF,22.0,27.3,102,70,61,30,11,66,100,66.0,34,40,8,32,30,132,98,0,Matches,Real-Sociedad,La-Liga
1012,Mikel Oyarzabal,es ESP,FW,27.0,25.0,25,16,9,10,6,10,23,43.5,13,17,1,16,4,29,15,0,Matches,Real-Sociedad,La-Liga
1013,Takefusa Kubo,jp JPN,"MF,FW",23.0,26.4,31,20,11,11,9,16,40,40.0,24,38,1,37,17,48,13,1,Matches,Real-Sociedad,La-Liga
1014,Igor Zubeldia,es ESP,DF,27.0,25.2,34,22,21,10,3,14,26,53.8,12,32,18,14,31,65,100,2,Matches,Real-Sociedad,La-Liga
1015,Javi López,es ESP,DF,22.0,21.5,40,23,23,12,5,23,37,62.2,14,21,7,14,11,51,59,2,Matches,Real-Sociedad,La-Liga
1016,Luka Sučić,hr CRO,MF,21.0,19.9,25,18,8,12,5,10,26,38.5,16,30,2,28,15,40,16,1,Matches,Real-Sociedad,La-Liga
1017,Nayef Aguerd,ma MAR,DF,28.0,19.6,30,24,17,12,1,12,18,66.7,6,21,15,6,13,43,91,0,Matches,Real-Sociedad,La-Liga
1018,Brais Méndez,es ESP,MF,27.0,17.0,24,13,6,14,4,9,24,37.5,15,14,1,13,7,31,16,1,Matches,Real-Sociedad,La-Liga
1019,Aritz Elustondo,es ESP,DF,30.0,16.2,20,11,15,3,2,11,19,57.9,8,17,12,5,11,31,96,0,Matches,Real-Sociedad,La-Liga
1020,Ander Barrenetxea,es ESP,"MF,FW",22.0,14.0,26,19,7,14,5,6,23,26.1,17,15,0,15,11,37,16,1,Matches,Real-Sociedad,La-Liga
1021,Pablo Marín,es ESP,MF,21.0,13.8,25,17,6,13,6,10,19,52.6,9,12,3,9,5,30,14,0,Matches,Real-Sociedad,La-Liga
1022,Aihen Muñoz,es ESP,DF,26.0,12.2,24,12,14,8,2,14,28,50.0,14,11,6,5,14,38,47,0,Matches,Real-Sociedad,La-Liga
1023,Sheraldo Becker,sr SUR,"FW,MF",29.0,11.1,3,2,0,3,0,0,2,0.0,2,4,0,4,1,4,10,0,Matches,Real-Sociedad,La-Liga
1024,Beñat Turrientes,es ESP,MF,22.0,10.5,15,6,4,10,1,4,15,26.7,11,15,3,12,5,20,14,1,Matches,Real-Sociedad,La-Liga
1025,Orri Steinn Óskarsson,is ISL,FW,19.0,10.5,6,6,2,1,3,2,8,25.0,6,10,1,9,2,8,11,0,Matches,Real-Sociedad,La-Liga
1026,Jon Pacheco,es ESP,DF,23.0,9.5,15,9,12,3,0,10,12,83.3,2,8,6,2,9,24,49,2,Matches,Real-Sociedad,La-Liga
1027,Hamari Traoré,ml MLI,DF,32.0,7.8,19,12,10,7,2,15,22,68.2,7,6,2,4,9,28,21,0,Matches,Real-Sociedad,La-Liga
1028,Olasagasti,es ESP,MF,23.0,9.5,21,10,7,9,5,8,18,44.4,10,8,2,6,15,36,10,0,Matches,Real-Sociedad,La-Liga
1029,Jon Martin,es ESP,DF,18.0,10.0,11,9,7,3,1,6,9,66.7,3,13,9,4,7,18,80,1,Matches,Real-Sociedad,La-Liga
1030,Umar Sadiq,ng NGA,FW,27.0,2.5,2,1,1,1,0,1,2,50.0,1,3,1,2,1,3,2,0,Matches,Real-Sociedad,La-Liga
1031,Unai Marrero,es ESP,GK,22.0,2.0,0,0,0,0,0,0,0,,0,0,0,0,0,0,1,0,Matches,Real-Sociedad,La-Liga
1032,Arkaitz Mariezkurrena,es ESP,"FW,MF",19.0,2.7,1,0,1,0,0,0,4,0.0,4,4,1,3,1,2,4,0,Matches,Real-Sociedad,La-Liga
1033,Arsen Zakharyan,ru RUS,"MF,FW",21.0,0.8,1,1,1,0,0,1,1,100.0,0,1,1,0,1,2,0,0,Matches,Real-Sociedad,La-Liga
1034,Urko González,es ESP,MF,23.0,0.5,0,0,0,0,0,0,0,,0,1,1,0,0,0,0,0,Matches,Real-Sociedad,La-Liga
1035,Álvaro Odriozola,es ESP,DF,28.0,0.5,1,1,1,0,0,0,0,,0,0,0,0,0,1,1,0,Matches,Real-Sociedad,La-Liga
1036,Daniel Díaz,es ESP,MF,18.0,0.1,1,1,1,0,0,0,0,,0,1,0,1,0,1,0,0,Matches,Real-Sociedad,La-Liga
1037,Luken Beitia,es ESP,DF,20.0,0.1,1,1,1,0,0,1,1,100.0,0,0,0,0,0,1,2,0,Matches,Real-Sociedad,La-Liga
1038,Jon Magunazelaia,es ESP,MF,23.0,0.1,1,1,1,0,0,0,0,,0,0,0,0,0,1,0,0,Matches,Real-Sociedad,La-Liga
1039,Dodi Lukebakio,be BEL,FW,26.0,34.4,22,14,8,8,6,15,27,55.6,12,18,1,17,11,33,17,2,Matches,Sevilla,La-Liga
1040,Carmona,es ESP,DF,22.0,32.7,83,59,53,21,9,41,77,53.2,36,37,11,26,68,151,92,3,Matches,Sevilla,La-Liga
1041,Loïc Bade,fr FRA,DF,24.0,29.8,47,27,37,10,0,23,31,74.2,8,22,13,9,29,76,162,2,Matches,Sevilla,La-Liga
1042,Ørjan Nyland,no NOR,GK,33.0,29.7,3,2,3,0,0,3,5,60.0,2,0,0,0,0,3,12,4,Matches,Sevilla,La-Liga
1043,Nemanja Gudelj,rs SRB,"MF,DF",32.0,27.7,42,24,16,22,4,21,35,60.0,14,27,10,17,27,69,94,1,Matches,Sevilla,La-Liga
1044,Adrià Pedrosa,es ESP,DF,26.0,25.5,56,32,34,16,6,31,54,57.4,23,43,11,32,24,80,85,0,Matches,Sevilla,La-Liga
1045,Isaac Romero,es ESP,FW,24.0,24.0,13,7,4,4,5,3,16,18.8,13,18,1,17,7,20,27,0,Matches,Sevilla,La-Liga
1046,Kike Salas,es ESP,DF,22.0,24.9,47,28,24,16,7,27,46,58.7,19,26,14,12,32,79,146,0,Matches,Sevilla,La-Liga
1047,Lucien Agoume,fr FRA,MF,22.0,23.5,70,32,23,37,10,27,39,69.2,12,30,11,19,41,111,42,0,Matches,Sevilla,La-Liga
1048,Djibril Sow,ch SUI,MF,27.0,22.9,25,14,13,10,2,8,17,47.1,9,18,3,15,28,53,26,1,Matches,Sevilla,La-Liga
1049,Juanlu Sánchez,es ESP,"MF,DF",20.0,19.1,50,34,28,15,7,35,59,59.3,24,27,2,25,17,67,19,0,Matches,Sevilla,La-Liga
1050,Saúl Ñíguez,es ESP,MF,29.0,17.3,47,32,16,24,7,12,31,38.7,19,25,2,23,22,69,34,0,Matches,Sevilla,La-Liga
1051,Albert Sambi Lokonga,be BEL,MF,24.0,16.3,22,15,10,9,3,10,14,71.4,4,13,1,12,9,31,24,3,Matches,Sevilla,La-Liga
1052,Peque,es ESP,"MF,FW",21.0,12.6,16,5,4,10,2,7,17,41.2,10,16,0,16,8,24,5,0,Matches,Sevilla,La-Liga
1053,Chidera Ejuke,ng NGA,FW,26.0,10.7,19,13,8,9,2,9,20,45.0,11,12,0,12,5,24,8,0,Matches,Sevilla,La-Liga
1054,Ruben Vargas,ch SUI,"FW,MF",25.0,7.5,7,4,1,5,1,3,8,37.5,5,9,0,9,3,10,10,0,Matches,Sevilla,La-Liga
1055,Álvaro Fernández,es ESP,GK,26.0,8.3,0,0,0,0,0,0,1,0.0,1,0,0,0,0,0,7,0,Matches,Sevilla,La-Liga
1056,Marcão,br BRA,DF,28.0,6.1,10,7,6,4,0,3,5,60.0,2,9,6,3,7,17,29,1,Matches,Sevilla,La-Liga
1057,Tanguy Nianzou,fr FRA,DF,22.0,5.8,7,5,6,0,1,5,6,83.3,1,1,0,1,8,15,27,0,Matches,Sevilla,La-Liga
1058,Kelechi Iheanacho,ng NGA,FW,27.0,4.4,1,0,0,1,0,1,3,33.3,2,0,0,0,0,1,1,0,Matches,Sevilla,La-Liga
1059,Suso,es ESP,"FW,MF",30.0,6.7,10,7,3,6,1,4,11,36.4,7,4,0,4,4,14,2,0,Matches,Sevilla,La-Liga
1060,Álvaro Pascual,es ESP,FW,22.0,4.5,5,3,0,3,2,1,5,20.0,4,4,0,4,2,7,9,0,Matches,Sevilla,La-Liga
1061,Jesús Navas,es ESP,"FW,MF",38.0,4.7,5,2,3,0,2,0,3,0.0,3,1,0,1,4,9,6,0,Matches,Sevilla,La-Liga
1062,Valentín Barco,ar ARG,"DF,FW",20.0,3.2,15,9,8,3,4,12,15,80.0,3,0,0,0,2,17,5,0,Matches,Sevilla,La-Liga
1063,Stanis Idumbo,be BEL,"FW,MF",19.0,3.2,9,5,3,4,2,3,5,60.0,2,3,1,2,4,13,2,0,Matches,Sevilla,La-Liga
1064,Ramón Martínez,es ESP,DF,21.0,2.9,6,3,5,1,0,3,5,60.0,2,2,1,1,2,8,23,0,Matches,Sevilla,La-Liga
1065,Lucas Ocampos,ar ARG,FW,30.0,1.9,3,2,2,0,1,1,2,50.0,1,2,0,2,0,3,2,0,Matches,Sevilla,La-Liga
1066,Manu Bueno,es ESP,"MF,FW",20.0,1.6,4,3,0,1,3,1,2,50.0,1,0,0,0,0,4,2,0,Matches,Sevilla,La-Liga
1067,Akor Adams,ng NGA,FW,24.0,1.5,0,0,0,0,0,0,0,,0,1,0,1,0,0,1,0,Matches,Sevilla,La-Liga
1068,Gonzalo Montiel,ar ARG,"DF,MF",27.0,1.3,4,2,3,1,0,3,4,75.0,1,0,0,0,2,6,11,0,Matches,Sevilla,La-Liga
1069,Diego Iturralde,es ESP,FW,21.0,0.4,0,0,0,0,0,0,0,,0,0,0,0,1,1,1,0,Matches,Sevilla,La-Liga
1070,Leandro Antonetti,pr PUR,FW,21.0,0.3,0,0,0,0,0,0,0,,0,0,0,0,0,0,0,0,Matches,Sevilla,La-Liga
1071,Israel Domínguez,es ESP,FW,21.0,0.2,0,0,0,0,0,0,0,,0,0,0,0,0,0,0,0,Matches,Sevilla,La-Liga
1072,Mateo Mejía,es ESP,FW,21.0,0.1,0,0,0,0,0,0,0,,0,0,0,0,0,0,0,0,Matches,Sevilla,La-Liga
1073,Darío Fuentes,es ESP,DF,21.0,0.1,0,0,0,0,0,0,0,,0,0,0,0,0,0,0,0,Matches,Sevilla,La-Liga
1074,Cristhian Mosquera,es ESP,DF,20.0,36.9,56,36,41,13,2,31,40,77.5,9,37,24,13,35,91,128,4,Matches,Valencia,La-Liga
1075,Diego López,es ESP,"MF,FW",22.0,30.4,31,18,11,16,4,16,47,34.0,31,30,0,30,16,47,15,0,Matches,Valencia,La-Liga
1076,Giorgi Mamardashvili,ge GEO,GK,23.0,34.0,2,2,2,0,0,2,3,66.7,1,0,0,0,1,3,16,3,Matches,Valencia,La-Liga
1077,César Tárrega,es ESP,DF,22.0,33.6,49,37,33,13,3,19,31,61.3,12,41,20,21,22,71,222,2,Matches,Valencia,La-Liga
1078,Luis Rioja,es ESP,"MF,FW",30.0,31.5,33,21,14,12,7,14,42,33.3,28,30,1,29,22,55,44,1,Matches,Valencia,La-Liga
1079,Javier Guerra,es ESP,MF,21.0,28.7,50,27,18,21,11,26,56,46.4,30,15,3,12,20,70,49,3,Matches,Valencia,La-Liga
1080,Enzo Barrenechea,ar ARG,MF,23.0,24.3,57,30,22,29,6,32,46,69.6,14,30,8,22,28,85,48,1,Matches,Valencia,La-Liga
1081,Dimitri Foulquier,fr FRA,DF,31.0,25.5,48,31,29,13,6,24,36,66.7,12,21,5,16,16,64,86,1,Matches,Valencia,La-Liga
1082,Hugo Duro,es ESP,FW,24.0,24.1,13,8,4,7,2,5,13,38.5,8,11,2,9,10,23,11,0,Matches,Valencia,La-Liga
1083,Domingos André Ribeiro Almeida,pt POR,"MF,FW",24.0,22.0,48,32,18,21,9,14,39,35.9,25,21,3,18,8,56,14,1,Matches,Valencia,La-Liga
1084,José Luis Gayà,es ESP,DF,29.0,20.0,57,40,39,15,3,40,58,69.0,18,16,2,14,25,82,61,0,Matches,Valencia,La-Liga
1085,José Luis García Vayá,es ESP,MF,25.0,19.4,43,25,24,13,6,19,33,57.6,14,23,6,17,19,62,42,0,Matches,Valencia,La-Liga
1086,Jesus Vazquez,es ESP,DF,21.0,10.2,23,18,12,9,2,10,19,52.6,9,16,5,11,10,33,30,0,Matches,Valencia,La-Liga
1087,Yarek Gasiorowski,es ESP,DF,19.0,10.5,19,16,16,3,0,9,13,69.2,4,17,6,11,26,45,60,0,Matches,Valencia,La-Liga
1088,Umar Sadiq,ng NGA,FW,27.0,9.2,10,5,3,5,2,4,6,66.7,2,7,0,7,1,11,7,0,Matches,Valencia,La-Liga
1089,Thierry Correia,pt POR,DF,25.0,8.5,27,18,19,5,3,13,23,56.5,10,10,1,9,4,31,18,0,Matches,Valencia,La-Liga
1090,Mouctar Diakhaby,gn GUI,DF,27.0,7.3,8,3,8,0,0,4,6,66.7,2,8,6,2,11,19,56,0,Matches,Valencia,La-Liga
1091,Rafa Mir,es ESP,"FW,MF",27.0,8.4,12,6,8,4,0,3,9,33.3,6,5,0,5,5,17,9,0,Matches,Valencia,La-Liga
1092,Dani Gómez,es ESP,FW,26.0,5.9,3,2,0,0,3,0,0,,0,1,0,1,2,5,4,0,Matches,Valencia,La-Liga
1093,Francisco Perez,es ESP,"FW,MF",21.0,6.3,17,12,7,8,2,10,16,62.5,6,8,1,7,3,20,6,0,Matches,Valencia,La-Liga
1094,Hugo Guillamón,es ESP,MF,24.0,4.0,11,8,1,9,1,9,10,90.0,1,4,1,3,5,16,9,1,Matches,Valencia,La-Liga
1095,Stole Dimitrievski,mk MKD,GK,30.0,4.0,0,0,0,0,0,0,0,,0,0,0,0,0,0,3,1,Matches,Valencia,La-Liga
1096,Sergi Canós,es ESP,"MF,FW",27.0,4.1,11,7,3,4,4,4,10,40.0,6,6,1,5,5,16,5,0,Matches,Valencia,La-Liga
1097,Ivan Jaime Pajuelo,es ESP,MF,23.0,3.3,8,5,2,3,3,4,5,80.0,1,2,0,2,2,10,0,0,Matches,Valencia,La-Liga
1098,Germán Valera,es ESP,MF,22.0,1.6,1,1,1,0,0,0,1,0.0,1,2,0,2,4,5,2,1,Matches,Valencia,La-Liga
1099,Max Aarons,eng ENG,"DF,MF",24.0,1.3,4,4,2,2,0,4,5,80.0,1,1,0,1,0,4,3,0,Matches,Valencia,La-Liga
1100,Maximiliano Caufriez,be BEL,DF,27.0,1.0,1,1,1,0,0,1,1,100.0,0,2,1,1,1,2,4,0,Matches,Valencia,La-Liga
1101,Rodrigo Abajas,es ESP,DF,21.0,0.7,3,2,2,1,0,3,3,100.0,0,1,0,1,1,4,0,0,Matches,Valencia,La-Liga
1102,Martín Tejón,es ESP,"MF,DF",20.0,0.5,2,0,0,2,0,1,2,50.0,1,0,0,0,0,2,0,0,Matches,Valencia,La-Liga
1103,Iker Córdoba,es ESP,DF,18.0,0.2,0,0,0,0,0,0,0,,0,0,0,0,0,0,1,0,Matches,Valencia,La-Liga
1104,David Otorbi,es ESP,MF,16.0,0.2,0,0,0,0,0,0,0,,0,1,0,1,0,0,0,0,Matches,Valencia,La-Liga
1105,Alberto Marí,es ESP,FW,23.0,0.1,0,0,0,0,0,0,0,,0,0,0,0,0,0,0,0,Matches,Valencia,La-Liga
1106,Karl Jakob Hein,ee EST,GK,22.0,31.0,0,0,0,0,0,0,2,0.0,2,0,0,0,0,0,19,2,Matches,Valladolid,La-Liga
1107,Luis Pérez,es ESP,DF,29.0,28.4,41,30,25,11,5,24,40,60.0,16,26,9,17,29,70,86,0,Matches,Valladolid,La-Liga
1108,Raúl Moro,es ESP,"MF,FW",21.0,26.0,22,13,15,4,3,13,32,40.6,19,8,0,8,10,32,20,1,Matches,Valladolid,La-Liga
1109,Javi Sánchez,es ESP,DF,27.0,22.5,26,16,19,6,1,17,26,65.4,9,39,28,11,22,48,111,3,Matches,Valladolid,La-Liga
1110,Lucas Oliveira Rosa,br BRA,DF,24.0,21.0,53,33,40,11,2,35,51,68.6,16,24,9,15,28,81,69,2,Matches,Valladolid,La-Liga
1111,Eray Cömert,ch SUI,"DF,MF",26.0,19.8,24,14,15,9,0,12,21,57.1,9,28,15,13,24,48,75,2,Matches,Valladolid,La-Liga
1112,Anuar,ma MAR,"MF,FW",29.0,19.1,38,27,21,12,5,15,28,53.6,13,24,8,16,18,56,26,1,Matches,Valladolid,La-Liga
1113,Mario Martín,es ESP,MF,20.0,19.4,62,32,31,27,4,21,49,42.9,28,32,7,25,21,83,46,7,Matches,Valladolid,La-Liga
1114,Stanko Jurić,hr CRO,MF,27.0,19.2,48,24,26,19,3,19,48,39.6,29,35,11,24,24,72,52,0,Matches,Valladolid,La-Liga
1115,Selim Amallah,ma MAR,MF,27.0,15.3,30,18,10,18,2,10,18,55.6,8,24,2,22,14,44,5,1,Matches,Valladolid,La-Liga
1116,Mamadou Sylla,sn SEN,"FW,MF",30.0,17.6,8,4,3,3,2,2,9,22.2,7,8,0,8,3,11,14,1,Matches,Valladolid,La-Liga
1117,David Torres,es ESP,DF,21.0,15.4,13,8,12,1,0,7,11,63.6,4,19,17,2,10,23,74,0,Matches,Valladolid,La-Liga
1118,Juanmi Latasa,es ESP,FW,23.0,15.5,4,2,1,1,2,2,6,33.3,4,4,1,3,0,4,11,1,Matches,Valladolid,La-Liga
1119,Kike Pérez,es ESP,MF,27.0,13.2,37,26,15,19,3,15,26,57.7,11,16,4,12,7,44,18,0,Matches,Valladolid,La-Liga
1120,Marcos André,br BRA,FW,27.0,13.2,10,6,3,5,2,5,13,38.5,8,18,2,16,3,13,10,0,Matches,Valladolid,La-Liga
1121,Antonio Candela,it ITA,DF,24.0,10.1,9,6,6,2,1,4,11,36.4,7,11,6,5,6,15,33,0,Matches,Valladolid,La-Liga
1122,Iván Sánchez,es ESP,"MF,FW",31.0,15.6,37,20,18,10,9,12,27,44.4,15,18,3,15,14,51,10,0,Matches,Valladolid,La-Liga
1123,Adam Aznou,ma MAR,DF,18.0,9.7,28,21,20,8,0,21,43,48.8,22,24,8,16,10,38,30,0,Matches,Valladolid,La-Liga
1124,Juma Bah,sl SLE,DF,18.0,9.6,10,7,7,3,0,3,5,60.0,2,15,8,7,12,22,60,0,Matches,Valladolid,La-Liga
1125,Tamás Nikitscher,hu HUN,"MF,DF",24.0,9.5,17,8,8,9,0,8,13,61.5,5,17,4,13,11,28,16,1,Matches,Valladolid,La-Liga
1126,Chuky san jose,es ESP,MF,20.0,8.1,8,2,3,3,2,2,9,22.2,7,4,1,3,0,8,4,0,Matches,Valladolid,La-Liga
1127,Cenk Özkacar,tr TUR,DF,23.0,8.4,9,5,7,2,0,4,14,28.6,10,9,6,3,18,27,69,1,Matches,Valladolid,La-Liga
1128,Darwin Machís,ve VEN,"MF,FW",31.0,7.1,5,4,3,2,0,3,9,33.3,6,3,0,3,5,10,13,0,Matches,Valladolid,La-Liga
1129,Florian Grillitsch,at AUT,MF,28.0,6.9,11,7,7,3,1,7,15,46.7,8,12,2,10,4,15,5,1,Matches,Valladolid,La-Liga
1130,Joseph Aidoo,gh GHA,DF,28.0,6.5,5,5,3,2,0,2,3,66.7,1,8,4,4,5,10,26,1,Matches,Valladolid,La-Liga
1131,André Ferreira,pt POR,GK,28.0,6.0,0,0,0,0,0,0,0,,0,0,0,0,0,0,4,2,Matches,Valladolid,La-Liga
1132,Amath,sn SEN,"FW,DF",28.0,4.2,2,0,2,0,0,1,8,12.5,7,7,1,6,2,4,6,0,Matches,Valladolid,La-Liga
1133,Henrique,br BRA,DF,30.0,3.9,6,2,3,2,1,1,4,25.0,3,5,0,5,3,9,12,0,Matches,Valladolid,La-Liga
1134,Enzo Boyomo,cm CMR,DF,22.0,3.0,6,2,4,2,0,3,3,100.0,0,4,3,1,1,7,7,0,Matches,Valladolid,La-Liga
1135,Víctor Meseguer,es ESP,MF,25.0,4.6,10,6,4,4,2,2,10,20.0,8,3,0,3,2,12,4,1,Matches,Valladolid,La-Liga
1136,Ibrahim Alani,ng NGA,MF,18.0,1.8,12,7,8,4,0,4,6,66.7,2,3,1,2,1,13,1,0,Matches,Valladolid,La-Liga
1137,Raúl Chasco,es ESP,DF,20.0,1.4,4,1,3,1,0,2,4,50.0,2,1,0,1,2,6,2,0,Matches,Valladolid,La-Liga
1138,Arnau Rafús,es ESP,GK,21.0,1.0,0,0,0,0,0,0,0,,0,0,0,0,0,0,0,1,Matches,Valladolid,La-Liga
1139,Iago Parente,es ESP,DF,18.0,0.8,0,0,0,0,0,0,0,,0,0,0,0,0,0,2,0,Matches,Valladolid,La-Liga
1140,Xavier Moreno,es ESP,FW,19.0,0.5,0,0,0,0,0,0,0,,0,0,0,0,0,0,1,0,Matches,Valladolid,La-Liga
1141,Mario Maroto,es ESP,MF,20.0,0.7,0,0,0,0,0,0,2,0.0,2,0,0,0,2,2,2,0,Matches,Valladolid,La-Liga
1142,Adrian Baquerin,es ESP,FW,17.0,0.5,1,1,0,1,0,0,0,,0,0,0,0,0,1,1,0,Matches,Valladolid,La-Liga
1143,Kenedy,br BRA,"MF,FW",28.0,0.1,0,0,0,0,0,0,0,,0,1,0,1,0,0,0,0,Matches,Valladolid,La-Liga
1144,Sergi Cardona,es ESP,DF,25.0,32.7,71,48,44,20,7,49,79,62.0,30,52,7,45,40,111,122,1,Matches,Villarreal,La-Liga
1145,Alex Baena,es ESP,"MF,FW",23.0,28.8,28,15,6,14,8,10,39,25.6,29,29,2,27,22,50,22,2,Matches,Villarreal,La-Liga
1146,Santi Comesaña,es ESP,MF,27.0,28.4,85,49,44,32,9,42,76,55.3,34,56,22,34,19,104,56,1,Matches,Villarreal,La-Liga
1147,Logan Costa,cv CPV,DF,23.0,28.7,38,21,25,12,1,24,29,82.8,5,25,14,11,21,59,115,2,Matches,Villarreal,La-Liga
1148,Kiko Femenía,es ESP,DF,33.0,24.7,50,34,34,14,2,33,57,57.9,24,21,10,11,40,90,62,3,Matches,Villarreal,La-Liga
1149,Daniel Parejo,es ESP,MF,35.0,25.3,52,40,27,20,5,29,54,53.7,25,24,7,17,24,76,40,1,Matches,Villarreal,La-Liga
1150,Pape Gueye,sn SEN,MF,25.0,24.7,54,26,23,23,8,20,29,69.0,9,31,13,18,27,81,53,2,Matches,Villarreal,La-Liga
1151,Thierno Barry,fr FRA,FW,21.0,25.8,11,8,2,5,4,4,10,40.0,6,15,2,13,0,11,19,0,Matches,Villarreal,La-Liga
1152,Yeremi Pino,es ESP,"MF,FW",21.0,21.5,60,32,20,32,8,32,65,49.2,33,38,3,35,8,68,18,0,Matches,Villarreal,La-Liga
1153,Ayoze Pérez,es ESP,FW,31.0,21.9,27,14,5,18,4,6,24,25.0,18,17,0,17,8,35,15,0,Matches,Villarreal,La-Liga
1154,Diego Conde,es ESP,GK,25.0,21.8,2,2,2,0,0,2,4,50.0,2,0,0,0,1,3,9,2,Matches,Villarreal,La-Liga
1155,Juan Foyth,ar ARG,DF,26.0,16.9,25,15,15,6,4,11,16,68.8,5,26,17,9,19,44,119,3,Matches,Villarreal,La-Liga
1156,Luiz Lúcio Reis Júnior,br BRA,GK,23.0,16.2,0,0,0,0,0,0,0,,0,0,0,0,0,0,14,1,Matches,Villarreal,La-Liga
1157,Nicolas Pépé,ci CIV,"FW,MF",29.0,16.7,22,9,12,6,4,6,17,35.3,11,12,1,11,5,27,12,0,Matches,Villarreal,La-Liga
1158,Raúl Albiol,es ESP,DF,38.0,13.2,10,9,9,1,0,6,10,60.0,4,10,9,1,6,16,69,1,Matches,Villarreal,La-Liga
1159,Willy Kambwala,fr FRA,DF,19.0,12.4,17,12,14,2,1,10,12,83.3,2,10,7,3,10,27,56,1,Matches,Villarreal,La-Liga
1160,Pau Navarro,es ESP,DF,19.0,10.2,23,17,15,6,2,19,39,48.7,20,13,6,7,4,27,41,0,Matches,Villarreal,La-Liga
1161,Eric Bailly,ci CIV,DF,30.0,6.9,12,4,6,6,0,3,4,75.0,1,12,6,6,6,18,29,0,Matches,Villarreal,La-Liga
1162,Denis Suárez,es ESP,MF,30.0,6.8,12,8,7,2,3,4,10,40.0,6,4,1,3,3,15,3,0,Matches,Villarreal,La-Liga
1163,Ilias Akhomach,ma MAR,"MF,FW",20.0,6.5,12,7,4,4,4,6,12,50.0,6,8,0,8,3,15,13,0,Matches,Villarreal,La-Liga
1164,Gerard Moreno,es ESP,FW,32.0,8.0,7,4,3,2,2,3,12,25.0,9,0,0,0,2,9,8,0,Matches,Villarreal,La-Liga
1165,Alfonso Pedraza,es ESP,"DF,MF",28.0,5.1,3,2,2,0,1,2,4,50.0,2,3,1,2,6,9,16,0,Matches,Villarreal,La-Liga
1166,Tajon Buchanan,ca CAN,MF,25.0,4.6,10,5,6,4,0,6,9,66.7,3,6,0,6,1,11,1,0,Matches,Villarreal,La-Liga
1167,Arnaut Danjuma,nl NED,FW,27.0,2.2,2,1,0,1,1,0,1,0.0,1,1,0,1,0,2,0,0,Matches,Villarreal,La-Liga
1168,Juan Bernat,es ESP,"DF,MF",31.0,2.4,9,7,7,1,1,4,5,80.0,1,3,1,2,1,10,4,0,Matches,Villarreal,La-Liga
1169,Ramón Terrats,es ESP,"MF,FW",23.0,1.5,3,3,1,2,0,2,4,50.0,2,3,1,2,2,5,3,0,Matches,Villarreal,La-Liga
1170,Pau Cabanes,es ESP,"MF,FW",19.0,1.8,4,4,0,3,1,3,4,75.0,1,5,0,5,3,7,2,1,Matches,Villarreal,La-Liga
1171,Karl Etta,cm CMR,"MF,FW",20.0,0.4,0,0,0,0,0,0,1,0.0,1,1,0,1,0,0,0,0,Matches,Villarreal,La-Liga
1172,Arnau Solà,es ESP,MF,21.0,0.1,0,0,0,0,0,0,2,0.0,2,1,1,0,0,0,0,0,Matches,Villarreal,La-Liga
1173,Daniel Requena,es ESP,MF,20.0,0.1,0,0,0,0,0,0,0,,0,0,0,0,0,0,0,0,Matches,Villarreal,La-Liga
1174,Thiago Ojeda,ar ARG,MF,21.0,0.1,0,0,0,0,0,0,0,,0,0,0,0,0,0,1,0,Matches,Villarreal,La-Liga
1175,Marco Carnesecchi,it ITA,GK,24.0,34.0,0,0,0,0,0,0,0,,0,1,0,1,0,0,26,2,Matches,Atalanta,Serie-A
1176,Marten de Roon,nl NED,"MF,DF",33.0,34.0,74,48,32,38,4,30,66,45.5,36,40,7,33,47,121,67,1,Matches,Atalanta,Serie-A
1177,Éderson,br BRA,MF,25.0,32.0,52,32,19,28,5,22,34,64.7,12,30,6,24,35,87,36,1,Matches,Atalanta,Serie-A
1178,Berat Djimsiti,al ALB,DF,31.0,29.3,53,33,29,23,1,29,40,72.5,11,34,21,13,40,93,141,2,Matches,Atalanta,Serie-A
1179,Mateo Retegui,it ITA,FW,25.0,26.5,14,9,0,9,5,3,16,18.8,13,7,0,7,4,18,17,0,Matches,Atalanta,Serie-A
1180,Ademola Lookman,ng NGA,"MF,FW",26.0,25.0,32,15,9,15,8,11,19,57.9,8,19,0,19,3,35,5,1,Matches,Atalanta,Serie-A
1181,Raoul Bellanova,it ITA,DF,24.0,26.7,24,14,8,13,3,13,21,61.9,8,12,3,9,18,42,45,0,Matches,Atalanta,Serie-A
1182,Isak Hien,se SWE,DF,25.0,25.9,48,28,27,21,0,27,44,61.4,17,31,18,13,31,79,82,2,Matches,Atalanta,Serie-A
1183,Davide Zappacosta,it ITA,DF,32.0,23.0,26,16,15,5,6,20,39,51.3,19,28,6,22,11,37,32,2,Matches,Atalanta,Serie-A
1184,Charles De Ketelaere,be BEL,"MF,FW",23.0,23.0,13,9,2,9,2,4,15,26.7,11,14,3,11,3,16,9,1,Matches,Atalanta,Serie-A
1185,Mario Pašalić,hr CRO,MF,29.0,21.9,26,16,11,13,2,11,26,42.3,15,22,7,15,12,38,28,1,Matches,Atalanta,Serie-A
1186,Sead Kolašinac,ba BIH,DF,31.0,21.1,41,26,21,20,0,16,30,53.3,14,16,7,9,25,66,53,1,Matches,Atalanta,Serie-A
1187,Matteo Ruggeri,it ITA,DF,22.0,19.5,39,24,15,14,10,25,39,64.1,14,30,4,26,22,61,50,1,Matches,Atalanta,Serie-A
1188,Odilon Kossounou,ci CIV,DF,23.0,12.5,16,11,8,6,2,6,13,46.2,7,16,6,10,13,29,25,1,Matches,Atalanta,Serie-A
1189,Marco Brescianini,it ITA,MF,24.0,11.0,18,11,5,9,4,8,10,80.0,2,15,2,13,2,20,6,0,Matches,Atalanta,Serie-A
1190,Lazar Samardzic,rs SRB,MF,22.0,13.0,21,15,5,7,9,12,25,48.0,13,9,1,8,2,23,6,0,Matches,Atalanta,Serie-A
1191,Juan Cuadrado,co COL,"DF,MF",36.0,9.2,19,9,9,6,4,11,23,47.8,12,14,2,12,7,26,9,0,Matches,Atalanta,Serie-A
1192,Stefan Posch,at AUT,DF,27.0,4.3,18,11,7,8,3,8,9,88.9,1,5,1,4,4,22,13,0,Matches,Atalanta,Serie-A
1193,Giorgio Scalvini,it ITA,DF,20.0,3.0,8,4,5,3,0,5,9,55.6,4,0,0,0,4,12,7,0,Matches,Atalanta,Serie-A
1194,Ibrahim Sulemana,gh GHA,MF,21.0,3.1,9,4,4,5,0,2,8,25.0,6,2,0,2,0,9,1,0,Matches,Atalanta,Serie-A
1195,Rui Patrício,pt POR,GK,36.0,3.0,0,0,0,0,0,0,0,,0,0,0,0,0,0,3,0,Matches,Atalanta,Serie-A
1196,Rafael Tolói,it ITA,DF,33.0,5.2,10,5,3,5,2,4,11,36.4,7,8,2,6,8,18,11,0,Matches,Atalanta,Serie-A
1197,Daniel Maldini,it ITA,"FW,MF",22.0,2.9,2,2,0,1,1,1,2,50.0,1,1,0,1,2,4,3,0,Matches,Atalanta,Serie-A
1198,Marco Palestra,it ITA,DF,19.0,2.5,6,4,3,2,1,3,3,100.0,0,4,1,3,2,8,4,0,Matches,Atalanta,Serie-A
1199,Juan Musso,ar ARG,GK,30.0,1.0,0,0,0,0,0,0,0,,0,0,0,0,0,0,0,0,Matches,Atalanta,Serie-A
1200,Nicolò Zaniolo,it ITA,"FW,MF",25.0,4.0,0,0,0,0,0,0,2,0.0,2,0,0,0,1,1,0,0,Matches,Atalanta,Serie-A
1201,Vanja Vlahović,rs SRB,"FW,MF",20.0,0.7,1,1,0,0,1,0,0,,0,0,0,0,0,1,0,0,Matches,Atalanta,Serie-A
1202,Ben Godfrey,eng ENG,DF,26.0,0.3,0,0,0,0,0,0,1,0.0,1,1,1,0,0,0,0,0,Matches,Atalanta,Serie-A
1203,Mitchel Bakker,nl NED,MF,24.0,0.2,1,0,1,0,0,1,1,100.0,0,0,0,0,0,1,0,0,Matches,Atalanta,Serie-A
1204,Federico Cassa,it ITA,"MF,FW",18.0,0.2,0,0,0,0,0,0,0,,0,1,0,1,0,0,0,0,Matches,Atalanta,Serie-A
1205,Alberto Manzoni,it ITA,MF,19.0,0.1,0,0,0,0,0,0,0,,0,0,0,0,0,0,0,0,Matches,Atalanta,Serie-A
1206,Gianluca Scamacca,it ITA,FW,25.0,0.1,0,0,0,0,0,0,0,,0,0,0,0,0,0,0,0,Matches,Atalanta,Serie-A
1207,Remo Freuler,ch SUI,MF,32.0,35.6,79,40,28,40,11,33,79,41.8,46,38,4,34,38,117,57,1,Matches,Bologna,Serie-A
1208,Sam Beukema,nl NED,DF,25.0,33.5,54,29,27,24,3,22,41,53.7,19,36,21,15,30,84,111,0,Matches,Bologna,Serie-A
1209,Jhon Lucumí,co COL,DF,26.0,29.0,53,30,23,29,1,29,41,70.7,12,32,14,18,26,79,88,7,Matches,Bologna,Serie-A
1210,Łukasz Skorupski,pl POL,GK,33.0,26.3,1,0,1,0,0,1,3,33.3,2,0,0,0,0,1,13,2,Matches,Bologna,Serie-A
1211,Santiago Castro,ar ARG,FW,19.0,25.5,18,10,4,9,5,6,17,35.3,11,13,2,11,3,21,20,0,Matches,Bologna,Serie-A
1212,Dan Ndoye,ch SUI,FW,23.0,23.8,26,19,8,8,10,16,28,57.1,12,23,0,23,9,35,4,0,Matches,Bologna,Serie-A
1213,Juan Miranda,es ESP,DF,24.0,25.3,32,18,11,14,7,14,33,42.4,19,21,3,18,23,55,50,1,Matches,Bologna,Serie-A
1214,Jens Odgaard,dk DEN,"MF,FW",25.0,21.7,20,14,3,12,5,6,21,28.6,15,19,2,17,9,29,12,1,Matches,Bologna,Serie-A
1215,Riccardo Orsolini,it ITA,FW,27.0,20.9,16,13,6,6,4,5,11,45.5,6,26,0,26,8,24,10,1,Matches,Bologna,Serie-A
1216,Benjamín Domínguez,ar ARG,FW,20.0,14.2,18,7,2,11,5,6,20,30.0,14,15,1,14,4,22,7,0,Matches,Bologna,Serie-A
1217,Nikola Moro,hr CRO,MF,26.0,13.4,35,27,7,21,7,22,33,66.7,11,18,7,11,13,48,18,0,Matches,Bologna,Serie-A
1218,Tommaso Pobega,it ITA,MF,25.0,13.1,33,19,12,15,6,22,30,73.3,8,16,4,12,14,47,16,0,Matches,Bologna,Serie-A
1219,Lorenzo De Silvestri,it ITA,DF,36.0,11.8,11,6,7,1,3,7,16,43.8,9,12,4,8,10,21,32,0,Matches,Bologna,Serie-A
1220,Emil Holm,se SWE,DF,24.0,12.6,34,21,17,14,3,20,31,64.5,11,19,4,15,10,44,51,1,Matches,Bologna,Serie-A
1221,Charalampos Lykogiannis,gr GRE,DF,30.0,11.6,23,14,14,8,1,10,20,50.0,10,10,5,5,11,34,41,1,Matches,Bologna,Serie-A
1222,Thijs Dallinga,nl NED,FW,23.0,12.8,10,5,0,4,6,3,3,100.0,0,10,1,9,1,11,13,1,Matches,Bologna,Serie-A
1223,Federico Ravaglia,it ITA,GK,24.0,11.7,0,0,0,0,0,0,0,,0,0,0,0,0,0,9,0,Matches,Bologna,Serie-A
1224,Lewis Ferguson,sct SCO,MF,24.0,10.9,24,13,4,14,6,9,16,56.3,7,9,2,7,5,29,9,0,Matches,Bologna,Serie-A
1225,Giovanni Fabbian,it ITA,MF,21.0,11.4,10,6,1,3,6,7,13,53.8,6,7,2,5,2,12,4,0,Matches,Bologna,Serie-A
1226,Nicolò Casale,it ITA,DF,26.0,10.0,11,5,4,6,1,5,10,50.0,5,15,7,8,17,28,43,3,Matches,Bologna,Serie-A
1227,Michel Aebischer,ch SUI,MF,27.0,8.0,18,13,8,7,3,10,14,71.4,4,4,1,3,7,25,6,0,Matches,Bologna,Serie-A
1228,Stefan Posch,at AUT,DF,27.0,7.9,26,15,12,9,5,15,25,60.0,10,19,4,15,5,31,22,0,Matches,Bologna,Serie-A
1229,Davide Calabria,it ITA,DF,27.0,7.0,12,8,5,5,2,5,12,41.7,7,4,0,4,3,15,22,1,Matches,Bologna,Serie-A
1230,Martin Erlic,hr CRO,DF,26.0,3.7,2,0,0,2,0,1,2,50.0,1,5,4,1,2,4,9,0,Matches,Bologna,Serie-A
1231,Nicolò Cambiaghi,it ITA,FW,23.0,6.9,16,10,6,7,3,5,10,50.0,5,9,0,9,2,18,2,0,Matches,Bologna,Serie-A
1232,Jesper Karlsson,se SWE,FW,26.0,3.3,1,0,0,0,1,0,2,0.0,2,4,0,4,0,1,3,0,Matches,Bologna,Serie-A
1233,Kacper Urbanski,pl POL,MF,19.0,2.7,5,2,4,0,1,4,6,66.7,2,5,1,4,2,7,5,0,Matches,Bologna,Serie-A
1234,Samuel Iling-Junior,eng ENG,"FW,MF",20.0,1.3,3,2,1,1,1,0,1,0.0,1,1,0,1,2,5,2,0,Matches,Bologna,Serie-A
1235,Oussama El Azzouzi,ma MAR,MF,23.0,0.2,0,0,0,0,0,0,0,,0,0,0,0,2,2,0,0,Matches,Bologna,Serie-A
1236,Estanis,es ESP,FW,20.0,0.1,0,0,0,0,0,0,0,,0,0,0,0,0,0,0,0,Matches,Bologna,Serie-A
1237,Roberto Piccoli,it ITA,FW,23.0,34.7,13,9,2,6,5,3,12,25.0,9,12,4,8,3,16,31,0,Matches,Cagliari,Serie-A
1238,Sebastiano Luperto,it ITA,DF,27.0,36.0,48,27,31,16,1,18,28,64.3,10,30,15,15,33,81,161,1,Matches,Cagliari,Serie-A
1239,Gabriele Zappa,it ITA,DF,24.0,34.0,40,23,20,17,3,17,34,50.0,17,42,22,20,23,63,93,1,Matches,Cagliari,Serie-A
1240,Nadir Zortea,it ITA,"DF,MF",25.0,30.1,30,14,16,12,2,14,37,37.8,23,11,0,11,19,49,47,2,Matches,Cagliari,Serie-A
1241,Yerry Mina,co COL,DF,29.0,28.5,66,32,43,21,2,40,52,76.9,12,59,35,24,37,103,163,3,Matches,Cagliari,Serie-A
1242,Tommaso Augello,it ITA,DF,29.0,30.1,49,28,28,17,4,30,43,69.8,13,23,8,15,16,65,109,2,Matches,Cagliari,Serie-A
1243,Michel Ndary Adopo,fr FRA,MF,24.0,26.8,55,32,16,31,8,15,29,51.7,14,20,5,15,27,82,25,0,Matches,Cagliari,Serie-A
1244,Antoine Makoumbou,cg CGO,MF,26.0,23.9,42,23,28,11,3,19,25,76.0,6,26,5,21,17,59,28,0,Matches,Cagliari,Serie-A
1245,Zito Luvumbo,ao ANG,"FW,MF",22.0,17.8,10,6,4,3,3,6,19,31.6,13,5,0,5,4,14,4,0,Matches,Cagliari,Serie-A
1246,Elia Caprile,it ITA,GK,22.0,18.0,1,0,1,0,0,0,2,0.0,2,0,0,0,0,1,9,1,Matches,Cagliari,Serie-A
1247,Nicolas Viola,it ITA,"FW,MF",34.0,14.1,14,7,6,7,1,1,10,10.0,9,5,0,5,3,17,5,0,Matches,Cagliari,Serie-A
1248,Alessandro Deiola,it ITA,MF,28.0,15.9,31,20,11,17,3,10,32,31.3,22,26,12,14,13,44,38,0,Matches,Cagliari,Serie-A
1249,Răzvan Marin,ro ROU,MF,28.0,15.6,22,13,8,11,3,13,25,52.0,12,7,0,7,2,24,20,2,Matches,Cagliari,Serie-A
1250,Simone Scuffet,it ITA,GK,28.0,13.0,0,0,0,0,0,0,1,0.0,1,0,0,0,0,0,8,2,Matches,Cagliari,Serie-A
1251,Adam Obert,sk SVK,DF,21.0,12.0,31,18,12,17,2,16,27,59.3,11,19,7,12,23,54,48,2,Matches,Cagliari,Serie-A
1252,José Luis Palomino,ar ARG,DF,34.0,12.0,27,15,16,9,2,15,21,71.4,6,21,11,10,22,49,46,0,Matches,Cagliari,Serie-A
1253,Mattia Felici,it ITA,"MF,FW",23.0,10.3,17,12,8,7,2,4,11,36.4,7,10,0,10,7,24,7,1,Matches,Cagliari,Serie-A
1254,Gianluca Gaetano,it ITA,"MF,FW",24.0,11.2,11,8,4,6,1,5,15,33.3,10,8,0,8,6,17,8,0,Matches,Cagliari,Serie-A
1255,Matteo Prati,it ITA,MF,20.0,6.3,10,4,2,7,1,3,11,27.3,8,5,2,3,7,17,10,1,Matches,Cagliari,Serie-A
1256,Alen Sherri,al ALB,GK,26.0,6.9,1,0,1,0,0,1,2,50.0,1,0,0,0,1,2,1,0,Matches,Cagliari,Serie-A
1257,Paulo Azzi,br BRA,DF,30.0,4.7,11,9,3,6,2,5,9,55.6,4,5,2,3,5,16,11,0,Matches,Cagliari,Serie-A
1258,Florinel Coman,ro ROU,"FW,MF",26.0,2.9,5,3,3,1,1,2,2,100.0,0,2,0,2,1,6,3,0,Matches,Cagliari,Serie-A
1259,Leonardo Pavoletti,it ITA,"FW,MF",35.0,4.9,1,0,0,1,0,0,0,,0,4,1,3,0,1,3,0,Matches,Cagliari,Serie-A
1260,Gianluca Lapadula,pe PER,"FW,MF",34.0,3.4,2,0,1,0,1,0,1,0.0,1,0,0,0,0,2,1,0,Matches,Cagliari,Serie-A
1261,Mateusz Wieteska,pl POL,DF,27.0,2.0,1,0,0,1,0,1,1,100.0,0,3,2,1,7,8,6,0,Matches,Cagliari,Serie-A
1262,Kingstone Mutandwa,zm ZAM,"FW,MF",21.0,1.4,0,0,0,0,0,0,0,,0,0,0,0,0,0,0,0,Matches,Cagliari,Serie-A
1263,Giuseppe Ciocci,it ITA,GK,22.0,0.1,0,0,0,0,0,0,0,,0,0,0,0,0,0,0,0,Matches,Cagliari,Serie-A
1264,Nicola Pintus,it ITA,DF,19.0,0.0,0,0,0,0,0,0,0,,0,0,0,0,0,0,2,0,Matches,Cagliari,Serie-A
1265,Gabriel Strefezza,br BRA,"FW,MF",27.0,29.1,57,39,20,20,17,21,55,38.2,34,24,2,22,13,70,26,0,Matches,Como,Serie-A
1266,Nicolás Paz,ar ARG,"MF,FW",19.0,29.9,51,33,18,26,7,24,51,47.1,27,49,3,46,21,72,16,0,Matches,Como,Serie-A
1267,Marc-Oliver Kempf,de GER,DF,29.0,29.1,30,20,15,14,1,13,24,54.2,11,35,26,9,33,63,136,4,Matches,Como,Serie-A
1268,Lucas Da Cunha,fr FRA,MF,23.0,29.0,45,25,17,19,9,20,39,51.3,19,18,3,15,17,62,30,1,Matches,Como,Serie-A
1269,Edoardo Goldaniga,it ITA,DF,30.0,28.1,34,21,21,8,5,13,18,72.2,5,21,10,11,33,67,102,3,Matches,Como,Serie-A
1270,Patrick Cutrone,it ITA,FW,26.0,22.7,16,11,0,10,6,7,14,50.0,7,11,0,11,5,21,7,0,Matches,Como,Serie-A
1271,Alberto Moreno,es ESP,DF,32.0,19.2,25,11,17,8,0,12,26,46.2,14,12,3,9,14,39,40,2,Matches,Como,Serie-A
1272,Máximo Perrone,ar ARG,MF,21.0,20.6,38,27,19,14,5,13,38,34.2,25,15,2,13,20,58,43,0,Matches,Como,Serie-A
1273,Alberto Dossena,it ITA,DF,25.0,20.3,33,20,23,8,2,16,28,57.1,12,22,11,11,22,55,89,1,Matches,Como,Serie-A
1274,Alieu Fadera,gm GAM,"FW,DF",22.0,18.3,64,47,25,27,12,20,45,44.4,25,18,1,17,12,76,10,0,Matches,Como,Serie-A
1275,Jean Butez,fr FRA,GK,29.0,18.5,0,0,0,0,0,0,2,0.0,2,0,0,0,0,0,18,1,Matches,Como,Serie-A
1276,Maxence Caqueret,fr FRA,MF,24.0,12.1,36,21,14,18,4,20,38,52.6,18,15,1,14,7,43,4,1,Matches,Como,Serie-A
1277,Ignace Van Der Brempt,be BEL,DF,22.0,14.0,40,32,27,10,3,24,33,72.7,9,14,5,9,17,57,34,0,Matches,Como,Serie-A
1278,Assane Diao,sn SEN,"FW,MF",18.0,13.9,25,14,9,10,6,12,28,42.9,16,8,1,7,3,28,19,0,Matches,Como,Serie-A
1279,Pepe Reina,es ESP,GK,41.0,11.5,0,0,0,0,0,0,1,0.0,1,0,0,0,0,0,3,2,Matches,Como,Serie-A
1280,Álex Valle,es ESP,DF,20.0,11.4,26,12,12,12,2,15,21,71.4,6,13,2,11,8,34,42,0,Matches,Como,Serie-A
1281,Yannik Engelhardt,de GER,"MF,DF",23.0,12.9,30,12,13,13,4,16,27,59.3,11,13,6,7,11,41,27,0,Matches,Como,Serie-A
1282,Emil Audero,id IDN,GK,27.0,8.0,0,0,0,0,0,0,1,0.0,1,0,0,0,0,0,4,1,Matches,Como,Serie-A
1283,Mërgim Vojvoda,xk KVX,DF,29.0,8.0,9,6,5,4,0,7,9,77.8,2,7,4,3,3,12,18,0,Matches,Como,Serie-A
1284,Sergi Roberto,es ESP,MF,32.0,7.7,14,8,5,5,4,5,7,71.4,2,7,1,6,9,23,14,0,Matches,Como,Serie-A
1285,Ivan Smolčić,hr CRO,DF,23.0,7.0,16,9,8,7,1,9,13,69.2,4,8,2,6,10,26,24,0,Matches,Como,Serie-A
1286,Andrea Belotti,it ITA,FW,30.0,6.6,7,5,1,4,2,1,4,25.0,3,4,0,4,1,8,8,0,Matches,Como,Serie-A
1287,Anastasios Douvikas,gr GRE,FW,24.0,6.4,3,2,0,3,0,1,4,25.0,3,3,0,3,1,4,3,0,Matches,Como,Serie-A
1288,Jonathan Ikone,fr FRA,FW,26.0,6.0,15,9,4,3,8,6,11,54.5,5,5,1,4,0,15,1,1,Matches,Como,Serie-A
1289,Federico Barba,it ITA,DF,30.0,4.8,2,2,1,1,0,1,4,25.0,3,2,2,0,4,6,15,0,Matches,Como,Serie-A
1290,Alessio Iovine,it ITA,"DF,FW",33.0,4.3,5,2,2,3,0,4,10,40.0,6,7,1,6,3,8,21,1,Matches,Como,Serie-A
1291,Luca Mazzitelli,it ITA,MF,28.0,3.7,9,6,4,5,0,5,7,71.4,2,5,2,3,3,12,10,0,Matches,Como,Serie-A
1292,Matthias Braunöder,at AUT,MF,22.0,3.0,10,4,6,3,1,7,11,63.6,4,3,0,3,2,12,4,1,Matches,Como,Serie-A
1293,Marco Sala,it ITA,DF,25.0,2.9,9,6,5,3,1,5,8,62.5,3,2,0,2,1,10,9,0,Matches,Como,Serie-A
1294,Fellipe Jack,br BRA,DF,18.0,1.9,9,4,8,1,0,3,5,60.0,2,2,2,0,4,13,5,0,Matches,Como,Serie-A
1295,Daniele Baselli,it ITA,MF,32.0,0.2,0,0,0,0,0,0,0,,0,0,0,0,1,1,1,0,Matches,Como,Serie-A
1296,Alessandro Gabrielloni,it ITA,"FW,MF",30.0,1.6,0,0,0,0,0,0,3,0.0,3,0,0,0,0,0,1,0,Matches,Como,Serie-A
1297,Simone Verdi,it ITA,"MF,FW",32.0,1.3,2,2,0,1,1,0,2,0.0,2,2,0,2,0,2,2,0,Matches,Como,Serie-A
1298,Alberto Cerri,it ITA,FW,28.0,1.0,0,0,0,0,0,0,0,,0,2,0,2,0,0,1,0,Matches,Como,Serie-A
1299,Ben Lhassine Kone,ci CIV,MF,24.0,0.6,2,2,1,0,1,2,3,66.7,1,0,0,0,1,3,1,0,Matches,Como,Serie-A
1300,Ali Jasim,iq IRQ,"FW,DF",20.0,0.1,1,0,1,0,0,1,1,100.0,0,0,0,0,0,1,0,0,Matches,Como,Serie-A
1301,Dele Alli,eng ENG,MF,28.0,0.1,0,0,0,0,0,0,0,,0,0,0,0,0,0,0,0,Matches,Como,Serie-A
1302,Oliver Abildgaard,dk DEN,MF,28.0,0.1,0,0,0,0,0,0,0,,0,1,0,1,0,0,0,0,Matches,Como,Serie-A
1303,Emmanuel Gyasi,gh GHA,"DF,FW",30.0,35.7,52,29,32,14,6,24,38,63.2,14,27,9,18,11,63,77,0,Matches,Empoli,Serie-A
1304,Giuseppe Pezzella,it ITA,"DF,FW",26.0,32.0,55,31,28,17,10,29,57,50.9,28,32,8,24,15,70,110,2,Matches,Empoli,Serie-A
1305,Devis Vásquez,co COL,GK,26.0,32.0,0,0,0,0,0,0,0,,0,0,0,0,0,0,21,4,Matches,Empoli,Serie-A
1306,Mattia Viti,it ITA,DF,22.0,28.6,65,45,42,20,3,34,52,65.4,18,41,18,23,48,113,128,4,Matches,Empoli,Serie-A
1307,Saba Goglichidze,ge GEO,DF,20.0,28.2,64,37,36,25,3,25,51,49.0,26,36,17,19,33,97,97,3,Matches,Empoli,Serie-A
1308,Ardian Ismajli,al ALB,DF,27.0,27.9,30,23,21,9,0,16,20,80.0,4,35,24,11,56,86,249,3,Matches,Empoli,Serie-A
1309,Liam Henderson,sct SCO,MF,28.0,26.0,42,22,17,22,3,22,53,41.5,31,19,5,14,15,57,42,0,Matches,Empoli,Serie-A
1310,Sebastiano Esposito,it ITA,"FW,MF",22.0,25.9,57,29,15,31,11,18,35,51.4,17,20,2,18,12,69,14,0,Matches,Empoli,Serie-A
1311,Alberto Grassi,it ITA,MF,29.0,24.5,39,21,16,18,5,14,22,63.6,8,22,12,10,33,72,43,1,Matches,Empoli,Serie-A
1312,Lorenzo Colombo,it ITA,"FW,MF",22.0,24.8,31,14,7,16,8,7,21,33.3,14,33,2,31,2,33,16,1,Matches,Empoli,Serie-A
1313,Liberato Cacace,nz NZL,"MF,DF",23.0,24.8,37,25,20,13,4,22,31,71.0,9,26,9,17,22,59,59,0,Matches,Empoli,Serie-A
1314,Youssef Maleh,ma MAR,MF,25.0,16.8,45,23,17,23,5,17,34,50.0,17,25,6,19,16,61,25,0,Matches,Empoli,Serie-A
1315,Jacopo Fazzini,it ITA,MF,21.0,15.4,32,19,11,16,5,13,23,56.5,10,13,1,12,6,38,24,0,Matches,Empoli,Serie-A
1316,Faustino Anjorin,eng ENG,MF,22.0,12.4,29,13,9,14,6,9,18,50.0,9,18,3,15,13,42,20,0,Matches,Empoli,Serie-A
1317,Luca Marianucci,it ITA,DF,20.0,11.9,28,12,17,11,0,11,19,57.9,8,16,8,8,19,47,63,1,Matches,Empoli,Serie-A
1318,Ola Solbakken,no NOR,"MF,FW",25.0,8.4,7,4,0,6,1,3,6,50.0,3,0,0,0,2,9,8,0,Matches,Empoli,Serie-A
1319,Mattia De Sciglio,it ITA,DF,31.0,8.5,18,13,10,8,0,14,17,82.4,3,10,3,7,8,26,35,1,Matches,Empoli,Serie-A
1320,Christian Kouamé,ci CIV,"FW,MF",26.0,5.6,5,4,0,3,2,2,4,50.0,2,4,2,2,0,5,4,0,Matches,Empoli,Serie-A
1321,Marco Silvestri,it ITA,GK,33.0,5.0,0,0,0,0,0,0,2,0.0,2,0,0,0,0,0,3,1,Matches,Empoli,Serie-A
1322,Pietro Pellegri,it ITA,FW,23.0,4.6,7,2,0,6,1,2,4,50.0,2,2,0,2,0,7,3,0,Matches,Empoli,Serie-A
1323,Junior Sambia,fr FRA,"DF,FW",27.0,4.3,14,10,3,6,5,11,11,100.0,0,3,0,3,2,16,5,0,Matches,Empoli,Serie-A
1324,Nicolas Haas,ch SUI,MF,28.0,3.2,11,8,4,5,2,5,9,55.6,4,2,1,1,4,15,6,0,Matches,Empoli,Serie-A
1325,Sebastian Walukiewicz,pl POL,DF,24.0,2.0,1,0,1,0,0,0,1,0.0,1,3,3,0,1,2,15,0,Matches,Empoli,Serie-A
1326,Jacopo Seghetti,it ITA,GK,19.0,1.0,0,0,0,0,0,0,0,,0,0,0,0,0,0,0,0,Matches,Empoli,Serie-A
1327,Emmanuel Ekong,se SWE,"MF,FW",22.0,2.1,4,3,0,2,2,3,3,100.0,0,2,1,1,1,5,1,0,Matches,Empoli,Serie-A
1328,Ismael Konate,ci CIV,"FW,MF",18.0,1.3,4,2,4,0,0,2,3,66.7,1,3,2,1,0,4,1,0,Matches,Empoli,Serie-A
1329,Szymon Żurkowski,pl POL,MF,26.0,1.2,6,4,2,4,0,4,4,100.0,0,3,0,3,1,7,2,0,Matches,Empoli,Serie-A
1330,Viktor Kovalenko,ua UKR,MF,28.0,0.9,2,1,0,2,0,0,1,0.0,1,0,0,0,0,2,0,0,Matches,Empoli,Serie-A
1331,Tyronne Ebuehi,ng NGA,"DF,MF",28.0,0.8,3,2,1,2,0,1,1,100.0,0,1,0,1,2,5,0,0,Matches,Empoli,Serie-A
1332,Jacopo Bacci,it ITA,MF,19.0,0.3,1,0,1,0,0,1,1,100.0,0,0,0,0,1,2,1,0,Matches,Empoli,Serie-A
1333,Thomas Campaniello,it ITA,FW,16.0,0.3,0,0,0,0,0,0,2,0.0,2,0,0,0,0,0,0,0,Matches,Empoli,Serie-A
1334,Francesco Caputo,it ITA,FW,36.0,0.1,0,0,0,0,0,0,0,,0,0,0,0,0,0,0,0,Matches,Empoli,Serie-A
1335,Petar Stojanović,si SVN,MF,28.0,0.0,0,0,0,0,0,0,0,,0,0,0,0,0,0,0,0,Matches,Empoli,Serie-A
1336,Lorenzo Tosto,it ITA,DF,18.0,0.0,0,0,0,0,0,0,0,,0,0,0,0,0,0,0,0,Matches,Empoli,Serie-A
1337,David de Gea,es ESP,GK,33.0,35.0,1,0,1,0,0,1,1,100.0,0,0,0,0,0,1,12,0,Matches,Fiorentina,Serie-A
1338,Dodô,br BRA,DF,25.0,34.6,44,30,25,11,8,25,49,51.0,24,22,5,17,35,79,58,2,Matches,Fiorentina,Serie-A
1339,Luca Ranieri,it ITA,DF,25.0,34.1,42,24,28,12,2,20,25,80.0,5,47,32,15,28,70,154,1,Matches,Fiorentina,Serie-A
1340,Moise Kean,it ITA,FW,24.0,30.0,7,5,1,2,4,3,4,75.0,1,12,0,12,6,13,26,1,Matches,Fiorentina,Serie-A
1341,Robin Gosens,de GER,DF,30.0,28.0,56,32,31,17,8,25,44,56.8,19,34,11,23,18,74,91,0,Matches,Fiorentina,Serie-A
1342,Pietro Comuzzo,it ITA,DF,19.0,24.4,43,21,29,11,3,23,29,79.3,6,35,22,13,29,72,113,4,Matches,Fiorentina,Serie-A
1343,Danilo Cataldi,it ITA,MF,29.0,19.2,25,16,13,10,2,14,27,51.9,13,17,8,9,22,47,35,0,Matches,Fiorentina,Serie-A
1344,Rolando Mandragora,it ITA,MF,27.0,21.5,23,13,9,12,2,14,31,45.2,17,22,7,15,17,40,54,1,Matches,Fiorentina,Serie-A
1345,Lucas Beltrán,ar ARG,"FW,MF",23.0,21.7,23,10,10,7,6,7,21,33.3,14,15,2,13,5,28,14,0,Matches,Fiorentina,Serie-A
1346,Andrea Colpani,it ITA,"FW,MF",25.0,16.1,15,9,5,7,3,4,12,33.3,8,7,0,7,9,24,10,0,Matches,Fiorentina,Serie-A
1347,Albert Guðmundsson,is ISL,"FW,MF",27.0,14.1,9,5,2,4,3,7,17,41.2,10,5,0,5,6,15,9,1,Matches,Fiorentina,Serie-A
1348,Yacine Adli,fr FRA,MF,24.0,13.7,32,19,11,16,5,17,39,43.6,22,13,1,12,6,38,19,0,Matches,Fiorentina,Serie-A
1349,Marin Pongračić,hr CRO,DF,26.0,15.2,18,13,13,4,1,7,11,63.6,4,14,6,8,12,30,69,2,Matches,Fiorentina,Serie-A
1350,Pablo Marí,es ESP,DF,30.0,12.2,14,9,11,3,0,6,11,54.5,5,19,14,5,25,39,94,0,Matches,Fiorentina,Serie-A
1351,Fabiano Parisi,it ITA,"DF,MF",23.0,12.5,27,17,11,12,4,12,21,57.1,9,14,2,12,17,44,17,0,Matches,Fiorentina,Serie-A
1352,Edoardo Bove,it ITA,"MF,FW",22.0,9.5,24,17,7,14,3,14,28,50.0,14,12,0,12,6,30,8,0,Matches,Fiorentina,Serie-A
1353,Amir Richardson,ma MAR,MF,22.0,12.2,30,13,13,15,2,9,21,42.9,12,14,1,13,6,36,29,1,Matches,Fiorentina,Serie-A
1354,Nicolò Fagioli,it ITA,MF,23.0,10.7,19,10,8,9,2,9,22,40.9,13,11,2,9,5,24,12,2,Matches,Fiorentina,Serie-A
1355,Riccardo Sottil,it ITA,"FW,MF",25.0,9.3,5,4,3,1,1,3,4,75.0,1,1,0,1,4,9,3,0,Matches,Fiorentina,Serie-A
1356,Michael Folorunsho,it ITA,"FW,MF",26.0,7.2,19,12,9,6,4,8,20,40.0,12,9,1,8,4,23,10,0,Matches,Fiorentina,Serie-A
1357,Christian Kouamé,ci CIV,"FW,MF",26.0,6.9,13,8,4,4,5,0,3,0.0,3,3,1,2,2,15,10,0,Matches,Fiorentina,Serie-A
1358,Cristiano Biraghi,it ITA,DF,31.0,4.8,4,4,1,3,0,2,7,28.6,5,2,0,2,4,8,11,0,Matches,Fiorentina,Serie-A
1359,Cher Ndour,it ITA,"MF,DF",20.0,4.5,4,1,2,1,1,2,10,20.0,8,5,1,4,2,6,7,1,Matches,Fiorentina,Serie-A
1360,Lucas Martínez Quarta,ar ARG,DF,28.0,3.9,12,7,9,3,0,8,13,61.5,5,5,2,3,3,15,25,1,Matches,Fiorentina,Serie-A
1361,Nicolò Zaniolo,it ITA,FW,25.0,3.8,3,1,1,2,0,0,4,0.0,4,2,1,1,0,3,2,0,Matches,Fiorentina,Serie-A
1362,Pietro Terracciano,it ITA,GK,34.0,3.0,0,0,0,0,0,0,0,,0,0,0,0,0,0,0,0,Matches,Fiorentina,Serie-A
1363,Sofyan Amrabat,ma MAR,MF,27.0,2.0,3,2,1,2,0,2,2,100.0,0,1,1,0,0,3,2,0,Matches,Fiorentina,Serie-A
1364,Matias Moreno,ar ARG,DF,20.0,1.6,8,8,5,3,0,4,4,100.0,0,5,1,4,1,9,9,0,Matches,Fiorentina,Serie-A
1365,Jonathan Ikone,fr FRA,"FW,MF",26.0,3.7,5,2,3,2,0,2,4,50.0,2,3,0,3,1,6,1,0,Matches,Fiorentina,Serie-A
1366,Michael Kayode,it ITA,"DF,FW",20.0,1.4,1,1,1,0,0,0,0,,0,3,1,2,2,3,7,0,Matches,Fiorentina,Serie-A
1367,Antonín Barák,cz CZE,MF,29.0,0.6,2,0,0,2,0,0,2,0.0,2,1,1,0,0,2,0,0,Matches,Fiorentina,Serie-A
1368,Alessandro Bianco,it ITA,MF,21.0,0.2,0,0,0,0,0,0,1,0.0,1,0,0,0,0,0,0,0,Matches,Fiorentina,Serie-A
1369,Maat Daniel Caprini,it ITA,FW,18.0,0.1,0,0,0,0,0,0,0,,0,0,0,0,0,0,0,0,Matches,Fiorentina,Serie-A
1370,Tommaso Rubino,it ITA,MF,17.0,0.1,0,0,0,0,0,0,1,0.0,1,0,0,0,0,0,0,0,Matches,Fiorentina,Serie-A
1371,Morten Frendrup,dk DEN,MF,23.0,34.5,102,61,23,52,27,34,78,43.6,44,62,16,46,47,149,57,0,Matches,Genoa,Serie-A
1372,Aarón Martín,es ESP,DF,27.0,34.3,71,47,41,26,4,33,51,64.7,18,33,11,22,19,90,73,1,Matches,Genoa,Serie-A
1373,Johan Vásquez,mx MEX,DF,25.0,33.8,56,31,24,27,5,26,44,59.1,18,59,31,28,50,106,150,1,Matches,Genoa,Serie-A
1374,Andrea Pinamonti,it ITA,FW,25.0,31.7,10,6,0,7,3,2,8,25.0,6,16,4,12,1,11,28,2,Matches,Genoa,Serie-A
1375,Nicola Leali,it ITA,GK,31.0,29.0,0,0,0,0,0,0,0,,0,0,0,0,0,0,14,1,Matches,Genoa,Serie-A
1376,Koni De Winter,be BEL,DF,22.0,23.7,33,19,21,8,4,17,25,68.0,8,11,7,4,25,58,118,3,Matches,Genoa,Serie-A
1377,Stefano Sabelli,it ITA,DF,31.0,22.9,58,31,27,25,6,20,52,38.5,32,28,7,21,22,80,65,0,Matches,Genoa,Serie-A
1378,Morten Thorsby,no NOR,"MF,FW",28.0,21.1,49,30,19,20,10,17,29,58.6,12,22,1,21,5,54,28,1,Matches,Genoa,Serie-A
1379,Fabio Miretti,it ITA,"MF,FW",20.0,18.6,28,15,6,14,8,18,33,54.5,15,20,1,19,7,35,13,2,Matches,Genoa,Serie-A
1380,Milan Badelj,hr CRO,MF,35.0,16.4,29,16,14,10,5,15,35,42.9,20,19,7,12,20,49,43,0,Matches,Genoa,Serie-A
1381,Alessandro Zanoli,it ITA,"FW,DF",23.0,19.0,29,20,11,14,4,10,23,43.5,13,20,3,17,12,41,40,0,Matches,Genoa,Serie-A
1382,Mattia Bani,it ITA,DF,30.0,16.7,19,10,11,6,2,7,11,63.6,4,13,8,5,22,41,85,2,Matches,Genoa,Serie-A
1383,Patrizio Masini,it ITA,MF,23.0,17.1,54,29,18,26,10,19,40,47.5,21,26,8,18,15,69,37,0,Matches,Genoa,Serie-A
1384,Vitinha,pt POR,"FW,MF",24.0,14.8,23,8,12,6,5,11,30,36.7,19,14,2,12,12,35,22,0,Matches,Genoa,Serie-A
1385,Alan Matturro,uy URU,DF,19.0,10.0,11,6,6,5,0,3,14,21.4,11,10,3,7,14,25,38,0,Matches,Genoa,Serie-A
1386,Junior Messias,br BRA,"MF,FW",33.0,9.4,13,7,6,6,1,3,10,30.0,7,8,2,6,6,19,20,0,Matches,Genoa,Serie-A
1387,Brooke Norton-Cuffy,eng ENG,"DF,FW",20.0,8.0,12,7,9,3,0,9,11,81.8,2,12,2,10,3,15,12,0,Matches,Genoa,Serie-A
1388,Alessandro Vogliacco,it ITA,DF,25.0,7.9,15,3,7,7,1,10,12,83.3,2,11,7,4,9,24,20,0,Matches,Genoa,Serie-A
1389,Pierluigi Gollini,it ITA,GK,29.0,7.0,0,0,0,0,0,0,0,,0,1,0,1,0,0,2,1,Matches,Genoa,Serie-A
1390,Jeff Ekhator,it ITA,"FW,MF",17.0,8.5,7,4,4,1,2,4,9,44.4,5,10,1,9,2,9,5,0,Matches,Genoa,Serie-A
1391,Ruslan Malinovskyi,ua UKR,"MF,FW",31.0,4.3,12,8,4,7,1,3,6,50.0,3,2,0,2,1,13,4,0,Matches,Genoa,Serie-A
1392,Caleb Ekuban,gh GHA,FW,30.0,6.2,3,3,1,1,1,1,1,100.0,0,4,1,3,1,4,6,0,Matches,Genoa,Serie-A
1393,Honest Ahanor,it ITA,"DF,MF",16.0,3.0,7,5,2,3,2,7,10,70.0,3,4,0,4,1,8,9,0,Matches,Genoa,Serie-A
1394,Sebastian Otoa,dk DEN,DF,20.0,2.0,1,0,1,0,0,1,2,50.0,1,1,1,0,3,4,14,0,Matches,Genoa,Serie-A
1395,Jean Onana,cm CMR,MF,24.0,3.4,12,6,2,10,0,5,9,55.6,4,6,1,5,4,16,8,1,Matches,Genoa,Serie-A
1396,Maxwel Cornet,ci CIV,"FW,MF",27.0,2.7,2,1,1,0,1,0,1,0.0,1,1,1,0,2,4,2,0,Matches,Genoa,Serie-A
1397,Lior Kasa,il ISR,"MF,FW",18.0,2.6,4,4,2,2,0,2,5,40.0,3,4,1,3,3,7,5,0,Matches,Genoa,Serie-A
1398,Benjamin Siegrist,ch SUI,GK,32.0,1.7,0,0,0,0,0,0,0,,0,0,0,0,1,1,1,0,Matches,Genoa,Serie-A
1399,Lorenzo Venturino,it ITA,"FW,MF",18.0,1.9,5,3,4,0,1,3,6,50.0,3,3,0,3,0,5,5,0,Matches,Genoa,Serie-A
1400,Emil Bohinen,no NOR,MF,25.0,1.8,4,4,3,0,1,2,5,40.0,3,2,0,2,1,5,6,0,Matches,Genoa,Serie-A
1401,Filippo Melegoni,it ITA,"MF,FW",25.0,1.0,1,1,1,0,0,0,4,0.0,4,0,0,0,0,1,2,0,Matches,Genoa,Serie-A
1402,Alessandro Marcandalli,it ITA,DF,21.0,0.5,1,0,1,0,0,0,0,,0,0,0,0,0,1,2,0,Matches,Genoa,Serie-A
1403,Mario Balotelli,it ITA,"FW,MF",33.0,0.7,0,0,0,0,0,0,0,,0,0,0,0,0,0,1,0,Matches,Genoa,Serie-A
1404,David Akpan Ankeye,ng NGA,"FW,MF",22.0,0.5,0,0,0,0,0,0,1,0.0,1,0,0,0,0,0,1,0,Matches,Genoa,Serie-A
1405,Gastón Pereiro,uy URU,MF,29.0,0.3,1,0,0,1,0,1,1,100.0,0,0,0,0,0,1,1,0,Matches,Genoa,Serie-A
1406,Daniele Sommariva,it ITA,GK,27.0,0.3,0,0,0,0,0,0,0,,0,0,0,0,0,0,1,0,Matches,Genoa,Serie-A
1407,Federico Accornero,it ITA,MF,20.0,0.1,0,0,0,0,0,0,0,,0,0,0,0,0,0,0,0,Matches,Genoa,Serie-A
1408,Lorenzo Montipò,it ITA,GK,28.0,36.0,1,0,1,0,0,1,4,25.0,3,0,0,0,0,1,24,4,Matches,Hellas-Verona,Serie-A
1409,Jackson Tchatchoua,cm CMR,"DF,MF",22.0,35.2,50,31,34,13,3,28,43,65.1,15,21,9,12,14,64,75,2,Matches,Hellas-Verona,Serie-A
1410,Diego Coppola,it ITA,DF,20.0,32.5,66,36,48,14,4,28,40,70.0,12,44,24,20,72,138,194,2,Matches,Hellas-Verona,Serie-A
1411,Ondrej Duda,sk SVK,MF,29.0,26.6,46,27,21,22,3,29,64,45.3,35,28,9,19,31,77,30,4,Matches,Hellas-Verona,Serie-A
1412,Tomáš Suslov,sk SVK,"MF,FW",22.0,23.1,54,38,23,24,7,23,72,31.9,49,30,2,28,18,72,17,1,Matches,Hellas-Verona,Serie-A
1413,Amin Sarr,se SWE,FW,23.0,21.2,22,12,3,8,11,5,10,50.0,5,18,3,15,3,25,14,0,Matches,Hellas-Verona,Serie-A
1414,Domagoj Bradarić,hr CRO,DF,24.0,21.5,36,28,21,11,4,18,29,62.1,11,17,4,13,15,51,49,1,Matches,Hellas-Verona,Serie-A
1415,Paweł Dawidowicz,pl POL,"DF,MF",29.0,20.5,45,24,20,22,3,18,27,66.7,9,16,6,10,20,65,70,2,Matches,Hellas-Verona,Serie-A
1416,Daniele Ghilardi,it ITA,DF,21.0,22.5,44,29,27,17,0,25,41,61.0,16,29,15,14,30,74,106,0,Matches,Hellas-Verona,Serie-A
1417,Casper Tengstedt,dk DEN,FW,24.0,16.9,7,5,0,5,2,4,9,44.4,5,5,1,4,4,11,29,0,Matches,Hellas-Verona,Serie-A
1418,Reda Belahyane,ma MAR,MF,20.0,18.4,36,26,16,13,7,13,17,76.5,4,20,9,11,10,46,22,1,Matches,Hellas-Verona,Serie-A
1419,Darko Lazović,rs SRB,"DF,MF",33.0,16.2,21,10,5,14,2,11,28,39.3,17,19,3,16,11,32,39,0,Matches,Hellas-Verona,Serie-A
1420,Suat Serdar,de GER,MF,27.0,15.3,35,22,12,19,4,10,26,38.5,16,19,4,15,8,43,21,0,Matches,Hellas-Verona,Serie-A
1421,Nicolás Valentini,ar ARG,DF,23.0,12.5,35,23,22,12,1,20,31,64.5,11,15,7,8,15,50,97,0,Matches,Hellas-Verona,Serie-A
1422,Daniel Mosquera,co COL,FW,24.0,15.3,11,8,3,5,3,1,15,6.7,14,11,1,10,2,13,10,0,Matches,Hellas-Verona,Serie-A
1423,Giangiacomo Magnani,it ITA,DF,28.0,11.8,20,15,14,6,0,7,7,100.0,0,16,9,7,17,37,73,1,Matches,Hellas-Verona,Serie-A
1424,Flavius Daniliuc,at AUT,DF,23.0,11.2,26,21,14,9,3,15,24,62.5,9,10,3,7,7,33,27,0,Matches,Hellas-Verona,Serie-A
1425,Dailon Livramento,cv CPV,"FW,MF",23.0,10.4,15,11,2,7,6,7,13,53.8,6,10,2,8,3,18,9,0,Matches,Hellas-Verona,Serie-A
1426,Grigoris Kastanos,cy CYP,"MF,FW",26.0,9.7,23,16,8,7,8,9,21,42.9,12,17,2,15,7,30,8,0,Matches,Hellas-Verona,Serie-A
1427,Cheikh Tidiane Niasse,sn SEN,MF,24.0,8.4,18,15,6,12,0,10,19,52.6,9,17,4,13,17,35,17,2,Matches,Hellas-Verona,Serie-A
1428,Antoine Bernede,fr FRA,MF,25.0,6.6,15,8,4,9,2,10,16,62.5,6,6,1,5,5,20,3,0,Matches,Hellas-Verona,Serie-A
1429,Martin Frese,dk DEN,DF,26.0,6.1,18,11,7,10,1,7,13,53.8,6,5,1,4,8,26,16,1,Matches,Hellas-Verona,Serie-A
1430,Abdou Harroui,nl NED,"MF,FW",26.0,5.1,9,6,6,3,0,4,4,100.0,0,5,0,5,2,11,5,0,Matches,Hellas-Verona,Serie-A
1431,Daniel Bandeira,pt POR,MF,24.0,4.5,4,0,1,3,0,3,6,50.0,3,2,1,1,6,10,8,0,Matches,Hellas-Verona,Serie-A
1432,Davide Faraoni,it ITA,DF,32.0,2.9,10,9,5,5,0,3,9,33.3,6,7,3,4,2,12,12,1,Matches,Hellas-Verona,Serie-A
1433,Simone Perilli,it ITA,GK,29.0,2.0,0,0,0,0,0,0,0,,0,0,0,0,0,0,1,0,Matches,Hellas-Verona,Serie-A
1434,Daniel Oyegoke,eng ENG,DF,21.0,1.1,2,2,1,0,1,1,1,100.0,0,1,0,1,1,3,7,0,Matches,Hellas-Verona,Serie-A
1435,Mathis Lambourde,fr FRA,"FW,MF",18.0,1.0,3,1,2,1,0,1,3,33.3,2,3,0,3,0,3,1,0,Matches,Hellas-Verona,Serie-A
1436,Faride Alidou,de GER,"FW,MF",23.0,0.8,0,0,0,0,0,0,0,,0,1,0,1,1,1,3,1,Matches,Hellas-Verona,Serie-A
1437,Junior Ajayi,ci CIV,FW,19.0,0.1,0,0,0,0,0,0,0,,0,0,0,0,0,0,0,0,Matches,Hellas-Verona,Serie-A
1438,Alphadjo Cissè,it ITA,"FW,MF",17.0,0.1,0,0,0,0,0,0,0,,0,0,0,0,0,0,0,0,Matches,Hellas-Verona,Serie-A
1439,Yllan Okou,fr FRA,DF,21.0,0.0,0,0,0,0,0,0,0,,0,1,0,1,0,0,0,0,Matches,Hellas-Verona,Serie-A
1440,Yann Sommer,ch SUI,GK,35.0,33.0,0,0,0,0,0,0,0,,0,0,0,0,0,0,13,1,Matches,Internazionale,Serie-A
1441,Lautaro Martínez,ar ARG,FW,26.0,28.5,30,16,10,12,8,13,25,52.0,12,21,3,18,10,40,15,0,Matches,Internazionale,Serie-A
1442,Alessandro Bastoni,it ITA,DF,25.0,26.7,46,24,26,14,6,20,30,66.7,10,25,13,12,22,68,52,1,Matches,Internazionale,Serie-A
1443,Henrikh Mkhitaryan,am ARM,MF,35.0,26.6,43,24,17,16,10,20,45,44.4,25,29,5,24,17,60,41,0,Matches,Internazionale,Serie-A
1444,Nicolò Barella,it ITA,MF,27.0,27.7,50,31,19,20,11,26,59,44.1,33,26,3,23,12,62,16,1,Matches,Internazionale,Serie-A
1445,Federico Dimarco,it ITA,"DF,FW",26.0,24.2,25,14,10,12,3,10,19,52.6,9,24,4,20,14,39,33,2,Matches,Internazionale,Serie-A
1446,Marcus Thuram,fr FRA,FW,26.0,25.4,18,10,7,5,6,3,14,21.4,11,16,3,13,3,21,15,0,Matches,Internazionale,Serie-A
1447,Hakan Çalhanoğlu,tr TUR,MF,30.0,21.6,43,23,7,23,13,21,36,58.3,15,17,8,9,18,61,24,0,Matches,Internazionale,Serie-A
1448,Denzel Dumfries,nl NED,"DF,FW",28.0,21.7,25,18,12,9,4,14,27,51.9,13,31,8,23,6,31,26,1,Matches,Internazionale,Serie-A
1449,Matteo Darmian,it ITA,DF,34.0,19.8,28,17,12,12,4,14,25,56.0,11,14,6,8,10,38,39,0,Matches,Internazionale,Serie-A
1450,Francesco Acerbi,it ITA,DF,36.0,19.0,23,19,16,7,0,11,17,64.7,6,22,16,6,26,49,81,0,Matches,Internazionale,Serie-A
1451,Stefan de Vrij,nl NED,DF,32.0,19.2,18,12,12,5,1,9,12,75.0,3,19,11,8,23,41,89,0,Matches,Internazionale,Serie-A
1452,Benjamin Pavard,fr FRA,DF,28.0,17.6,29,16,12,12,5,18,25,72.0,7,16,12,4,16,45,52,0,Matches,Internazionale,Serie-A
1453,Yann Aurel Bisseck,de GER,DF,23.0,18.3,17,12,11,4,2,11,16,68.8,5,23,12,11,17,34,64,1,Matches,Internazionale,Serie-A
1454,Carlos Augusto,br BRA,DF,25.0,18.8,29,14,12,11,6,12,19,63.2,7,21,9,12,9,38,50,0,Matches,Internazionale,Serie-A
1455,Kristjan Asllani,al ALB,MF,22.0,11.0,14,3,8,4,2,8,22,36.4,14,8,1,7,9,23,13,1,Matches,Internazionale,Serie-A
1456,Davide Frattesi,it ITA,MF,24.0,13.6,17,8,6,10,1,10,18,55.6,8,12,4,8,5,22,14,1,Matches,Internazionale,Serie-A
1457,Piotr Zieliński,pl POL,MF,30.0,10.9,14,10,6,7,1,6,13,46.2,7,10,5,5,6,20,13,1,Matches,Internazionale,Serie-A
1458,Mehdi Taremi,ir IRN,FW,32.0,9.1,7,1,2,2,3,1,4,25.0,3,11,2,9,0,7,11,0,Matches,Internazionale,Serie-A
1459,Joaquín Correa,ar ARG,"FW,MF",29.0,8.1,11,5,4,7,0,4,13,30.8,9,3,0,3,0,11,6,0,Matches,Internazionale,Serie-A
1460,Marko Arnautović,at AUT,FW,35.0,6.1,7,6,1,3,3,3,5,60.0,2,3,0,3,1,8,1,0,Matches,Internazionale,Serie-A
1461,Josep Martinez,es ESP,GK,26.0,5.0,0,0,0,0,0,0,0,,0,0,0,0,0,0,0,0,Matches,Internazionale,Serie-A
1462,Nicola Zalewski,pl POL,"DF,MF",22.0,4.8,7,4,3,2,2,4,6,66.7,2,5,1,4,2,9,5,1,Matches,Internazionale,Serie-A
1463,Tajon Buchanan,ca CAN,"DF,FW",25.0,1.1,3,0,2,0,1,1,2,50.0,1,0,0,0,0,3,3,0,Matches,Internazionale,Serie-A
1464,Tomás Palacios,ar ARG,DF,21.0,0.1,0,0,0,0,0,0,0,,0,0,0,0,1,1,0,0,Matches,Internazionale,Serie-A
1465,Luka Topalović,si SVN,MF,18.0,0.1,1,1,0,1,0,0,0,,0,0,0,0,0,1,0,0,Matches,Internazionale,Serie-A
1466,Manuel Locatelli,it ITA,MF,26.0,31.4,72,49,29,35,8,32,56,57.1,24,58,20,38,23,95,77,0,Matches,Juventus,Serie-A
1467,Michele Di Gregorio,it ITA,GK,27.0,33.0,0,0,0,0,0,0,0,,0,0,0,0,1,1,14,0,Matches,Juventus,Serie-A
1468,Kenan Yıldız,tr TUR,"FW,MF",19.0,26.7,54,30,13,26,15,18,32,56.3,14,25,0,25,5,59,13,3,Matches,Juventus,Serie-A
1469,Weston McKennie,us USA,"MF,DF",25.0,25.7,33,12,18,11,4,13,22,59.1,9,28,8,20,14,47,37,0,Matches,Juventus,Serie-A
1470,Khéphren Thuram,fr FRA,MF,23.0,25.8,44,21,16,24,4,18,32,56.3,14,32,10,22,14,58,39,2,Matches,Juventus,Serie-A
1471,Federico Gatti,it ITA,DF,26.0,24.4,28,23,18,8,2,14,24,58.3,10,27,18,9,18,46,76,2,Matches,Juventus,Serie-A
1472,Pierre Kalulu,fr FRA,DF,24.0,26.0,41,25,29,9,3,18,24,75.0,6,27,15,12,17,58,68,1,Matches,Juventus,Serie-A
1473,Andrea Cambiaso,it ITA,"DF,FW",24.0,24.7,46,30,27,13,6,27,44,61.4,17,24,4,20,16,62,34,5,Matches,Juventus,Serie-A
1474,Teun Koopmeiners,nl NED,"MF,FW",26.0,22.2,32,16,6,19,7,10,30,33.3,20,36,14,22,8,40,26,2,Matches,Juventus,Serie-A
1475,Nicolás González,ar ARG,"FW,MF",26.0,19.4,24,13,10,9,5,9,25,36.0,16,16,4,12,9,33,37,2,Matches,Juventus,Serie-A
1476,Dušan Vlahović,rs SRB,FW,24.0,19.8,4,2,0,1,3,1,5,20.0,4,7,3,4,1,5,9,3,Matches,Juventus,Serie-A
1477,Nicolò Savona,it ITA,DF,21.0,19.2,29,13,19,9,1,13,25,52.0,12,12,3,9,11,40,38,0,Matches,Juventus,Serie-A
1478,Timothy Weah,us USA,"DF,FW",24.0,18.2,36,19,15,13,8,14,25,56.0,11,25,4,21,14,50,27,2,Matches,Juventus,Serie-A
1479,Randal Kolo Muani,fr FRA,FW,25.0,12.9,11,7,3,5,3,4,5,80.0,1,8,0,8,4,15,2,0,Matches,Juventus,Serie-A
1480,Francisco Conceição,pt POR,"FW,MF",21.0,14.9,23,14,6,9,8,13,30,43.3,17,7,0,7,6,29,6,0,Matches,Juventus,Serie-A
1481,Renato Veiga,pt POR,DF,21.0,12.1,17,12,7,9,1,9,14,64.3,5,17,13,4,19,36,81,0,Matches,Juventus,Serie-A
1482,Lloyd Kelly,eng ENG,DF,25.0,11.3,15,11,5,9,1,7,9,77.8,2,11,6,5,2,17,56,3,Matches,Juventus,Serie-A
1483,Samuel Mbangula,be BEL,FW,20.0,7.9,15,10,7,6,2,7,13,53.8,6,7,0,7,3,18,4,0,Matches,Juventus,Serie-A
1484,Danilo,br BRA,DF,33.0,6.5,10,4,7,2,1,5,10,50.0,5,4,3,1,9,19,21,1,Matches,Juventus,Serie-A
1485,Gleison Bremer,br BRA,DF,27.0,6.0,15,7,9,5,1,4,5,80.0,1,15,11,4,6,21,16,0,Matches,Juventus,Serie-A
1486,Juan David Cabal,co COL,DF,23.0,5.1,10,4,7,3,0,8,12,66.7,4,2,0,2,2,12,14,1,Matches,Juventus,Serie-A
1487,Nicolò Fagioli,it ITA,MF,23.0,6.3,14,10,7,6,1,6,9,66.7,3,4,0,4,2,16,5,0,Matches,Juventus,Serie-A
1488,Mattia Perin,it ITA,GK,31.0,5.0,0,0,0,0,0,0,0,,0,0,0,0,0,0,2,0,Matches,Juventus,Serie-A
1489,Douglas Luiz,br BRA,MF,26.0,5.9,13,8,7,5,1,6,9,66.7,3,5,2,3,4,17,5,0,Matches,Juventus,Serie-A
1490,Alberto costa,pt POR,DF,20.0,4.0,14,10,7,5,2,7,9,77.8,2,5,1,4,4,18,14,0,Matches,Juventus,Serie-A
1491,Jonas Rouhi,se SWE,DF,20.0,2.3,4,1,1,3,0,0,1,0.0,1,2,0,2,3,7,2,0,Matches,Juventus,Serie-A
1492,Vasilije Adžić,me MNE,"MF,FW",18.0,0.5,2,2,0,1,1,0,1,0.0,1,0,0,0,0,2,0,0,Matches,Juventus,Serie-A
1493,Diego Pugno,it ITA,FW,18.0,0.1,0,0,0,0,0,0,0,,0,0,0,0,0,0,0,0,Matches,Juventus,Serie-A
1494,Lorenzo Anghelè,it ITA,FW,19.0,0.1,0,0,0,0,0,0,0,,0,0,0,0,0,0,0,0,Matches,Juventus,Serie-A
1495,Mattéo Guendouzi,fr FRA,MF,25.0,36.3,37,21,13,19,5,20,47,42.6,27,34,9,25,32,69,50,2,Matches,Lazio,Serie-A
1496,Mattia Zaccagni,it ITA,FW,29.0,29.8,38,27,13,21,4,16,32,50.0,16,19,1,18,29,67,22,2,Matches,Lazio,Serie-A
1497,Mario Gila,es ESP,DF,23.0,30.5,55,37,35,18,2,37,56,66.1,19,20,13,7,28,83,115,4,Matches,Lazio,Serie-A
1498,Nicolò Rovella,it ITA,MF,22.0,30.2,84,50,39,38,7,41,79,51.9,38,19,4,15,47,131,46,3,Matches,Lazio,Serie-A
1499,Alessio Romagnoli,it ITA,DF,29.0,29.7,48,29,20,26,2,22,27,81.5,5,33,17,16,26,74,118,1,Matches,Lazio,Serie-A
1500,Ivan Provedel,it ITA,GK,30.0,29.0,0,0,0,0,0,0,0,,0,1,0,1,1,1,12,3,Matches,Lazio,Serie-A
1501,Gustav Isaksen,dk DEN,FW,23.0,24.6,16,9,7,8,1,7,28,25.0,21,22,2,20,10,26,21,1,Matches,Lazio,Serie-A
1502,Valentín Castellanos,ar ARG,FW,25.0,26.5,13,6,2,4,7,1,10,10.0,9,18,2,16,6,19,25,0,Matches,Lazio,Serie-A
1503,Boulaye Dia,sn SEN,"MF,FW",27.0,24.2,22,10,5,12,5,7,16,43.8,9,12,1,11,6,28,16,1,Matches,Lazio,Serie-A
1504,Adam Marušić,me MNE,DF,31.0,26.0,32,20,18,12,2,18,30,60.0,12,18,8,10,16,48,61,0,Matches,Lazio,Serie-A
1505,Nuno Tavares,pt POR,DF,24.0,18.7,28,21,15,8,5,14,34,41.2,20,21,3,18,21,49,44,2,Matches,Lazio,Serie-A
1506,Manuel Lazzari,it ITA,DF,30.0,15.6,26,16,13,11,2,14,24,58.3,10,9,5,4,10,36,19,0,Matches,Lazio,Serie-A
1507,Fisayo Dele-Bashiru,ng NGA,"MF,FW",23.0,10.5,10,6,3,3,4,2,6,33.3,4,10,2,8,4,14,5,0,Matches,Lazio,Serie-A
1508,Luca Pellegrini,it ITA,DF,25.0,11.9,23,11,11,10,2,17,32,53.1,15,10,3,7,19,42,32,0,Matches,Lazio,Serie-A
1509,Christos Mandas,gr GRE,GK,22.0,9.0,0,0,0,0,0,0,0,,0,0,0,0,0,0,4,0,Matches,Lazio,Serie-A
1510,Tijjani Noslin,nl NED,"FW,MF",25.0,9.6,6,5,2,1,3,1,8,12.5,7,15,1,14,1,7,7,0,Matches,Lazio,Serie-A
1511,Matías Vecino,uy URU,MF,32.0,9.7,13,7,3,9,1,4,18,22.2,14,9,3,6,5,18,15,0,Matches,Lazio,Serie-A
1512,Samuel Gigot,fr FRA,DF,30.0,7.6,4,3,1,3,0,0,1,0.0,1,8,6,2,13,17,36,0,Matches,Lazio,Serie-A
1513,Pedro,es ESP,"FW,MF",37.0,12.2,19,14,5,9,5,10,21,47.6,11,11,0,11,3,22,3,1,Matches,Lazio,Serie-A
1514,Loum Tchaouna,fr FRA,"FW,MF",20.0,7.3,8,4,2,2,4,3,9,33.3,6,5,1,4,4,12,14,2,Matches,Lazio,Serie-A
1515,Patric,es ESP,DF,31.0,6.7,9,6,6,3,0,6,10,60.0,4,3,2,1,3,12,22,1,Matches,Lazio,Serie-A
1516,Elseid Hysaj,al ALB,DF,30.0,4.7,11,6,6,5,0,3,3,100.0,0,5,2,3,5,16,21,0,Matches,Lazio,Serie-A
1517,Nicolò Casale,it ITA,DF,26.0,1.5,5,3,4,1,0,0,0,,0,4,3,1,1,6,2,0,Matches,Lazio,Serie-A
1518,Reda Belahyane,ma MAR,MF,20.0,2.2,8,6,8,0,0,6,6,100.0,0,3,2,1,1,9,5,0,Matches,Lazio,Serie-A
1519,Gaetano Castrovilli,it ITA,"MF,FW",27.0,1.6,5,2,3,1,1,2,4,50.0,2,3,0,3,3,8,1,0,Matches,Lazio,Serie-A
1520,Oliver Nielsen,dk DEN,DF,21.0,0.4,0,0,0,0,0,0,0,,0,1,0,1,1,1,2,0,Matches,Lazio,Serie-A
1521,Arijon Ibrahimović,de GER,MF,18.0,0.1,0,0,0,0,0,0,0,,0,0,0,0,0,0,0,0,Matches,Lazio,Serie-A
1522,Federico Baschirotto,it ITA,DF,27.0,38.0,37,25,30,5,2,22,28,78.6,6,44,32,12,23,60,237,2,Matches,Lecce,Serie-A
1523,Wladimiro Falcone,it ITA,GK,29.0,38.0,0,0,0,0,0,0,0,,0,0,0,0,0,0,29,3,Matches,Lecce,Serie-A
1524,Nikola Krstović,me MNE,FW,24.0,34.0,18,9,4,7,7,7,16,43.8,9,12,7,5,7,25,24,0,Matches,Lecce,Serie-A
1525,Antonino Gallo,it ITA,DF,24.0,29.0,65,42,46,15,4,34,62,54.8,28,33,6,27,20,85,133,0,Matches,Lecce,Serie-A
1526,Frederic Guilbert,fr FRA,DF,29.0,27.1,65,36,30,29,6,36,55,65.5,19,28,8,20,47,112,113,3,Matches,Lecce,Serie-A
1527,Lassana Coulibaly,ml MLI,MF,28.0,29.6,48,29,16,28,4,24,61,39.3,37,45,12,33,18,66,46,1,Matches,Lecce,Serie-A
1528,Kialonda,ao ANG,DF,26.0,23.8,34,12,24,10,0,12,17,70.6,5,44,28,16,32,66,132,1,Matches,Lecce,Serie-A
1529,Tete Morente,es ESP,"FW,MF",27.0,22.5,27,17,10,11,6,10,36,27.8,26,16,1,15,14,41,31,1,Matches,Lecce,Serie-A
1530,Santiago Pierotti,ar ARG,FW,23.0,21.5,46,24,22,18,6,23,51,45.1,28,31,5,26,14,60,32,0,Matches,Lecce,Serie-A
1531,Patrick Dorgu,dk DEN,"DF,FW",19.0,20.4,45,27,21,19,5,23,45,51.1,22,24,6,18,18,63,42,2,Matches,Lecce,Serie-A
1532,Ylber Ramadani,al ALB,MF,28.0,20.1,51,28,24,27,0,33,52,63.5,19,26,9,17,24,75,26,3,Matches,Lecce,Serie-A
1533,Balthazar Pierret,fr FRA,MF,24.0,19.1,51,31,25,23,3,13,30,43.3,17,19,5,14,19,70,31,1,Matches,Lecce,Serie-A
1534,Gaby Jean,fr FRA,DF,24.0,15.4,14,7,8,5,1,6,11,54.5,5,13,10,3,9,23,71,1,Matches,Lecce,Serie-A
1535,Hamza Rafia,tn TUN,MF,25.0,11.8,44,27,14,25,5,15,32,46.9,17,7,2,5,4,48,18,1,Matches,Lecce,Serie-A
1536,Þórir Jóhann Helgason,is ISL,MF,23.0,12.8,10,7,3,6,1,7,13,53.8,6,7,2,5,6,16,11,2,Matches,Lecce,Serie-A
1537,Ante Rebić,hr CRO,"FW,MF",30.0,8.8,12,9,5,5,2,3,9,33.3,6,7,1,6,2,14,4,1,Matches,Lecce,Serie-A
1538,Medon Berisha,al ALB,MF,20.0,8.0,12,8,7,3,2,4,8,50.0,4,6,0,6,11,23,5,2,Matches,Lecce,Serie-A
1539,Lameck Banda,zm ZAM,"FW,MF",23.0,6.8,8,5,4,2,2,3,12,25.0,9,7,0,7,2,10,8,1,Matches,Lecce,Serie-A
1540,Jesper Karlsson,se SWE,FW,26.0,5.5,3,2,3,0,0,2,8,25.0,6,2,0,2,0,3,4,0,Matches,Lecce,Serie-A
1541,Remi Oudin,fr FRA,"MF,FW",27.0,3.3,3,1,1,1,1,2,4,50.0,2,6,2,4,2,5,1,0,Matches,Lecce,Serie-A
1542,Mohamed Kaba,fr FRA,MF,22.0,5.0,13,8,7,5,1,8,10,80.0,2,11,4,7,4,17,10,1,Matches,Lecce,Serie-A
1543,Danilo Veiga,pt POR,DF,21.0,4.2,8,6,4,4,0,6,13,46.2,7,5,0,5,4,12,14,0,Matches,Lecce,Serie-A
1544,Konan N'dri,ci CIV,"FW,MF",23.0,3.4,3,3,0,0,3,2,3,66.7,1,4,0,4,1,4,0,0,Matches,Lecce,Serie-A
1545,Valentin Gendrey,fr FRA,DF,24.0,2.0,2,2,1,0,1,1,1,100.0,0,3,1,2,2,4,1,0,Matches,Lecce,Serie-A
1546,Andy Pelmard,fr FRA,DF,24.0,1.4,6,6,5,1,0,4,4,100.0,0,1,0,1,0,6,5,0,Matches,Lecce,Serie-A
1547,Tiago Gabriel,pt POR,DF,19.0,1.1,0,0,0,0,0,0,0,,0,4,2,2,0,0,11,0,Matches,Lecce,Serie-A
1548,Marco Sala,it ITA,DF,25.0,0.8,1,0,0,1,0,0,1,0.0,1,1,0,1,0,1,0,0,Matches,Lecce,Serie-A
1549,Kevin Bonifazi,it ITA,DF,28.0,0.7,1,1,1,0,0,1,1,100.0,0,1,1,0,2,3,3,0,Matches,Lecce,Serie-A
1550,Nicola Sansone,it ITA,"MF,FW",32.0,0.7,0,0,0,0,0,0,0,,0,0,0,0,0,0,0,0,Matches,Lecce,Serie-A
1551,Rareș-Cătălin Burnete,ro ROU,FW,20.0,0.3,0,0,0,0,0,0,1,0.0,1,0,0,0,0,0,0,0,Matches,Lecce,Serie-A
1552,Filip Marchwiński,pl POL,MF,22.0,0.2,0,0,0,0,0,0,0,,0,0,0,0,0,0,0,0,Matches,Lecce,Serie-A
1553,Mike Maignan,fr FRA,GK,29.0,36.6,0,0,0,0,0,0,1,0.0,1,1,0,1,0,0,19,3,Matches,Milan,Serie-A
1554,Tijjani Reijnders,nl NED,MF,26.0,34.8,26,13,6,14,6,10,26,38.5,16,22,4,18,38,64,28,2,Matches,Milan,Serie-A
1555,Theo Hernández,fr FRA,DF,26.0,30.0,36,28,23,10,3,21,39,53.8,18,25,10,15,17,53,75,3,Matches,Milan,Serie-A
1556,Youssouf Fofana,fr FRA,MF,25.0,27.8,56,34,20,31,5,26,52,50.0,26,32,9,23,19,75,24,3,Matches,Milan,Serie-A
1557,Christian Pulisic,us USA,"FW,MF",25.0,27.5,43,29,17,14,12,15,37,40.5,22,24,2,22,5,48,13,2,Matches,Milan,Serie-A
1558,Rafael Leão,pt POR,FW,25.0,25.8,16,10,4,8,4,11,29,37.9,18,15,1,14,6,22,4,0,Matches,Milan,Serie-A
1559,Matteo Gabbia,it ITA,DF,24.0,23.9,21,15,13,7,1,8,10,80.0,2,25,19,6,15,36,103,1,Matches,Milan,Serie-A
1560,Strahinja Pavlović,rs SRB,DF,23.0,20.7,52,31,32,19,1,29,50,58.0,21,17,6,11,16,68,82,0,Matches,Milan,Serie-A
1561,Malick Thiaw,de GER,DF,22.0,20.1,24,17,15,6,3,6,10,60.0,4,14,12,2,15,39,76,1,Matches,Milan,Serie-A
1562,Fikayo Tomori,eng ENG,DF,26.0,17.7,40,25,21,16,3,17,25,68.0,8,17,12,5,20,60,61,2,Matches,Milan,Serie-A
1563,Yunus Musah,us USA,"MF,FW",21.0,17.5,27,19,13,9,5,12,17,70.6,5,9,1,8,7,34,9,3,Matches,Milan,Serie-A
1564,Emerson,br BRA,DF,25.0,15.3,45,28,24,16,5,16,34,47.1,18,13,2,11,14,59,56,0,Matches,Milan,Serie-A
1565,Alejandro Jiménez,es ESP,"DF,FW",19.0,14.1,24,13,8,14,2,11,27,40.7,16,24,3,21,15,39,23,0,Matches,Milan,Serie-A
1566,Álvaro Morata,es ESP,"FW,MF",31.0,12.2,16,10,5,8,3,5,8,62.5,3,7,2,5,5,21,5,0,Matches,Milan,Serie-A
1567,Tammy Abraham,eng ENG,FW,26.0,13.1,17,11,2,10,5,6,8,75.0,2,13,0,13,2,19,16,0,Matches,Milan,Serie-A
1568,Ruben Loftus-Cheek,eng ENG,MF,28.0,11.5,19,8,6,9,4,6,12,50.0,6,3,0,3,3,22,20,0,Matches,Milan,Serie-A
1569,Samuel Chukwueze,ng NGA,"FW,MF",25.0,10.3,17,11,7,6,4,5,19,26.3,14,3,0,3,2,19,9,0,Matches,Milan,Serie-A
1570,João Félix,pt POR,MF,24.0,8.4,6,6,3,2,1,4,14,28.6,10,2,0,2,1,7,9,0,Matches,Milan,Serie-A
1571,Santiago Giménez,mx MEX,FW,23.0,7.4,5,3,0,4,1,3,4,75.0,1,3,1,2,1,6,13,0,Matches,Milan,Serie-A
1572,Kyle Walker,eng ENG,DF,34.0,7.3,17,9,12,4,1,13,17,76.5,4,9,5,4,9,26,15,1,Matches,Milan,Serie-A
1573,Luka Jović,rs SRB,"FW,MF",26.0,6.2,0,0,0,0,0,0,0,,0,2,1,1,1,1,3,0,Matches,Milan,Serie-A
1574,Filippo Terracciano,it ITA,"DF,MF",21.0,6.0,9,6,1,6,2,5,10,50.0,5,1,0,1,6,15,11,0,Matches,Milan,Serie-A
1575,Noah Okafor,ch SUI,FW,24.0,4.6,2,1,0,0,2,0,1,0.0,1,1,0,1,2,4,1,0,Matches,Milan,Serie-A
1576,Davide Calabria,it ITA,DF,27.0,3.5,10,7,10,0,0,4,7,57.1,3,1,0,1,8,18,8,0,Matches,Milan,Serie-A
1577,Ismaël Bennacer,dz ALG,MF,26.0,3.3,5,4,1,3,1,1,7,14.3,6,5,3,2,3,8,1,0,Matches,Milan,Serie-A
1578,Warren Bondo,fr FRA,MF,20.0,1.8,5,3,4,1,0,3,3,100.0,0,1,0,1,0,5,2,0,Matches,Milan,Serie-A
1579,Francesco Camarda,it ITA,"FW,MF",16.0,2.3,5,2,0,2,3,2,6,33.3,4,2,1,1,0,5,3,0,Matches,Milan,Serie-A
1580,Marco Sportiello,it ITA,GK,32.0,1.4,0,0,0,0,0,0,0,,0,0,0,0,0,0,1,0,Matches,Milan,Serie-A
1581,Riccardo Sottil,it ITA,"FW,MF",25.0,1.4,1,1,1,0,0,0,0,,0,0,0,0,0,1,0,0,Matches,Milan,Serie-A
1582,Davide Bartesaghi,it ITA,DF,18.0,1.3,4,2,1,1,2,4,4,100.0,0,1,1,0,3,7,1,0,Matches,Milan,Serie-A
1583,Alexis Saelemaekers,be BEL,"DF,FW",25.0,1.0,1,1,0,0,1,1,1,100.0,0,0,0,0,1,2,0,0,Matches,Milan,Serie-A
1584,Mattia Liberali,it ITA,MF,17.0,0.7,2,1,0,1,1,2,2,100.0,0,0,0,0,0,2,0,0,Matches,Milan,Serie-A
1585,Kevin Zeroli,it ITA,MF,19.0,0.1,1,1,0,1,0,0,0,,0,0,0,0,0,1,0,0,Matches,Milan,Serie-A
1586,Alessandro Florenzi,it ITA,FW,33.0,0.1,0,0,0,0,0,0,0,,0,0,0,0,0,0,0,0,Matches,Milan,Serie-A
1587,Bob Murphy Omoregbe,it ITA,MF,20.0,0.0,0,0,0,0,0,0,0,,0,0,0,0,0,0,0,0,Matches,Milan,Serie-A
1588,Giorgos Kyriakopoulos,gr GRE,DF,28.0,31.6,43,26,20,18,5,30,61,49.2,31,28,10,18,23,66,79,0,Matches,Monza,Serie-A
1589,Pedro Pereira,pt POR,DF,26.0,29.6,53,32,30,18,5,35,55,63.6,20,26,12,14,21,74,85,5,Matches,Monza,Serie-A
1590,Stefano Turati,it ITA,GK,22.0,29.7,0,0,0,0,0,0,1,0.0,1,0,0,0,0,0,21,2,Matches,Monza,Serie-A
1591,Alessandro Bianco,it ITA,MF,21.0,28.9,51,28,26,17,8,27,41,65.9,14,40,14,26,22,73,53,4,Matches,Monza,Serie-A
1592,Armando Izzo,it ITA,DF,32.0,27.1,40,15,30,9,1,18,36,50.0,18,38,28,10,45,85,101,0,Matches,Monza,Serie-A
1593,Andrea Carboni,it ITA,DF,23.0,24.3,60,35,39,17,4,35,53,66.0,18,31,16,15,27,87,106,4,Matches,Monza,Serie-A
1594,Dany Mota,pt POR,"FW,MF",26.0,23.4,13,3,2,3,8,4,8,50.0,4,18,1,17,9,22,27,3,Matches,Monza,Serie-A
1595,Pablo Marí,es ESP,DF,30.0,18.1,26,15,14,12,0,11,21,52.4,10,24,21,3,37,63,85,2,Matches,Monza,Serie-A
1596,Warren Bondo,fr FRA,MF,20.0,18.0,35,24,19,12,4,13,19,68.4,6,16,6,10,5,40,8,4,Matches,Monza,Serie-A
1597,Gianluca Caprari,it ITA,"MF,FW",31.0,18.3,19,11,8,8,3,7,14,50.0,7,14,0,14,8,27,2,1,Matches,Monza,Serie-A
1598,Samuele Birindelli,it ITA,"DF,MF",25.0,16.3,22,15,13,4,5,6,14,42.9,8,15,2,13,10,32,34,2,Matches,Monza,Serie-A
1599,Daniel Maldini,it ITA,"MF,FW",22.0,14.5,14,6,5,9,0,6,13,46.2,7,8,2,6,4,18,12,2,Matches,Monza,Serie-A
1600,Milan Đurić,ba BIH,FW,34.0,14.1,1,1,0,1,0,0,3,0.0,3,6,0,6,2,3,17,0,Matches,Monza,Serie-A
1601,Patrick Ciurria,it ITA,"MF,DF",29.0,12.3,22,14,11,7,4,4,11,36.4,7,13,3,10,6,28,22,0,Matches,Monza,Serie-A
1602,Danilo D'Ambrosio,it ITA,DF,35.0,12.2,28,15,17,10,1,14,23,60.9,9,12,8,4,15,43,36,2,Matches,Monza,Serie-A
1603,Jean-Daniel Akpa-Akpro,ci CIV,MF,31.0,10.7,30,18,15,14,1,9,21,42.9,12,19,6,13,13,43,16,1,Matches,Monza,Serie-A
1604,Luca Caldirola,it ITA,DF,33.0,9.7,11,7,8,3,0,4,7,57.1,3,9,6,3,11,22,43,1,Matches,Monza,Serie-A
1605,Matteo Pessina,it ITA,MF,27.0,9.5,15,4,3,11,1,9,14,64.3,5,6,0,6,12,27,7,0,Matches,Monza,Serie-A
1606,Semuel Pizzignacco,it ITA,GK,22.0,8.2,0,0,0,0,0,0,1,0.0,1,0,0,0,0,0,6,0,Matches,Monza,Serie-A
1607,Keita Baldé,sn SEN,FW,29.0,7.1,1,1,0,1,0,1,2,50.0,1,4,0,4,2,3,0,0,Matches,Monza,Serie-A
1608,Gaetano Castrovilli,it ITA,MF,27.0,6.6,12,7,10,2,0,4,11,36.4,7,8,2,6,2,14,9,0,Matches,Monza,Serie-A
1609,Kacper Urbanski,pl POL,MF,19.0,5.6,5,3,1,2,2,4,7,57.1,3,7,2,5,2,7,9,0,Matches,Monza,Serie-A
1610,Tomás Palacios,ar ARG,DF,21.0,5.0,11,5,9,2,0,9,13,69.2,4,7,2,5,8,19,17,2,Matches,Monza,Serie-A
1611,Kevin Zeroli,it ITA,MF,19.0,4.4,6,2,3,3,0,0,1,0.0,1,6,1,5,2,8,11,0,Matches,Monza,Serie-A
1612,Silvère Ganvoula M'Boussy,cg CGO,FW,28.0,3.6,0,0,0,0,0,0,1,0.0,1,1,0,1,1,1,5,0,Matches,Monza,Serie-A
1613,Samuele Vignato,it ITA,MF,20.0,5.2,6,3,0,4,2,3,7,42.9,4,1,0,1,0,6,6,0,Matches,Monza,Serie-A
1614,Stefan Lekovic,rs SRB,DF,20.0,4.1,9,4,6,2,1,5,13,38.5,8,4,4,0,7,16,5,0,Matches,Monza,Serie-A
1615,Arvid Brorsson,se SWE,DF,25.0,4.0,4,3,2,2,0,2,5,40.0,3,9,8,1,2,6,35,1,Matches,Monza,Serie-A
1616,Andrea Petagna,it ITA,FW,29.0,3.7,2,1,0,1,1,1,2,50.0,1,0,0,0,1,3,2,0,Matches,Monza,Serie-A
1617,Stefano Sensi,it ITA,MF,28.0,3.0,8,5,4,4,0,5,6,83.3,1,4,2,2,3,11,3,1,Matches,Monza,Serie-A
1618,Omari Forson,eng ENG,"MF,FW",20.0,2.5,3,3,1,2,0,1,3,33.3,2,3,0,3,1,4,1,0,Matches,Monza,Serie-A
1619,Kevin Martins,it ITA,"MF,DF",19.0,2.0,5,4,3,2,0,3,6,50.0,3,1,0,1,1,6,4,1,Matches,Monza,Serie-A
1620,Mirko Marić,hr CRO,"FW,MF",29.0,1.2,1,0,1,0,0,1,2,50.0,1,1,1,0,1,2,1,0,Matches,Monza,Serie-A
1621,Roberto Gagliardini,it ITA,"MF,DF",30.0,2.0,3,2,1,2,0,1,4,25.0,3,1,0,1,2,5,4,0,Matches,Monza,Serie-A
1622,Mattia Valoti,it ITA,MF,30.0,0.4,3,3,3,0,0,0,2,0.0,2,2,0,2,0,3,2,0,Matches,Monza,Serie-A
1623,Andrea Mazza,it ITA,GK,20.0,0.1,0,0,0,0,0,0,0,,0,0,0,0,0,0,0,0,Matches,Monza,Serie-A
1624,Amir Rrahmani,xk KVX,DF,30.0,37.8,39,31,19,19,1,16,25,64.0,9,43,26,17,27,66,179,2,Matches,Napoli,Serie-A
1625,Giovanni Di Lorenzo,it ITA,DF,30.0,37.0,66,44,35,25,6,42,65,64.6,23,19,6,13,31,97,85,1,Matches,Napoli,Serie-A
1626,Romelu Lukaku,be BEL,FW,31.0,31.6,4,2,0,2,2,1,4,25.0,3,7,2,5,1,5,17,0,Matches,Napoli,Serie-A
1627,Alex Meret,it ITA,GK,27.0,33.4,0,0,0,0,0,0,0,,0,1,0,1,0,0,16,0,Matches,Napoli,Serie-A
1628,Matteo Politano,it ITA,"FW,MF",30.0,31.2,29,15,17,11,1,15,43,34.9,28,21,1,20,13,42,50,1,Matches,Napoli,Serie-A
1629,Scott McTominay,sct SCO,MF,27.0,32.6,43,25,12,27,4,18,36,50.0,18,22,5,17,24,67,51,0,Matches,Napoli,Serie-A
1630,Andre-Frank Zambo Anguissa,cm CMR,MF,28.0,31.7,42,26,8,28,6,15,34,44.1,19,24,6,18,35,77,40,1,Matches,Napoli,Serie-A
1631,Stanislav Lobotka,sk SVK,MF,29.0,29.3,47,30,16,21,10,19,31,61.3,12,29,11,18,21,68,57,1,Matches,Napoli,Serie-A
1632,Mathías Olivera,uy URU,DF,26.0,26.3,63,35,31,25,7,32,53,60.4,21,36,12,24,28,91,74,1,Matches,Napoli,Serie-A
1633,Alessandro Buongiorno,it ITA,DF,25.0,21.4,39,23,26,12,1,24,32,75.0,8,30,18,12,35,74,73,2,Matches,Napoli,Serie-A
1634,Leonardo Spinazzola,it ITA,"DF,FW",31.0,16.9,17,10,6,9,2,10,23,43.5,13,12,1,11,9,26,31,1,Matches,Napoli,Serie-A
1635,Khvicha Kvaratskhelia,ge GEO,"FW,MF",23.0,13.1,15,9,4,10,1,4,15,26.7,11,13,0,13,4,19,7,0,Matches,Napoli,Serie-A
1636,David Neres,br BRA,FW,27.0,14.3,21,11,10,4,7,10,15,66.7,5,7,0,7,7,28,4,0,Matches,Napoli,Serie-A
1637,Billy Gilmour,sct SCO,MF,23.0,13.1,24,16,10,9,5,12,20,60.0,8,6,1,5,9,33,23,0,Matches,Napoli,Serie-A
1638,Juan Jesus,br BRA,DF,33.0,11.9,25,14,16,9,0,12,20,60.0,8,15,3,12,9,34,42,0,Matches,Napoli,Serie-A
1639,Giacomo Raspadori,it ITA,"FW,MF",24.0,12.3,18,9,6,10,2,8,12,66.7,4,10,2,8,3,21,13,0,Matches,Napoli,Serie-A
1640,Pasquale Mazzocchi,it ITA,"DF,FW",29.0,7.8,15,7,7,5,3,8,15,53.3,7,5,2,3,5,20,25,0,Matches,Napoli,Serie-A
1641,Elia Caprile,it ITA,GK,22.0,3.6,0,0,0,0,0,0,0,,0,0,0,0,0,0,2,0,Matches,Napoli,Serie-A
1642,Giovanni Simeone,ar ARG,FW,29.0,4.7,2,0,0,1,1,1,6,16.7,5,9,2,7,1,3,6,0,Matches,Napoli,Serie-A
1643,Cyril Ngonge,be BEL,FW,24.0,2.4,8,5,4,4,0,4,7,57.1,3,3,0,3,2,10,4,0,Matches,Napoli,Serie-A
1644,Philip Billing,dk DEN,MF,28.0,2.2,9,6,4,4,1,1,4,25.0,3,4,1,3,4,13,6,0,Matches,Napoli,Serie-A
1645,Rafa Marín,es ESP,DF,22.0,1.6,1,0,1,0,0,1,2,50.0,1,1,1,0,1,2,4,0,Matches,Napoli,Serie-A
1646,Simone Scuffet,it ITA,GK,28.0,1.0,0,0,0,0,0,0,0,,0,0,0,0,0,0,2,0,Matches,Napoli,Serie-A
1647,Noah Okafor,ch SUI,"FW,MF",24.0,0.4,3,2,3,0,0,2,2,100.0,0,0,0,0,0,3,1,0,Matches,Napoli,Serie-A
1648,Michael Folorunsho,it ITA,"FW,MF",26.0,0.4,3,2,0,3,0,2,4,50.0,2,0,0,0,1,4,1,1,Matches,Napoli,Serie-A
1649,Walid Cheddira,ma MAR,FW,26.0,0.1,0,0,0,0,0,0,0,,0,0,0,0,0,0,0,0,Matches,Napoli,Serie-A
1650,Alessio Zerbin,it ITA,"FW,DF",25.0,0.0,2,1,2,0,0,1,1,100.0,0,0,0,0,0,2,0,0,Matches,Napoli,Serie-A
1651,Zion Suzuki,jp JPN,GK,21.0,36.8,1,0,1,0,0,1,2,50.0,1,0,0,0,0,1,35,4,Matches,Parma,Serie-A
1652,Simon Sohm,ch SUI,MF,23.0,33.2,28,17,11,13,4,16,35,45.7,19,11,3,8,26,54,36,0,Matches,Parma,Serie-A
1653,Emanuele Valeri,it ITA,DF,25.0,31.9,51,31,33,15,3,30,61,49.2,31,31,10,21,29,80,103,4,Matches,Parma,Serie-A
1654,Enrico Del Prato,it ITA,DF,24.0,32.7,33,17,24,8,1,19,26,73.1,7,69,35,34,19,52,132,2,Matches,Parma,Serie-A
1655,Ange-Yoan Bonny,fr FRA,FW,20.0,28.1,34,16,4,23,7,8,14,57.1,6,17,2,15,3,37,17,0,Matches,Parma,Serie-A
1656,Mandela Keita,be BEL,MF,22.0,20.3,44,25,13,25,6,18,35,51.4,17,18,7,11,21,65,29,2,Matches,Parma,Serie-A
1657,Botond Balogh,hu HUN,DF,22.0,22.8,36,16,22,13,1,20,28,71.4,8,34,26,8,25,61,141,2,Matches,Parma,Serie-A
1658,Dennis Man,ro ROU,"FW,MF",25.0,22.2,13,6,7,3,3,6,24,25.0,18,15,3,12,8,21,11,0,Matches,Parma,Serie-A
1659,Matteo Cancellieri,it ITA,"FW,MF",22.0,15.8,26,16,15,9,2,11,32,34.4,21,15,1,14,13,39,30,0,Matches,Parma,Serie-A
1660,Lautaro Valenti,ar ARG,DF,25.0,17.3,17,12,13,3,1,7,9,77.8,2,26,13,13,13,30,94,1,Matches,Parma,Serie-A
1661,Adrian Bernabe,es ESP,MF,23.0,16.1,29,18,16,9,4,14,32,43.8,18,22,9,13,7,36,26,1,Matches,Parma,Serie-A
1662,Valentin Mihaila,ro ROU,"FW,MF",24.0,14.3,29,15,8,13,8,9,22,40.9,13,18,0,18,8,37,6,0,Matches,Parma,Serie-A
1663,Hernani,br BRA,MF,30.0,14.7,47,26,25,18,4,27,50,54.0,23,26,6,20,19,66,12,1,Matches,Parma,Serie-A
1664,Giovanni Leoni,it ITA,DF,17.0,13.3,14,6,10,4,0,5,10,50.0,5,20,11,9,15,29,63,1,Matches,Parma,Serie-A
1665,Woyo Coulibaly,ml MLI,DF,25.0,12.0,13,10,9,2,2,5,11,45.5,6,19,2,17,8,21,25,0,Matches,Parma,Serie-A
1666,Antoine Hainaut,fr FRA,"DF,FW",22.0,13.4,26,14,15,8,3,9,13,69.2,4,17,4,13,15,41,59,1,Matches,Parma,Serie-A
1667,Pontus Almqvist,se SWE,"FW,MF",25.0,12.4,17,13,7,7,3,8,17,47.1,9,13,0,13,19,36,8,0,Matches,Parma,Serie-A
1668,Alessandro Vogliacco,it ITA,DF,25.0,8.6,5,2,5,0,0,3,5,60.0,2,15,10,5,3,8,37,0,Matches,Parma,Serie-A
1669,Mateo Pellegrino,ar ARG,FW,23.0,8.2,3,2,1,2,0,1,4,25.0,3,6,1,5,1,4,6,0,Matches,Parma,Serie-A
1670,Nahuel Estévez,ar ARG,MF,28.0,7.3,16,6,7,8,1,6,15,40.0,9,9,2,7,3,19,26,0,Matches,Parma,Serie-A
1671,Alessandro Circati,au AUS,DF,20.0,6.0,7,5,6,1,0,1,2,50.0,1,5,4,1,3,10,42,1,Matches,Parma,Serie-A
1672,Mohamed Haj,tn TUN,MF,19.0,5.0,3,1,2,1,0,1,2,50.0,1,3,1,2,4,7,5,0,Matches,Parma,Serie-A
1673,Jacob Ondrejka,se SWE,"MF,FW",21.0,4.7,12,6,5,7,0,10,12,83.3,2,2,0,2,7,19,2,0,Matches,Parma,Serie-A
1674,Milan Đurić,ba BIH,FW,34.0,3.0,0,0,0,0,0,0,2,0.0,2,3,0,3,0,0,2,0,Matches,Parma,Serie-A
1675,Adrian Benedyczak,pl POL,"FW,MF",23.0,2.4,0,0,0,0,0,0,1,0.0,1,3,1,2,0,0,8,0,Matches,Parma,Serie-A
1676,Yordan Osorio,ve VEN,DF,30.0,1.9,5,3,4,1,0,2,2,100.0,0,3,1,2,4,9,6,1,Matches,Parma,Serie-A
1677,Drissa Camara,ci CIV,"MF,FW",22.0,5.0,9,7,2,6,1,1,10,10.0,9,8,0,8,3,12,1,0,Matches,Parma,Serie-A
1678,Leandro Chichizola,ar ARG,GK,34.0,1.0,0,0,0,0,0,0,0,,0,0,0,0,0,0,2,0,Matches,Parma,Serie-A
1679,Mateusz Kowalski,pl POL,MF,19.0,0.6,0,0,0,0,0,0,0,,0,1,0,1,0,0,1,0,Matches,Parma,Serie-A
1680,Gabriel Charpentier,cg CGO,FW,25.0,3.0,4,3,2,1,1,3,4,75.0,1,3,0,3,0,4,9,0,Matches,Parma,Serie-A
1681,Mathias Løvik,no NOR,"DF,FW",20.0,1.0,1,0,0,1,0,1,3,33.3,2,1,1,0,2,3,3,0,Matches,Parma,Serie-A
1682,Wylan Cyprien,fr FRA,MF,29.0,0.3,0,0,0,0,0,0,1,0.0,1,1,0,1,1,1,0,0,Matches,Parma,Serie-A
1683,Obite N'Dicka,ci CIV,DF,24.0,38.0,32,26,17,15,0,14,21,66.7,7,46,30,16,33,65,150,2,Matches,Roma,Serie-A
1684,Mile Svilar,rs SRB,GK,24.0,38.0,0,0,0,0,0,0,0,,0,0,0,0,0,0,12,2,Matches,Roma,Serie-A
1685,Angeliño,es ESP,DF,27.0,35.3,46,24,20,24,2,17,34,50.0,17,33,9,24,28,74,98,0,Matches,Roma,Serie-A
1686,Gianluca Mancini,it ITA,DF,28.0,34.9,42,26,22,18,2,20,34,58.8,14,22,16,6,35,77,103,0,Matches,Roma,Serie-A
1687,Manu Koné,fr FRA,MF,23.0,28.6,41,26,17,17,7,19,40,47.5,21,27,4,23,24,65,28,0,Matches,Roma,Serie-A
1688,Artem Dovbyk,ua UKR,FW,27.0,26.9,4,2,0,1,3,0,4,0.0,4,10,3,7,2,6,12,0,Matches,Roma,Serie-A
1689,Zeki Çelik,tr TUR,DF,27.0,25.1,62,37,21,31,10,23,43,53.5,20,28,9,19,15,77,84,3,Matches,Roma,Serie-A
1690,Bryan Cristante,it ITA,MF,29.0,22.7,48,29,18,24,6,15,26,57.7,11,20,10,10,19,67,36,1,Matches,Roma,Serie-A
1691,Matìas Soulé,ar ARG,"MF,DF",21.0,19.8,26,16,12,7,7,10,23,43.5,13,25,3,22,9,35,25,0,Matches,Roma,Serie-A
1692,Lorenzo Pellegrini,it ITA,MF,28.0,18.1,24,16,5,13,6,8,19,42.1,11,8,1,7,6,30,22,0,Matches,Roma,Serie-A
1693,Alexis Saelemaekers,be BEL,"DF,FW",25.0,15.4,33,20,22,7,4,18,35,51.4,17,12,1,11,9,42,8,1,Matches,Roma,Serie-A
1694,Paulo Dybala,ar ARG,"FW,MF",30.0,15.7,17,7,3,9,5,8,19,42.1,11,12,1,11,2,19,2,0,Matches,Roma,Serie-A
1695,Leandro Paredes,ar ARG,MF,30.0,15.3,26,14,9,12,5,16,32,50.0,16,14,5,9,19,45,33,2,Matches,Roma,Serie-A
1696,Stephan El Shaarawy,it ITA,"DF,MF",31.0,12.2,16,12,4,6,6,6,12,50.0,6,4,0,4,10,26,13,0,Matches,Roma,Serie-A
1697,Niccolò Pisilli,it ITA,MF,19.0,13.6,24,11,11,8,5,12,22,54.5,10,14,3,11,11,35,16,0,Matches,Roma,Serie-A
1698,Eldor Shomurodov,uz UZB,"FW,MF",29.0,12.2,14,6,2,7,5,3,6,50.0,3,10,1,9,3,17,5,0,Matches,Roma,Serie-A
1699,Mats Hummels,de GER,DF,35.0,10.2,30,15,16,14,0,11,18,61.1,7,12,4,8,26,56,43,0,Matches,Roma,Serie-A
1700,Tommaso Baldanzi,it ITA,"MF,FW",21.0,9.2,12,4,5,4,3,4,12,33.3,8,4,0,4,6,18,8,0,Matches,Roma,Serie-A
1701,Devyne Rensch,nl NED,DF,21.0,5.2,17,13,8,8,1,9,10,90.0,1,5,3,2,7,24,12,1,Matches,Roma,Serie-A
1702,Nicola Zalewski,pl POL,"DF,FW",22.0,5.9,8,6,3,2,3,2,7,28.6,5,7,2,5,4,12,8,2,Matches,Roma,Serie-A
1703,Enzo Le Fée,fr FRA,MF,24.0,3.5,7,4,5,2,0,2,6,33.3,4,9,3,6,5,12,2,0,Matches,Roma,Serie-A
1704,Mario Hermoso,es ESP,DF,29.0,2.8,2,1,2,0,0,0,1,0.0,1,1,1,0,4,6,13,0,Matches,Roma,Serie-A
1705,Lucas Gourna-Douath,fr FRA,MF,20.0,2.5,9,4,5,4,0,2,6,33.3,4,1,1,0,0,9,2,0,Matches,Roma,Serie-A
1706,Saud Abdulhamid,sa KSA,DF,25.0,2.3,3,2,2,0,1,1,1,100.0,0,2,0,2,2,5,0,0,Matches,Roma,Serie-A
1707,Anass Salah-Eddine,nl NED,DF,22.0,1.7,1,1,1,0,0,0,0,,0,0,0,0,1,2,2,2,Matches,Roma,Serie-A
1708,Victor Nelsson,dk DEN,DF,25.0,2.1,5,4,3,1,1,3,5,60.0,2,1,0,1,2,7,9,0,Matches,Roma,Serie-A
1709,Samuel Dahl,se SWE,"DF,MF",24.0,0.5,2,2,0,2,0,1,2,50.0,1,2,0,2,0,2,0,0,Matches,Roma,Serie-A
1710,Tammy Abraham,eng ENG,FW,26.0,0.0,0,0,0,0,0,0,1,0.0,1,0,0,0,0,0,0,0,Matches,Roma,Serie-A
1711,Vanja Milinković-Savić,rs SRB,GK,27.0,37.0,1,0,1,0,0,1,3,33.3,2,0,0,0,0,1,18,4,Matches,Torino,Serie-A
1712,Samuele Ricci,it ITA,MF,22.0,31.4,35,21,15,14,6,18,28,64.3,10,23,9,14,25,60,51,2,Matches,Torino,Serie-A
1713,Saúl Coco,gq EQG,DF,25.0,31.6,46,26,31,14,1,19,30,63.3,11,49,31,18,38,84,157,4,Matches,Torino,Serie-A
1714,Che Adams,sct SCO,FW,28.0,29.5,12,6,2,4,6,1,7,14.3,6,13,6,7,2,14,18,0,Matches,Torino,Serie-A
1715,Guillermo Maripán,cl CHI,DF,30.0,26.0,40,23,25,14,1,21,33,63.6,12,27,13,14,41,81,138,1,Matches,Torino,Serie-A
1716,Valentino Lazaro,at AUT,"DF,FW",28.0,25.6,26,12,10,12,4,15,30,50.0,15,28,5,23,11,37,38,1,Matches,Torino,Serie-A
1717,Nikola Vlašić,hr CRO,"MF,FW",26.0,23.5,37,19,11,17,9,12,30,40.0,18,15,3,12,9,46,15,0,Matches,Torino,Serie-A
1718,Adam Masina,ma MAR,DF,30.0,21.3,33,15,22,10,1,23,40,57.5,17,28,15,13,27,60,95,2,Matches,Torino,Serie-A
1719,Sebastian Walukiewicz,pl POL,DF,24.0,18.5,38,20,18,16,4,23,31,74.2,8,21,8,13,18,56,60,0,Matches,Torino,Serie-A
1720,Karol Linetty,pl POL,MF,29.0,17.1,39,23,17,19,3,20,41,48.8,21,14,5,9,12,51,31,1,Matches,Torino,Serie-A
1721,Antonio Sanabria,py PAR,FW,28.0,14.6,3,3,1,1,1,1,4,25.0,3,6,1,5,1,4,13,0,Matches,Torino,Serie-A
1722,Gvidas Gineitis,lt LTU,MF,20.0,15.9,25,15,8,10,7,13,25,52.0,12,16,6,10,18,43,32,0,Matches,Torino,Serie-A
1723,Marcus Pedersen,no NOR,DF,24.0,15.1,13,8,6,6,1,10,16,62.5,6,11,2,9,13,26,34,1,Matches,Torino,Serie-A
1724,Borna Sosa,hr CRO,DF,26.0,13.1,26,19,14,7,5,16,25,64.0,9,13,6,7,14,40,33,0,Matches,Torino,Serie-A
1725,Cristiano Biraghi,it ITA,DF,31.0,12.9,16,10,9,3,4,11,18,61.1,7,15,4,11,8,24,44,0,Matches,Torino,Serie-A
1726,Cesare Casadei,it ITA,MF,21.0,11.3,12,5,4,8,0,5,10,50.0,5,4,2,2,5,17,26,0,Matches,Torino,Serie-A
1727,Mërgim Vojvoda,xk KVX,DF,29.0,12.3,18,10,5,9,4,7,14,50.0,7,13,3,10,7,25,24,1,Matches,Torino,Serie-A
1728,Elif Elmas,mk MKD,"FW,MF",24.0,11.3,10,7,3,5,2,4,10,40.0,6,8,2,6,6,16,5,2,Matches,Torino,Serie-A
1729,Yann Karamoh,fr FRA,"MF,FW",26.0,11.6,5,2,2,1,2,4,9,44.4,5,10,2,8,3,8,5,0,Matches,Torino,Serie-A
1730,Ivan Ilić,rs SRB,MF,23.0,10.2,5,2,0,4,1,2,8,25.0,6,0,0,0,5,10,10,0,Matches,Torino,Serie-A
1731,Adrien Tameze,cm CMR,"MF,DF",30.0,7.2,5,2,2,3,0,1,10,10.0,9,8,5,3,10,15,8,1,Matches,Torino,Serie-A
1732,Duván Zapata,co COL,FW,33.0,6.5,7,5,2,0,5,0,3,0.0,3,2,1,1,2,9,7,0,Matches,Torino,Serie-A
1733,Ali Dembélé,fr FRA,DF,20.0,4.3,9,5,6,3,0,4,4,100.0,0,6,2,4,1,10,11,1,Matches,Torino,Serie-A
1734,Alberto Paleari,it ITA,GK,31.0,1.0,0,0,0,0,0,0,0,,0,0,0,0,0,0,2,0,Matches,Torino,Serie-A
1735,Raoul Bellanova,it ITA,DF,24.0,1.0,0,0,0,0,0,0,1,0.0,1,0,0,0,0,0,4,0,Matches,Torino,Serie-A
1736,Eybi Nije,se SWE,"FW,MF",19.0,4.4,5,1,3,1,1,0,3,0.0,3,5,1,4,0,5,1,0,Matches,Torino,Serie-A
1737,Sergiu Perciun,md MDA,"FW,MF",18.0,1.7,2,2,0,0,2,1,4,25.0,3,2,0,2,1,3,2,0,Matches,Torino,Serie-A
1738,Alessio Cacciamani,it ITA,"MF,DF",17.0,0.3,0,0,0,0,0,0,0,,0,0,0,0,1,1,0,0,Matches,Torino,Serie-A
1739,Tommaso Gabellini,it ITA,FW,17.0,0.1,0,0,0,0,0,0,0,,0,0,0,0,0,0,0,0,Matches,Torino,Serie-A
1740,Saba Sazonov,ge GEO,DF,22.0,0.0,0,0,0,0,0,0,0,,0,1,1,0,0,0,0,0,Matches,Torino,Serie-A
1741,Aaron Ciammaglichella,it ITA,MF,19.0,0.0,0,0,0,0,0,0,0,,0,0,0,0,0,0,0,0,Matches,Torino,Serie-A
1742,Jesper Karlström,se SWE,MF,29.0,35.4,61,34,32,21,8,25,51,49.0,26,28,11,17,35,96,82,5,Matches,Udinese,Serie-A
1743,Jaka Bijol,si SVN,DF,25.0,32.9,43,25,32,10,1,21,40,52.5,19,38,18,20,38,81,182,1,Matches,Udinese,Serie-A
1744,Sandi Lovrić,si SVN,MF,26.0,25.6,46,29,25,17,4,22,44,50.0,22,33,5,28,22,68,27,1,Matches,Udinese,Serie-A
1745,Kingsley Ehizibue,nl NED,DF,29.0,27.8,55,35,31,18,6,25,41,61.0,16,41,14,27,23,78,70,5,Matches,Udinese,Serie-A
1746,Lorenzo Lucca,it ITA,FW,23.0,26.1,10,6,3,2,5,5,11,45.5,6,18,1,17,7,17,27,0,Matches,Udinese,Serie-A
1747,Maduka Okoye,ng NGA,GK,24.0,25.0,0,0,0,0,0,0,0,,0,0,0,0,0,0,12,1,Matches,Udinese,Serie-A
1748,Hassane Kamara,ci CIV,DF,30.0,22.2,35,25,20,11,4,16,28,57.1,12,23,5,18,26,61,49,1,Matches,Udinese,Serie-A
1749,Florian Thauvin,fr FRA,"FW,MF",31.0,21.7,20,14,9,8,3,10,25,40.0,15,6,0,6,7,27,10,0,Matches,Udinese,Serie-A
1750,Jurgen Ekkelenkamp,nl NED,MF,24.0,21.0,36,25,10,22,4,18,35,51.4,17,26,4,22,12,48,26,0,Matches,Udinese,Serie-A
1751,Thomas Kristensen,dk DEN,DF,22.0,19.5,31,21,16,11,4,20,32,62.5,12,18,13,5,21,52,80,2,Matches,Udinese,Serie-A
1752,Oumar Solet,fr FRA,DF,24.0,18.6,33,19,18,13,2,21,30,70.0,9,32,19,13,17,50,78,4,Matches,Udinese,Serie-A
1753,Martín Payero,ar ARG,MF,25.0,15.3,24,16,4,14,6,8,16,50.0,8,16,2,14,13,37,13,0,Matches,Udinese,Serie-A
1754,Jordan Zemura,zw ZIM,DF,24.0,15.7,31,14,14,12,5,17,29,58.6,12,17,4,13,16,47,41,0,Matches,Udinese,Serie-A
1755,Arthur Atta,fr FRA,"MF,FW",21.0,13.9,20,12,9,10,1,10,15,66.7,5,9,5,4,7,27,15,1,Matches,Udinese,Serie-A
1756,Christian Kabasele,be BEL,DF,33.0,12.9,17,9,10,7,0,11,14,78.6,3,14,8,6,14,31,75,1,Matches,Udinese,Serie-A
1757,Razvan Sava,ro ROU,GK,22.0,12.0,0,0,0,0,0,0,0,,0,0,0,0,0,0,6,2,Matches,Udinese,Serie-A
1758,Lautaro Gianetti,ar ARG,DF,30.0,9.8,22,10,16,5,1,14,20,70.0,6,20,10,10,15,37,49,1,Matches,Udinese,Serie-A
1759,Souleymane Touré,fr FRA,DF,21.0,8.1,7,6,4,3,0,4,5,80.0,1,15,6,9,9,16,17,1,Matches,Udinese,Serie-A
1760,Keinan Davis,eng ENG,FW,26.0,11.8,9,4,1,4,4,3,6,50.0,3,2,1,1,1,10,5,0,Matches,Udinese,Serie-A
1761,Oier Zarraga,es ESP,MF,25.0,10.0,19,13,7,10,2,10,22,45.5,12,9,5,4,2,21,8,0,Matches,Udinese,Serie-A
1762,Alexis Sánchez,cl CHI,FW,35.0,4.9,3,1,0,2,1,1,7,14.3,6,5,0,5,4,7,1,1,Matches,Udinese,Serie-A
1763,Brenner,br BRA,"MF,FW",24.0,4.3,6,4,2,3,1,3,8,37.5,5,4,0,4,1,7,6,0,Matches,Udinese,Serie-A
1764,Iker Bravo,es ESP,"FW,MF",19.0,7.6,10,6,3,5,2,5,9,55.6,4,4,1,3,1,11,4,0,Matches,Udinese,Serie-A
1765,Rui Modesto,ao ANG,"DF,MF",24.0,6.8,16,12,4,9,3,7,9,77.8,2,10,0,10,8,24,13,0,Matches,Udinese,Serie-A
1766,Nehuén Pérez,ar ARG,DF,24.0,2.0,1,1,0,0,1,0,1,0.0,1,2,2,0,1,2,7,0,Matches,Udinese,Serie-A
1767,Daniele Padelli,it ITA,GK,38.0,1.0,0,0,0,0,0,0,1,0.0,1,0,0,0,0,0,0,0,Matches,Udinese,Serie-A
1768,Simone Pafundi,it ITA,"MF,DF",18.0,1.3,3,3,2,0,1,1,4,25.0,3,0,0,0,0,3,1,0,Matches,Udinese,Serie-A
1769,Enzo Ebosse,cm CMR,DF,25.0,1.0,0,0,0,0,0,0,2,0.0,2,3,3,0,1,1,1,0,Matches,Udinese,Serie-A
1770,James Abankwah,ie IRL,"DF,MF",20.0,1.0,4,2,4,0,0,2,3,66.7,1,2,1,1,1,5,3,0,Matches,Udinese,Serie-A
1771,Damián Pizarro,cl CHI,"FW,MF",19.0,0.2,0,0,0,0,0,0,0,,0,0,0,0,0,0,0,0,Matches,Udinese,Serie-A
1772,Matteo Palma,de GER,DF,16.0,0.1,0,0,0,0,0,0,0,,0,1,1,0,0,0,1,0,Matches,Udinese,Serie-A
1773,Jay Idzes,id IDN,DF,24.0,34.7,45,29,24,17,4,17,33,51.5,16,52,32,20,32,77,156,0,Matches,Venezia,Serie-A
1774,Hans Nicolussi Caviglia,it ITA,MF,24.0,31.8,47,28,17,22,8,29,64,45.3,35,39,12,27,28,75,55,2,Matches,Venezia,Serie-A
1775,Mikael Ellertsson,is ISL,"DF,MF",22.0,27.4,58,26,37,14,7,33,61,54.1,28,42,5,37,17,75,79,0,Matches,Venezia,Serie-A
1776,Gaetano Oristanio,it ITA,"FW,MF",21.0,25.7,17,13,5,8,4,7,15,46.7,8,16,0,16,6,23,6,1,Matches,Venezia,Serie-A
1777,Gianluca Busio,us USA,MF,22.0,28.0,46,31,24,12,10,20,47,42.6,27,36,8,28,19,65,52,0,Matches,Venezia,Serie-A
1778,Joel Pohjanpalo,fi FIN,FW,29.0,17.8,3,3,1,2,0,0,4,0.0,4,7,4,3,4,7,24,0,Matches,Venezia,Serie-A
1779,Francesco Zampano,it ITA,DF,30.0,18.2,31,20,19,10,2,14,31,45.2,17,21,1,20,6,37,29,2,Matches,Venezia,Serie-A
1780,Fali Candé,gw GNB,DF,26.0,17.0,25,19,14,10,1,16,23,69.6,7,21,15,6,15,40,90,2,Matches,Venezia,Serie-A
1781,Alessio Zerbin,it ITA,DF,25.0,16.9,51,28,30,12,9,29,52,55.8,23,28,3,25,15,66,25,1,Matches,Venezia,Serie-A
1782,Filip Stankovic,rs SRB,GK,22.0,15.2,0,0,0,0,0,0,0,,0,0,0,0,0,0,11,2,Matches,Venezia,Serie-A
1783,Ionuț Radu,ro ROU,GK,27.0,15.0,0,0,0,0,0,0,0,,0,0,0,0,0,0,9,0,Matches,Venezia,Serie-A
1784,Michael Svoboda,at AUT,DF,25.0,14.6,26,14,19,6,1,8,19,42.1,11,19,11,8,22,48,66,2,Matches,Venezia,Serie-A
1785,Ridgeciano Haps,sr SUR,DF,31.0,15.2,30,16,19,8,3,14,22,63.6,8,18,3,15,7,37,48,0,Matches,Venezia,Serie-A
1786,Kike Pérez,es ESP,MF,27.0,12.4,41,25,18,12,11,18,44,40.9,26,14,2,12,10,51,15,0,Matches,Venezia,Serie-A
1787,Joël Schingtienne,be BEL,DF,21.0,12.5,27,16,18,7,2,12,19,63.2,7,18,9,9,14,41,25,5,Matches,Venezia,Serie-A
1788,Marin Šverko,hr CRO,DF,26.0,12.4,20,9,14,6,0,10,12,83.3,2,10,5,5,16,36,45,3,Matches,Venezia,Serie-A
1789,Antonio Candela,it ITA,DF,24.0,11.2,31,21,13,11,7,18,26,69.2,8,7,5,2,8,39,22,2,Matches,Venezia,Serie-A
1790,Alfred Duncan,gh GHA,MF,31.0,10.6,17,8,4,11,2,5,14,35.7,9,7,2,5,8,25,8,0,Matches,Venezia,Serie-A
1791,John Yeboah,ec ECU,"FW,MF",24.0,13.6,6,3,1,3,2,1,10,10.0,9,4,0,4,4,10,2,0,Matches,Venezia,Serie-A
1792,Issa Doumbia,it ITA,MF,20.0,10.4,14,8,6,7,1,7,17,41.2,10,17,5,12,9,23,14,1,Matches,Venezia,Serie-A
1793,Giorgio Altare,it ITA,DF,25.0,8.4,13,12,8,3,2,8,15,53.3,7,21,11,10,17,30,49,0,Matches,Venezia,Serie-A
1794,Jesse Joronen,fi FIN,GK,31.0,7.8,0,0,0,0,0,0,0,,0,0,0,0,0,0,4,1,Matches,Venezia,Serie-A
1795,Magnus Kofod Andersen,dk DEN,MF,25.0,7.7,13,4,3,9,1,4,10,40.0,6,7,2,5,6,19,12,0,Matches,Venezia,Serie-A
1796,Christian Gytkjær,dk DEN,FW,34.0,8.4,6,4,2,2,2,1,2,50.0,1,3,1,2,0,6,8,0,Matches,Venezia,Serie-A
1797,Daniel Fila,cz CZE,FW,21.0,5.5,2,0,0,1,1,0,2,0.0,2,6,0,6,0,2,5,0,Matches,Venezia,Serie-A
1798,Alessandro Marcandalli,it ITA,DF,21.0,3.9,8,6,6,2,0,3,6,50.0,3,6,3,3,2,10,26,0,Matches,Venezia,Serie-A
1799,Mirko Marić,hr CRO,FW,29.0,4.0,6,3,5,1,0,2,5,40.0,3,3,1,2,1,7,10,0,Matches,Venezia,Serie-A
1800,Franco Carboni,it ITA,DF,21.0,2.5,5,3,5,0,0,5,8,62.5,3,1,1,0,0,5,11,0,Matches,Venezia,Serie-A
1801,Richie Sagrado,be BEL,DF,20.0,1.6,2,2,1,1,0,1,1,100.0,0,1,0,1,3,5,4,0,Matches,Venezia,Serie-A
1802,Bjarki Bjarkason,is ISL,"DF,MF",24.0,1.8,3,2,2,1,0,1,2,50.0,1,1,0,1,2,5,4,0,Matches,Venezia,Serie-A
1803,Cheick Oumar Conde,gn GUI,MF,24.0,1.7,6,5,3,2,1,2,5,40.0,3,7,2,5,4,10,3,0,Matches,Venezia,Serie-A
1804,Domen Črnigoj,si SVN,MF,28.0,1.5,4,2,0,1,3,1,2,50.0,1,5,2,3,4,8,4,0,Matches,Venezia,Serie-A
1805,Antonio Raimondo,it ITA,"FW,DF",20.0,1.0,2,1,1,1,0,0,0,,0,0,0,0,0,2,0,1,Matches,Venezia,Serie-A
1806,Nicholas Pierini,it ITA,MF,25.0,0.9,0,0,0,0,0,0,1,0.0,1,2,0,2,0,0,0,0,Matches,Venezia,Serie-A
1807,Saad El Haddad,ma MAR,MF,19.0,0.3,0,0,0,0,0,0,0,,0,0,0,0,0,0,0,0,Matches,Venezia,Serie-A
1808,Nunzio Lella,it ITA,MF,24.0,0.1,0,0,0,0,0,0,0,,0,0,0,0,0,0,0,0,Matches,Venezia,Serie-A
1809,Jordan Lefort,fr FRA,DF,30.0,34.0,52,30,42,9,1,30,44,68.2,14,56,37,19,32,84,206,3,Matches,Angers,Ligue-1
1810,Yahia Fofana,ci CIV,GK,23.0,33.0,0,0,0,0,0,0,2,0.0,2,0,0,0,1,1,25,2,Matches,Angers,Ligue-1
1811,Himad Abdelli,dz ALG,"MF,FW",24.0,31.6,48,32,13,20,15,15,48,31.3,33,24,1,23,26,74,28,2,Matches,Angers,Ligue-1
1812,Florent Hanin,dz ALG,DF,34.0,29.7,69,48,45,17,7,39,71,54.9,32,31,10,21,47,116,99,2,Matches,Angers,Ligue-1
1813,Jean-Eudes Aholou,ci CIV,MF,30.0,21.8,56,36,26,20,10,22,48,45.8,26,34,14,20,33,89,32,0,Matches,Angers,Ligue-1
1814,Carlens Arcus,ht HAI,DF,28.0,22.7,52,35,32,15,5,34,56,60.7,22,24,4,20,27,79,83,3,Matches,Angers,Ligue-1
1815,Jim Allevinah,ga GAB,FW,29.0,19.4,19,11,6,9,4,5,28,17.9,23,10,0,10,12,31,17,0,Matches,Angers,Ligue-1
1816,Farid El Melali,dz ALG,FW,27.0,21.0,28,16,15,6,7,13,35,37.1,22,19,1,18,16,44,12,1,Matches,Angers,Ligue-1
1817,Haris Belkebla,dz ALG,MF,30.0,19.9,56,38,38,15,3,26,45,57.8,19,30,9,21,35,91,46,1,Matches,Angers,Ligue-1
1818,Esteban Lepaul,fr FRA,FW,24.0,18.1,11,6,2,6,3,4,16,25.0,12,15,2,13,4,15,10,0,Matches,Angers,Ligue-1
1819,Yassin Belkhdim,fr FRA,MF,22.0,16.9,53,27,26,21,6,27,58,46.6,31,23,6,17,21,74,41,1,Matches,Angers,Ligue-1
1820,Abdoulaye Bamba,ci CIV,DF,34.0,16.8,22,12,17,4,1,14,19,73.7,5,14,8,6,19,41,79,0,Matches,Angers,Ligue-1
1821,Emmanuel Biumla,fr FRA,DF,19.0,14.8,19,12,14,5,0,12,18,66.7,6,18,8,10,8,27,84,1,Matches,Angers,Ligue-1
1822,Lilian Raolisoa,fr FRA,"DF,FW",24.0,14.6,41,24,24,13,4,17,38,44.7,21,11,2,9,15,56,45,0,Matches,Angers,Ligue-1
1823,Ibrahima Niane,sn SEN,FW,25.0,10.5,7,3,3,2,2,3,3,100.0,0,6,1,5,2,9,6,2,Matches,Angers,Ligue-1
1824,Zinedine Ferhat,dz ALG,"FW,MF",31.0,9.4,9,7,1,5,3,4,13,30.8,9,9,0,9,10,19,12,0,Matches,Angers,Ligue-1
1825,Jacques Ekomie,ga GAB,"DF,FW",20.0,7.7,22,14,9,10,3,8,12,66.7,4,16,5,11,4,26,14,0,Matches,Angers,Ligue-1
1826,Bamba Dieng,sn SEN,FW,24.0,5.9,4,1,1,2,1,0,2,0.0,2,2,0,2,0,4,3,0,Matches,Angers,Ligue-1
1827,Zinédine Ould Khaled,fr FRA,MF,24.0,3.8,9,7,5,3,1,2,13,15.4,11,6,1,5,2,11,12,0,Matches,Angers,Ligue-1
1828,Pierrick Capelle,fr FRA,MF,37.0,5.4,24,17,10,9,5,9,18,50.0,9,4,1,3,11,35,5,1,Matches,Angers,Ligue-1
1829,Sidiki Cherif,fr FRA,FW,17.0,3.6,5,5,1,3,1,3,4,75.0,1,4,1,3,0,5,0,1,Matches,Angers,Ligue-1
1830,Marius Courcoul,fr FRA,"MF,DF",17.0,3.4,5,2,3,2,0,2,5,40.0,3,4,0,4,5,10,9,0,Matches,Angers,Ligue-1
1831,Cédric Hountondji,bj BEN,DF,30.0,3.0,6,4,4,2,0,3,7,42.9,4,3,3,0,4,10,14,0,Matches,Angers,Ligue-1
1832,Ousmane Camara,fr FRA,DF,21.0,2.8,4,3,3,1,0,1,2,50.0,1,1,1,0,0,4,18,0,Matches,Angers,Ligue-1
1833,Melvin Zinga,fr FRA,GK,22.0,1.0,0,0,0,0,0,0,0,,0,0,0,0,0,0,1,0,Matches,Angers,Ligue-1
1834,Enzo Caumont,fr FRA,MF,20.0,0.4,1,1,0,1,0,1,2,50.0,1,1,1,0,1,2,1,0,Matches,Angers,Ligue-1
1835,Justin-Noël Kalumba,fr FRA,"FW,MF",19.0,0.3,0,0,0,0,0,0,0,,0,0,0,0,1,1,1,0,Matches,Angers,Ligue-1
1836,Prosper Peter,ng NGA,"MF,FW",16.0,0.3,2,1,0,2,0,0,0,,0,0,0,0,0,2,0,0,Matches,Angers,Ligue-1
1837,Lois Diony,fr FRA,FW,31.0,0.2,0,0,0,0,0,0,0,,0,0,0,0,0,0,0,0,Matches,Angers,Ligue-1
1838,Lanroy Machine,fr FRA,FW,18.0,0.1,0,0,0,0,0,0,0,,0,0,0,0,0,0,0,0,Matches,Angers,Ligue-1
1839,Donovan Léon,gf GUF,GK,31.0,32.0,0,0,0,0,0,0,3,0.0,3,2,0,2,0,0,26,1,Matches,Auxerre,Ligue-1
1840,Gaëtan Perrin,fr FRA,"MF,FW",28.0,29.9,49,26,22,12,15,21,48,43.8,27,10,0,10,12,61,4,1,Matches,Auxerre,Ligue-1
1841,Jubal,br BRA,DF,30.0,29.3,60,39,46,13,1,28,40,70.0,12,61,36,25,25,85,201,1,Matches,Auxerre,Ligue-1
1842,Clément Akpa,ci CIV,DF,22.0,27.6,55,34,36,12,7,31,46,67.4,15,38,14,24,42,97,141,2,Matches,Auxerre,Ligue-1
1843,Elisha Owusu,gh GHA,MF,26.0,26.0,73,41,29,39,5,31,48,64.6,17,33,9,24,42,115,35,1,Matches,Auxerre,Ligue-1
1844,Gideon Mensah,gh GHA,DF,26.0,25.3,68,45,37,21,10,33,66,50.0,33,27,4,23,50,118,83,0,Matches,Auxerre,Ligue-1
1845,Ki-Jana Hoever,nl NED,DF,22.0,23.6,51,38,26,16,9,30,54,55.6,24,33,3,30,21,72,70,1,Matches,Auxerre,Ligue-1
1846,Hamed Junior Traorè,ci CIV,MF,24.0,23.3,41,20,11,17,13,16,54,29.6,38,14,0,14,8,49,11,0,Matches,Auxerre,Ligue-1
1847,Lassine Sinayoko,ml MLI,"FW,MF",24.0,25.5,33,20,10,14,9,11,23,47.8,12,16,2,14,13,46,38,0,Matches,Auxerre,Ligue-1
1848,Sinaly Diomande,ci CIV,DF,23.0,21.6,39,19,20,18,1,28,40,70.0,12,37,18,19,30,69,100,2,Matches,Auxerre,Ligue-1
1849,Gabriel Osho,ng NGA,DF,25.0,18.4,23,15,17,3,3,13,20,65.0,7,32,19,13,12,35,87,0,Matches,Auxerre,Ligue-1
1850,Kévin Danois,fr FRA,MF,20.0,16.2,49,30,20,22,7,20,46,43.5,26,17,3,14,20,69,20,0,Matches,Auxerre,Ligue-1
1851,Han-Noah Massengo,fr FRA,MF,23.0,11.6,17,11,5,8,4,8,12,66.7,4,12,4,8,17,34,10,2,Matches,Auxerre,Ligue-1
1852,Theo Bair,ca CAN,FW,24.0,10.4,4,3,1,2,1,0,2,0.0,2,6,2,4,3,7,10,0,Matches,Auxerre,Ligue-1
1853,Paul Joly,fr FRA,DF,24.0,11.2,49,32,30,17,2,27,45,60.0,18,19,1,18,25,74,32,5,Matches,Auxerre,Ligue-1
1854,Ado Onaiwu,jp JPN,"MF,FW",28.0,10.6,11,7,2,6,3,4,14,28.6,10,12,0,12,3,14,12,0,Matches,Auxerre,Ligue-1
1855,Rayan Raveloson,mg MAD,"MF,DF",27.0,8.0,6,5,2,4,0,5,15,33.3,10,8,7,1,5,11,22,0,Matches,Auxerre,Ligue-1
1856,Assane Dioussé,sn SEN,MF,26.0,7.4,15,7,9,5,1,5,14,35.7,9,6,2,4,12,27,15,0,Matches,Auxerre,Ligue-1
1857,Florian Ayé,fr FRA,FW,27.0,6.4,2,2,0,0,2,0,2,0.0,2,7,0,7,7,9,6,0,Matches,Auxerre,Ligue-1
1858,Fredrik Oppegard,no NOR,DF,21.0,3.0,6,4,4,1,1,3,7,42.9,4,2,1,1,2,8,12,1,Matches,Auxerre,Ligue-1
1859,Théo De Percin,mq MTQ,GK,23.0,2.0,0,0,0,0,0,0,1,0.0,1,0,0,0,0,0,3,0,Matches,Auxerre,Ligue-1
1860,Rudy Matondo,fr FRA,MF,16.0,0.7,1,1,1,0,0,0,1,0.0,1,0,0,0,0,1,2,0,Matches,Auxerre,Ligue-1
1861,Lasso Coulibaly,ci CIV,"FW,MF",21.0,0.5,1,1,0,0,1,0,0,,0,0,0,0,0,1,0,0,Matches,Auxerre,Ligue-1
1862,Théo Pellenard,fr FRA,DF,30.0,0.5,3,2,2,1,0,1,3,33.3,2,1,0,1,0,3,3,0,Matches,Auxerre,Ligue-1
1863,Aristide Zossou,ci CIV,MF,19.0,0.2,0,0,0,0,0,0,0,,0,0,0,0,0,0,0,0,Matches,Auxerre,Ligue-1
1864,Eros Maddy,nl NED,DF,23.0,0.2,0,0,0,0,0,0,0,,0,0,0,0,0,0,0,0,Matches,Auxerre,Ligue-1
1865,Loïc N'Gatta,fr FRA,DF,20.0,0.1,1,1,0,1,0,1,2,50.0,1,1,0,1,0,1,1,0,Matches,Auxerre,Ligue-1
1866,Yoann Cissé,fr FRA,MF,19.0,0.1,0,0,0,0,0,0,0,,0,0,0,0,1,1,0,0,Matches,Auxerre,Ligue-1
1867,Ben Viadere,fr FRA,MF,18.0,0.1,0,0,0,0,0,0,0,,0,0,0,0,0,0,0,0,Matches,Auxerre,Ligue-1
1868,Marco Bizot,nl NED,GK,33.0,32.0,2,1,2,0,0,1,2,50.0,1,0,0,0,0,2,33,0,Matches,Brest,Ligue-1
1869,Mahdi Camara,fr FRA,"MF,FW",26.0,29.5,71,40,16,38,17,24,46,52.2,22,40,5,35,33,104,29,0,Matches,Brest,Ligue-1
1870,Kenny Lala,mg MAD,DF,32.0,29.8,66,42,36,23,7,38,57,66.7,19,25,9,16,25,91,75,2,Matches,Brest,Ligue-1
1871,Ludovic Ajorque,fr FRA,FW,30.0,27.7,26,19,3,12,11,10,32,31.3,22,20,5,15,6,32,26,0,Matches,Brest,Ligue-1
1872,Brendan Chardonnet,fr FRA,DF,29.0,26.8,45,33,28,14,3,25,40,62.5,15,45,28,17,29,74,169,2,Matches,Brest,Ligue-1
1873,Hugo Magnetti,fr FRA,MF,26.0,25.8,52,32,21,27,4,23,51,45.1,28,20,3,17,18,70,37,0,Matches,Brest,Ligue-1
1874,Massadio Haïdara,ml MLI,DF,31.0,18.6,27,16,16,9,2,13,29,44.8,16,18,2,16,26,53,73,0,Matches,Brest,Ligue-1
1875,Abdoulaye Niakhate Ndiaye,sn SEN,DF,22.0,19.0,49,33,36,12,1,25,37,67.6,12,29,17,12,11,60,144,3,Matches,Brest,Ligue-1
1876,Mathias Pereira Lage,pt POR,"FW,MF",27.0,17.5,37,24,16,13,8,18,39,46.2,21,17,2,15,20,57,20,2,Matches,Brest,Ligue-1
1877,Pierre Lees-Melou,fr FRA,MF,31.0,17.0,48,33,20,19,9,25,54,46.3,29,19,3,16,12,60,23,0,Matches,Brest,Ligue-1
1878,Julien Le Cardinal,fr FRA,DF,26.0,15.3,27,15,16,8,3,11,16,68.8,5,18,14,4,33,60,75,0,Matches,Brest,Ligue-1
1879,Romain Del Castillo,fr FRA,FW,28.0,14.0,31,22,9,13,9,19,32,59.4,13,16,0,16,6,37,5,0,Matches,Brest,Ligue-1
1880,Abdallah Sima,sn SEN,"FW,MF",23.0,13.8,15,11,2,5,8,4,11,36.4,7,9,1,8,1,16,9,0,Matches,Brest,Ligue-1
1881,Kamory Doumbia,ml MLI,"MF,FW",21.0,14.7,41,29,17,17,7,14,31,45.2,17,17,1,16,28,69,13,1,Matches,Brest,Ligue-1
1882,Mama Samba Baldé,gw GNB,FW,28.0,12.8,13,9,4,4,5,3,14,21.4,11,8,0,8,6,19,14,0,Matches,Brest,Ligue-1
1883,Edimilson Fernandes,ch SUI,"MF,DF",28.0,12.3,9,7,3,6,0,7,13,53.8,6,14,6,8,20,29,38,1,Matches,Brest,Ligue-1
1884,Romain Faivre,fr FRA,"MF,FW",26.0,10.0,13,10,4,5,4,5,10,50.0,5,8,0,8,4,17,3,1,Matches,Brest,Ligue-1
1885,Jordan Amavi,fr FRA,DF,30.0,8.8,24,17,10,11,3,15,21,71.4,6,10,2,8,7,31,18,0,Matches,Brest,Ligue-1
1886,Luck Zogbé,ci CIV,DF,19.0,7.1,32,18,17,11,4,18,26,69.2,8,11,2,9,14,46,22,1,Matches,Brest,Ligue-1
1887,Jonas Martin,fr FRA,MF,34.0,5.5,13,7,10,2,1,6,11,54.5,5,4,1,3,8,21,12,1,Matches,Brest,Ligue-1
1888,Soumaïla Coulibaly,fr FRA,DF,20.0,4.9,4,2,2,2,0,1,1,100.0,0,7,2,5,5,9,26,0,Matches,Brest,Ligue-1
1889,Ibrahim Salah,ma MAR,FW,22.0,4.0,4,2,1,1,2,1,6,16.7,5,2,0,2,2,6,0,0,Matches,Brest,Ligue-1
1890,Grégoire Coudert,fr FRA,GK,25.0,2.0,0,0,0,0,0,0,0,,0,0,0,0,0,0,1,0,Matches,Brest,Ligue-1
1891,Justin Bourgault,fr FRA,DF,18.0,1.4,2,1,1,1,0,0,0,,0,0,0,0,0,2,1,0,Matches,Brest,Ligue-1
1892,Jérémy Le Douaron,fr FRA,FW,26.0,1.1,1,0,0,0,1,0,1,0.0,1,1,0,1,0,1,0,0,Matches,Brest,Ligue-1
1893,Bradley Locko,fr FRA,DF,22.0,1.1,2,2,1,1,0,1,1,100.0,0,3,2,1,1,3,3,0,Matches,Brest,Ligue-1
1894,Hamidou Makalou,ml MLI,"FW,MF",18.0,0.4,0,0,0,0,0,0,0,,0,0,0,0,0,0,0,0,Matches,Brest,Ligue-1
1895,Axel Camblan,fr FRA,"MF,FW",20.0,0.3,1,1,0,0,1,1,2,50.0,1,1,0,1,0,1,0,0,Matches,Brest,Ligue-1
1896,Hianga Mananga Mbock,fr FRA,MF,24.0,0.2,0,0,0,0,0,0,0,,0,0,0,0,1,1,0,0,Matches,Brest,Ligue-1
1897,Sérigné Diop,sn SEN,FW,19.0,0.0,1,0,0,1,0,0,0,,0,1,0,1,0,1,0,0,Matches,Brest,Ligue-1
1898,Gautier Lloris,fr FRA,DF,29.0,30.8,68,43,52,16,0,38,53,71.7,15,33,21,12,34,102,192,0,Matches,Le-Havre,Ligue-1
1899,Loïc Nego,hu HUN,"DF,FW",33.0,27.3,58,35,37,16,5,41,64,64.1,23,17,3,14,29,87,82,0,Matches,Le-Havre,Ligue-1
1900,Abdoulaye Touré,gn GUI,MF,30.0,25.8,61,34,31,21,9,33,59,55.9,26,36,19,17,34,95,42,5,Matches,Le-Havre,Ligue-1
1901,Etienne Youte Kinkoue,fr FRA,DF,22.0,25.8,19,10,11,7,1,13,20,65.0,7,36,23,13,29,48,158,3,Matches,Le-Havre,Ligue-1
1902,Yassine Kechta,ma MAR,"MF,FW",22.0,23.3,60,36,32,21,7,33,78,42.3,45,25,2,23,26,86,32,2,Matches,Le-Havre,Ligue-1
1903,Josué Casimir,fr FRA,"FW,MF",22.0,22.2,37,26,15,15,7,9,18,50.0,9,19,0,19,7,44,35,1,Matches,Le-Havre,Ligue-1
1904,Issa Soumaré,sn SEN,"FW,MF",23.0,21.1,25,14,8,10,7,13,49,26.5,36,19,4,15,16,41,32,0,Matches,Le-Havre,Ligue-1
1905,Arthur Desmas,fr FRA,GK,30.0,18.0,0,0,0,0,0,0,1,0.0,1,0,0,0,0,0,9,1,Matches,Le-Havre,Ligue-1
1906,Mathieu Gorgelin,fr FRA,GK,33.0,16.0,2,2,2,0,0,2,3,66.7,1,0,0,0,0,2,8,2,Matches,Le-Havre,Ligue-1
1907,Arouna Sangante,sn SEN,DF,22.0,13.8,25,16,11,14,0,10,17,58.8,7,11,5,6,21,46,65,3,Matches,Le-Havre,Ligue-1
1908,André Ayew,gh GHA,FW,34.0,16.1,18,10,3,7,8,7,13,53.8,6,9,2,7,3,21,21,1,Matches,Le-Havre,Ligue-1
1909,Christopher Operi,ci CIV,"DF,FW",27.0,13.0,13,9,6,2,5,7,12,58.3,5,20,6,14,14,27,30,0,Matches,Le-Havre,Ligue-1
1910,Timothee Pembele,fr FRA,DF,21.0,12.4,30,22,17,9,4,14,23,60.9,9,16,5,11,11,41,42,0,Matches,Le-Havre,Ligue-1
1911,Oussama Targhalline,ma MAR,MF,22.0,11.0,19,14,12,3,4,5,12,41.7,7,14,7,7,19,38,14,2,Matches,Le-Havre,Ligue-1
1912,Rassoul Ndiaye,sn SEN,MF,22.0,11.8,35,25,19,12,4,11,25,44.0,14,15,4,11,12,47,24,0,Matches,Le-Havre,Ligue-1
1913,Junior Mwanga,fr FRA,MF,21.0,10.6,26,16,10,13,3,11,19,57.9,8,10,3,7,8,34,18,2,Matches,Le-Havre,Ligue-1
1914,Koka,eg EGY,FW,31.0,9.5,4,1,1,3,0,0,4,0.0,4,3,0,3,4,8,6,1,Matches,Le-Havre,Ligue-1
1915,Yanis Zouaoui,dz ALG,"DF,FW",30.0,10.8,20,10,10,8,2,11,15,73.3,4,15,2,13,8,28,43,0,Matches,Le-Havre,Ligue-1
1916,Antoine Joujou,fr FRA,"MF,FW",21.0,10.5,16,11,10,4,2,9,15,60.0,6,15,3,12,9,25,19,0,Matches,Le-Havre,Ligue-1
1917,Yoann Salmier,gf GUF,DF,31.0,8.9,14,7,9,4,1,10,13,76.9,3,12,8,4,10,24,59,0,Matches,Le-Havre,Ligue-1
1918,Fodé Ballo-Touré,sn SEN,"DF,MF",27.0,6.5,8,7,3,4,1,5,9,55.6,4,8,3,5,4,12,27,0,Matches,Le-Havre,Ligue-1
1919,Emmanuel Sabbi,us USA,"FW,MF",26.0,7.3,14,7,7,4,3,5,8,62.5,3,2,0,2,3,17,4,0,Matches,Le-Havre,Ligue-1
1920,Mahamadou Diawara,fr FRA,MF,19.0,6.5,20,12,10,8,2,8,13,61.5,5,13,6,7,13,33,11,1,Matches,Le-Havre,Ligue-1
1921,Daler Kuzyaev,ru RUS,MF,31.0,6.3,13,8,7,4,2,2,9,22.2,7,7,4,3,9,22,8,0,Matches,Le-Havre,Ligue-1
1922,Ilyes Housni,fr FRA,"FW,MF",19.0,2.6,7,5,2,3,2,2,4,50.0,2,2,0,2,1,8,2,0,Matches,Le-Havre,Ligue-1
1923,Steve Ngoura,fr FRA,FW,19.0,3.2,4,2,1,1,2,3,3,100.0,0,2,1,1,0,4,2,0,Matches,Le-Havre,Ligue-1
1924,Samuel Grandsir,fr FRA,"MF,FW",27.0,0.9,5,5,0,3,2,2,3,66.7,1,2,0,2,0,5,0,0,Matches,Le-Havre,Ligue-1
1925,Elysée Logbo,fr FRA,FW,20.0,0.3,0,0,0,0,0,0,0,,0,0,0,0,0,0,0,0,Matches,Le-Havre,Ligue-1
1926,Mathéo Bodmer,fr FRA,MF,20.0,0.1,0,0,0,0,0,0,0,,0,0,0,0,0,0,1,0,Matches,Le-Havre,Ligue-1
1927,Kandet Diawara,gn GUI,FW,24.0,0.0,0,0,0,0,0,0,0,,0,1,0,1,0,0,1,0,Matches,Le-Havre,Ligue-1
1928,Alois Confais,fr FRA,MF,27.0,0.0,0,0,0,0,0,0,0,,0,0,0,0,0,0,0,0,Matches,Le-Havre,Ligue-1
1929,Adrien Thomasson,fr FRA,MF,30.0,29.1,90,47,42,25,23,52,95,54.7,43,48,3,45,19,109,28,2,Matches,Lens,Ligue-1
1930,Facundo Medina,ar ARG,DF,25.0,28.3,44,29,22,18,4,24,42,57.1,18,30,10,20,32,76,70,0,Matches,Lens,Ligue-1
1931,Andy Diouf,fr FRA,MF,21.0,24.7,37,26,10,22,5,16,40,40.0,24,24,1,23,15,52,18,2,Matches,Lens,Ligue-1
1932,Jonathan Gradit,fr FRA,DF,31.0,23.5,44,23,22,19,3,23,40,57.5,17,27,12,15,25,69,122,2,Matches,Lens,Ligue-1
1933,Florian Sotoca,fr FRA,"FW,MF",33.0,19.9,22,13,3,8,11,12,22,54.5,10,12,2,10,14,36,25,0,Matches,Lens,Ligue-1
1934,Deiver Machado,co COL,"DF,MF",30.0,20.1,36,26,14,14,8,17,30,56.7,13,20,4,16,16,52,34,2,Matches,Lens,Ligue-1
1935,Neil El Aynaoui,fr FRA,MF,23.0,17.6,39,21,18,15,6,12,34,35.3,22,34,8,26,30,69,29,0,Matches,Lens,Ligue-1
1936,M'Bala Nzola,ao ANG,FW,27.0,16.2,5,4,0,1,4,3,9,33.3,6,9,1,8,5,10,7,0,Matches,Lens,Ligue-1
1937,Anass Zaroury,ma MAR,"FW,MF",23.0,15.6,23,17,6,12,5,9,26,34.6,17,9,0,9,6,29,15,0,Matches,Lens,Ligue-1
1938,Przemysław Frankowski,pl POL,DF,29.0,15.4,32,21,17,10,5,19,30,63.3,11,10,2,8,19,51,28,0,Matches,Lens,Ligue-1
1939,Malang Sarr,fr FRA,DF,25.0,15.4,21,13,12,6,3,16,27,59.3,11,18,9,9,22,43,63,3,Matches,Lens,Ligue-1
1940,Brice Samba,fr FRA,GK,30.0,15.0,0,0,0,0,0,0,0,,0,0,0,0,1,1,6,2,Matches,Lens,Ligue-1
1941,Mathew Ryan,au AUS,GK,32.0,14.0,1,0,1,0,0,1,2,50.0,1,0,0,0,1,2,2,2,Matches,Lens,Ligue-1
1942,Ruben Aguilar,fr FRA,"DF,MF",31.0,12.5,34,18,17,12,5,24,39,61.5,15,25,3,22,13,47,23,0,Matches,Lens,Ligue-1
1943,Kevin Danso,at AUT,DF,25.0,12.0,19,7,12,5,2,12,16,75.0,4,25,19,6,20,39,62,1,Matches,Lens,Ligue-1
1944,Goduine Koyalipou,cf CTA,FW,24.0,9.8,3,2,0,3,0,1,1,100.0,0,4,0,4,1,4,8,0,Matches,Lens,Ligue-1
1945,Angelo Fulgini,fr FRA,"MF,FW",27.0,11.6,14,10,6,4,4,6,16,37.5,10,11,1,10,2,16,3,0,Matches,Lens,Ligue-1
1946,Abdukodir Khusanov,uz UZB,DF,20.0,10.8,15,11,9,5,1,7,11,63.6,4,17,11,6,26,41,57,0,Matches,Lens,Ligue-1
1947,Wesley Saïd,fr FRA,FW,29.0,10.1,16,11,3,10,3,6,13,46.2,7,6,0,6,2,18,2,0,Matches,Lens,Ligue-1
1948,Juma Bah,sl SLE,DF,18.0,7.6,16,10,6,10,0,5,7,71.4,2,10,7,3,17,33,47,1,Matches,Lens,Ligue-1
1949,Jhoanner Chávez,ec ECU,"DF,MF",22.0,6.6,9,5,4,4,1,2,7,28.6,5,10,1,9,6,15,13,0,Matches,Lens,Ligue-1
1950,Nampalys Mendy,sn SEN,MF,32.0,6.5,15,8,4,7,4,6,14,42.9,8,8,2,6,9,24,8,0,Matches,Lens,Ligue-1
1951,Rémy Labeau Lascary,gp GLP,"FW,MF",21.0,7.1,16,10,7,6,3,5,11,45.5,6,5,0,5,1,17,7,0,Matches,Lens,Ligue-1
1952,Hervé Koffi,bf BFA,GK,27.0,5.0,1,1,1,0,0,1,1,100.0,0,0,0,0,0,1,5,0,Matches,Lens,Ligue-1
1953,David Costa,pt POR,"MF,FW",23.0,3.9,2,0,1,1,0,1,4,25.0,3,5,1,4,1,3,0,0,Matches,Lens,Ligue-1
1954,Tom Pouilly,fr FRA,"DF,MF",21.0,3.0,9,6,5,1,3,5,10,50.0,5,5,1,4,4,13,11,0,Matches,Lens,Ligue-1
1955,Kyllian Antonio,fr FRA,"DF,MF",16.0,1.5,3,2,2,0,1,1,3,33.3,2,3,0,3,3,6,3,1,Matches,Lens,Ligue-1
1956,Hamzat Ojediran,ng NGA,"MF,FW",20.0,4.6,28,15,12,13,3,7,19,36.8,12,10,2,8,10,38,7,0,Matches,Lens,Ligue-1
1957,Jeremy Agbonifo,se SWE,"FW,MF",18.0,3.3,7,6,6,0,1,3,7,42.9,4,2,1,1,1,8,0,1,Matches,Lens,Ligue-1
1958,Martin Satriano,uy URU,"FW,DF",23.0,1.0,3,1,1,1,1,3,3,100.0,0,0,0,0,0,3,2,0,Matches,Lens,Ligue-1
1959,Rayan Fofana,fr FRA,"FW,MF",18.0,0.3,2,2,1,1,0,0,0,,0,0,0,0,0,2,0,0,Matches,Lens,Ligue-1
1960,Gabin Capuano,fr FRA,FW,18.0,0.1,0,0,0,0,0,0,0,,0,0,0,0,0,0,0,0,Matches,Lens,Ligue-1
1961,Kembo Diliwidi,fr FRA,DF,18.0,0.0,0,0,0,0,0,0,0,,0,0,0,0,0,0,0,0,Matches,Lens,Ligue-1
1962,Lucas Chevalier,fr FRA,GK,22.0,34.0,3,2,3,0,0,3,4,75.0,1,0,0,0,0,3,13,4,Matches,Lille,Ligue-1
1963,Bafodé Diakité,fr FRA,DF,23.0,30.7,31,18,17,11,3,18,26,69.2,8,30,17,13,27,58,99,5,Matches,Lille,Ligue-1
1964,Alexsandro Ribeiro,br BRA,DF,24.0,30.0,32,19,18,13,1,20,30,66.7,10,23,13,10,27,59,143,3,Matches,Lille,Ligue-1
1965,Benjamin André,fr FRA,MF,33.0,29.9,103,57,31,60,12,54,96,56.3,42,42,6,36,48,151,56,0,Matches,Lille,Ligue-1
1966,Jonathan David,ca CAN,FW,24.0,28.4,24,8,3,12,9,9,21,42.9,12,13,2,11,7,31,10,1,Matches,Lille,Ligue-1
1967,Thomas Meunier,be BEL,DF,32.0,21.4,53,38,32,15,6,33,49,67.3,16,21,8,13,34,87,64,0,Matches,Lille,Ligue-1
1968,Hákon Arnar Haraldsson,is ISL,"MF,FW",21.0,19.5,36,16,9,17,10,16,33,48.5,17,10,2,8,8,44,6,0,Matches,Lille,Ligue-1
1969,Gabriel Gudmundsson,se SWE,DF,25.0,19.8,36,25,15,15,6,23,36,63.9,13,19,7,12,17,53,41,3,Matches,Lille,Ligue-1
1970,Aïssa Mandi,dz ALG,DF,32.0,19.3,31,17,12,15,4,16,22,72.7,6,23,11,12,15,46,54,0,Matches,Lille,Ligue-1
1971,André Gomes,pt POR,MF,31.0,14.2,27,13,9,11,7,11,31,35.5,20,7,1,6,6,33,11,2,Matches,Lille,Ligue-1
1972,Ngal'Ayel Mukau,cd COD,MF,19.0,13.2,33,18,9,22,2,17,29,58.6,12,14,0,14,15,48,22,0,Matches,Lille,Ligue-1
1973,Mitchel Bakker,nl NED,"FW,DF",24.0,12.7,23,13,6,11,6,10,19,52.6,9,10,1,9,12,35,15,0,Matches,Lille,Ligue-1
1974,Matias Fernandez-Pardo,be BEL,"FW,MF",19.0,11.8,12,9,3,6,3,6,12,50.0,6,9,0,9,3,15,6,0,Matches,Lille,Ligue-1
1975,Rémy Cabella,fr FRA,"FW,MF",34.0,11.2,39,19,16,13,10,19,33,57.6,14,10,1,9,8,47,5,0,Matches,Lille,Ligue-1
1976,Edon Zhegrova,xk KVX,"FW,MF",25.0,10.9,5,2,3,0,2,2,7,28.6,5,8,0,8,4,9,1,0,Matches,Lille,Ligue-1
1977,Ayyoub Bouaddi,fr FRA,MF,16.0,12.8,50,31,21,21,8,19,32,59.4,13,12,3,9,10,60,12,1,Matches,Lille,Ligue-1
1978,Osame Sahraoui,ma MAR,"FW,MF",23.0,14.4,13,9,4,4,5,3,8,37.5,5,14,1,13,7,20,8,1,Matches,Lille,Ligue-1
1979,Ismaily,br BRA,DF,34.0,10.0,33,17,17,12,4,17,26,65.4,9,15,1,14,13,46,49,0,Matches,Lille,Ligue-1
1980,Angel Gomes,eng ENG,MF,23.0,8.2,10,6,4,4,2,2,12,16.7,10,0,0,0,0,10,2,0,Matches,Lille,Ligue-1
1981,Chuba Akpom,eng ENG,FW,28.0,7.1,8,5,0,4,4,2,6,33.3,4,9,0,9,0,8,3,0,Matches,Lille,Ligue-1
1982,Tiago Santos,pt POR,DF,22.0,4.5,12,7,4,5,3,6,9,66.7,3,2,0,2,2,14,4,0,Matches,Lille,Ligue-1
1983,Mohamed Lamine Bayo,gn GUI,FW,26.0,3.4,1,1,0,0,1,1,1,100.0,0,0,0,0,0,1,4,0,Matches,Lille,Ligue-1
1984,Nabil Bentaleb,dz ALG,MF,29.0,3.7,4,3,2,0,2,3,7,42.9,4,5,0,5,5,9,7,2,Matches,Lille,Ligue-1
1985,Ethan Mbappé,fr FRA,"MF,FW",17.0,2.5,6,2,3,2,1,0,4,0.0,4,6,0,6,1,7,0,0,Matches,Lille,Ligue-1
1986,Younes Lachaab,fr FRA,"MF,FW",19.0,0.1,1,1,0,0,1,1,1,100.0,0,0,0,0,1,2,0,0,Matches,Lille,Ligue-1
1987,Ousmane Toure,fr FRA,DF,19.0,0.1,0,0,0,0,0,0,0,,0,0,0,0,1,1,2,0,Matches,Lille,Ligue-1
1988,Aaron Malouda,fr FRA,FW,18.0,0.0,0,0,0,0,0,0,0,,0,0,0,0,0,0,0,0,Matches,Lille,Ligue-1
1989,Lucas Perri,br BRA,GK,26.0,33.0,1,1,1,0,0,0,4,0.0,4,1,0,1,0,1,22,1,Matches,Lyon,Ligue-1
1990,Moussa Niakhate,sn SEN,DF,28.0,30.3,47,27,37,8,2,24,32,75.0,8,26,17,9,25,72,143,3,Matches,Lyon,Ligue-1
1991,Clinton Mata,ao ANG,DF,31.0,26.3,41,29,23,14,4,28,36,77.8,8,26,17,9,46,87,72,3,Matches,Lyon,Ligue-1
1992,Corentin Tolisso,fr FRA,MF,29.0,25.9,57,25,21,26,10,34,65,52.3,31,52,13,39,22,79,41,1,Matches,Lyon,Ligue-1
1993,Nemanja Matić,rs SRB,MF,35.0,22.3,42,29,15,21,6,23,41,56.1,18,21,9,12,18,60,31,1,Matches,Lyon,Ligue-1
1994,Alexandre Lacazette,fr FRA,FW,33.0,22.8,13,6,3,7,3,5,16,31.3,11,13,3,10,8,21,7,0,Matches,Lyon,Ligue-1
1995,Rayan Cherki,fr FRA,"FW,MF",20.0,22.7,15,12,3,8,4,6,28,21.4,22,6,0,6,7,22,6,0,Matches,Lyon,Ligue-1
1996,Nicolás Tagliafico,ar ARG,DF,31.0,21.1,57,37,24,22,11,29,48,60.4,19,25,7,18,36,93,55,0,Matches,Lyon,Ligue-1
1997,Ainsley Maitland-Niles,eng ENG,DF,26.0,22.1,71,44,30,26,15,48,76,63.2,28,28,4,24,25,96,61,6,Matches,Lyon,Ligue-1
1998,Jordan Veretout,fr FRA,MF,31.0,17.3,30,14,14,14,2,17,40,42.5,23,17,3,14,5,35,23,1,Matches,Lyon,Ligue-1
1999,Duje Ćaleta-Car,hr CRO,DF,27.0,17.6,20,12,11,9,0,10,19,52.6,9,33,25,8,17,37,97,2,Matches,Lyon,Ligue-1
2000,Malick Fofana,be BEL,FW,19.0,17.7,22,11,8,11,3,8,17,47.1,9,12,0,12,8,30,6,0,Matches,Lyon,Ligue-1
2001,Georges Mikautadze,ge GEO,FW,23.0,16.1,7,6,1,3,3,3,9,33.3,6,11,0,11,4,11,6,0,Matches,Lyon,Ligue-1
2002,Tanner Tessmann,us USA,MF,22.0,13.7,25,15,11,10,4,12,25,48.0,13,13,7,6,19,44,29,1,Matches,Lyon,Ligue-1
2003,Ernest Nuamah,gh GHA,"FW,MF",20.0,11.7,21,11,15,4,2,12,27,44.4,15,9,1,8,8,29,8,1,Matches,Lyon,Ligue-1
2004,Abner,br BRA,DF,24.0,12.1,29,20,12,10,7,21,32,65.6,11,15,2,13,5,34,41,0,Matches,Lyon,Ligue-1
2005,Sael Kumbedi,fr FRA,DF,19.0,10.6,28,14,11,13,4,14,20,70.0,6,11,3,8,8,36,32,1,Matches,Lyon,Ligue-1
2006,Thiago Almada,ar ARG,"MF,FW",23.0,10.6,14,8,7,5,2,7,21,33.3,14,2,0,2,7,21,6,3,Matches,Lyon,Ligue-1
2007,Saïd Benrahma,dz ALG,"FW,MF",28.0,8.2,9,5,4,4,1,3,10,30.0,7,6,0,6,3,12,2,0,Matches,Lyon,Ligue-1
2008,Maxence Caqueret,fr FRA,MF,24.0,6.4,21,11,5,11,5,4,22,18.2,18,12,2,10,7,28,2,0,Matches,Lyon,Ligue-1
2009,Gift Orban,ng NGA,"FW,DF",22.0,2.1,0,0,0,0,0,0,1,0.0,1,0,0,0,0,0,0,0,Matches,Lyon,Ligue-1
2010,Rémy Descamps,fr FRA,GK,28.0,1.0,0,0,0,0,0,0,0,,0,0,0,0,0,0,0,0,Matches,Lyon,Ligue-1
2011,Wilfried Zaha,ci CIV,FW,31.0,0.8,1,1,1,0,0,1,2,50.0,1,3,0,3,1,2,0,0,Matches,Lyon,Ligue-1
2012,Orel Mangala,be BEL,MF,26.0,0.7,1,0,0,0,1,0,1,0.0,1,2,0,2,0,1,1,0,Matches,Lyon,Ligue-1
2013,Mama Samba Baldé,gw GNB,FW,28.0,0.4,2,2,0,2,0,0,0,,0,0,0,0,1,3,1,0,Matches,Lyon,Ligue-1
2014,Alejandro Rodriguez,pt POR,MF,16.0,0.2,0,0,0,0,0,0,0,,0,0,0,0,0,0,0,0,Matches,Lyon,Ligue-1
2015,Paul Akouokou,ci CIV,MF,26.0,0.2,1,0,0,1,0,0,0,,0,0,0,0,1,2,0,1,Matches,Lyon,Ligue-1
2016,Mahamadou Diawara,fr FRA,MF,19.0,0.2,1,0,0,1,0,1,3,33.3,2,2,0,2,0,1,0,0,Matches,Lyon,Ligue-1
2017,Warmed Omari,km COM,DF,24.0,0.1,0,0,0,0,0,0,0,,0,0,0,0,0,0,1,0,Matches,Lyon,Ligue-1
2018,Téo Barisic,fr FRA,DF,19.0,0.0,0,0,0,0,0,0,0,,0,0,0,0,0,0,1,0,Matches,Lyon,Ligue-1
2019,Adryelson,br BRA,DF,26.0,0.0,0,0,0,0,0,0,0,,0,0,0,0,1,1,1,0,Matches,Lyon,Ligue-1
2020,Gerónimo Rulli,ar ARG,GK,32.0,34.0,4,3,4,0,0,4,8,50.0,4,1,0,1,1,5,25,3,Matches,Marseille,Ligue-1
2021,Mason Greenwood,eng ENG,"FW,MF",22.0,31.2,35,18,10,14,11,16,39,41.0,23,7,0,7,12,47,5,2,Matches,Marseille,Ligue-1
2022,Pierre Højbjerg,dk DEN,MF,28.0,29.6,64,45,25,32,7,37,69,53.6,32,28,4,24,42,106,33,2,Matches,Marseille,Ligue-1
2023,Luis Henrique,br BRA,"DF,FW",22.0,29.0,16,9,7,6,3,9,10,90.0,1,15,2,13,10,26,30,0,Matches,Marseille,Ligue-1
2024,Adrien Rabiot,fr FRA,MF,29.0,27.6,49,31,17,21,11,19,32,59.4,13,21,2,19,21,70,32,0,Matches,Marseille,Ligue-1
2025,Michael Amir Murillo,pa PAN,DF,28.0,27.1,49,31,30,13,6,32,46,69.6,14,21,8,13,18,67,70,4,Matches,Marseille,Ligue-1
2026,Leonardo Balerdi,ar ARG,DF,25.0,25.3,54,39,32,17,5,27,47,57.4,20,25,14,11,38,92,72,4,Matches,Marseille,Ligue-1
2027,Geoffrey Kondogbia,cf CTA,"DF,MF",31.0,22.4,60,38,31,26,3,27,34,79.4,7,23,6,17,22,82,64,4,Matches,Marseille,Ligue-1
2028,Quentin Merlin,fr FRA,DF,22.0,17.7,22,17,12,5,5,9,16,56.3,7,20,4,16,14,36,17,1,Matches,Marseille,Ligue-1
2029,Valentin Rongier,fr FRA,"MF,DF",29.0,17.4,50,28,14,31,5,27,43,62.8,16,30,9,21,33,83,28,5,Matches,Marseille,Ligue-1
2030,Derek Cornelius,ca CAN,DF,26.0,15.8,24,17,15,8,1,17,22,77.3,5,16,10,6,14,38,51,0,Matches,Marseille,Ligue-1
2031,Neal Maupay,fr FRA,FW,27.0,11.6,9,4,1,6,2,3,6,50.0,3,5,0,5,2,11,0,0,Matches,Marseille,Ligue-1
2032,Amine Gouiri,dz ALG,"FW,MF",24.0,11.6,5,5,0,1,4,2,3,66.7,1,9,0,9,1,6,1,0,Matches,Marseille,Ligue-1
2033,Ulisses Garcia,ch SUI,DF,28.0,10.3,14,11,7,5,2,4,14,28.6,10,5,1,4,8,22,18,0,Matches,Marseille,Ligue-1
2034,Lilian Brassier,fr FRA,DF,24.0,8.7,8,6,8,0,0,5,6,83.3,1,8,3,5,9,17,28,2,Matches,Marseille,Ligue-1
2035,Ismaël Bennacer,dz ALG,MF,26.0,7.2,21,10,8,12,1,12,18,66.7,6,6,0,6,10,31,2,1,Matches,Marseille,Ligue-1
2036,Amine Harit,ma MAR,MF,27.0,5.8,8,7,0,6,2,1,2,50.0,1,6,0,6,3,11,1,1,Matches,Marseille,Ligue-1
2037,Elye Wahi,fr FRA,FW,21.0,6.4,0,0,0,0,0,0,4,0.0,4,1,0,1,1,1,0,0,Matches,Marseille,Ligue-1
2038,Jon Rowe,eng ENG,"FW,MF",21.0,9.0,15,11,5,4,6,6,14,42.9,8,4,1,3,2,17,4,0,Matches,Marseille,Ligue-1
2039,Pol Lirola,es ESP,DF,26.0,7.6,13,9,5,8,0,5,13,38.5,8,7,2,5,4,17,12,0,Matches,Marseille,Ligue-1
2040,Bilal Nadir,ma MAR,MF,20.0,4.3,10,3,4,6,0,4,6,66.7,2,6,1,5,4,14,7,0,Matches,Marseille,Ligue-1
2041,Ismaël Koné,ca CAN,"MF,FW",22.0,4.0,8,4,3,3,2,3,4,75.0,1,4,1,3,4,12,2,1,Matches,Marseille,Ligue-1
2042,Amar Dedić,ba BIH,DF,21.0,3.5,5,4,2,2,1,3,10,30.0,7,0,0,0,3,8,12,1,Matches,Marseille,Ligue-1
2043,Luiz Felipe,it ITA,DF,27.0,1.4,4,3,3,1,0,1,2,50.0,1,3,2,1,3,7,5,0,Matches,Marseille,Ligue-1
2044,Valentin Carboni,ar ARG,"MF,FW",19.0,1.1,2,2,0,1,1,0,1,0.0,1,1,0,1,1,3,1,0,Matches,Marseille,Ligue-1
2045,Robinio Vaz,fr FRA,FW,17.0,0.8,1,1,0,0,1,0,2,0.0,2,0,0,0,0,1,2,0,Matches,Marseille,Ligue-1
2046,Bamo Meïté,ci CIV,DF,22.0,0.3,0,0,0,0,0,0,0,,0,0,0,0,0,0,1,0,Matches,Marseille,Ligue-1
2047,Enzo Sternal,fr FRA,"FW,MF",17.0,0.3,0,0,0,0,0,0,0,,0,0,0,0,0,0,0,0,Matches,Marseille,Ligue-1
2048,Darryl Bakola,fr FRA,"DF,MF",16.0,0.2,1,1,0,1,0,0,0,,0,0,0,0,0,1,0,0,Matches,Marseille,Ligue-1
2049,Emmanuel Koum Mbondo,fr FRA,DF,18.0,0.1,0,0,0,0,0,0,0,,0,0,0,0,0,0,0,0,Matches,Marseille,Ligue-1
2050,Faris Pemi Moumbagna,cm CMR,FW,24.0,0.1,0,0,0,0,0,0,0,,0,0,0,0,0,0,0,0,Matches,Marseille,Ligue-1
2051,Keyliane Abdallah,fr FRA,FW,18.0,0.0,1,1,1,0,0,1,1,100.0,0,0,0,0,0,1,0,0,Matches,Marseille,Ligue-1
2052,Maghnes Akliouche,fr FRA,"FW,MF",22.0,26.7,51,31,12,24,15,19,41,46.3,22,21,0,21,15,66,13,0,Matches,Monaco,Ligue-1
2053,Thilo Kehrer,de GER,DF,27.0,26.5,37,23,26,11,0,22,38,57.9,16,18,10,8,36,73,113,1,Matches,Monaco,Ligue-1
2054,Takumi Minamino,jp JPN,"MF,FW",29.0,24.8,33,19,7,14,12,15,42,35.7,27,26,1,25,10,43,20,0,Matches,Monaco,Ligue-1
2055,Lamine Camara,sn SEN,MF,20.0,22.8,66,41,22,34,10,26,48,54.2,22,30,4,26,31,97,32,1,Matches,Monaco,Ligue-1
2056,Denis Zakaria,ch SUI,MF,27.0,23.8,41,26,15,19,7,24,33,72.7,9,31,8,23,34,75,39,1,Matches,Monaco,Ligue-1
2057,Wilfried Singo,ci CIV,DF,23.0,23.3,37,23,24,10,3,20,28,71.4,8,17,9,8,43,80,110,2,Matches,Monaco,Ligue-1
2058,Vanderson,br BRA,DF,23.0,22.9,76,48,37,30,9,45,64,70.3,19,43,6,37,39,115,65,2,Matches,Monaco,Ligue-1
2059,Caio Henrique Oliveira Silva,br BRA,DF,27.0,21.4,37,26,16,19,2,23,44,52.3,21,26,8,18,22,59,59,0,Matches,Monaco,Ligue-1
2060,Breel Embolo,ch SUI,"FW,MF",27.0,20.5,22,17,7,7,8,5,16,31.3,11,11,0,11,3,25,10,1,Matches,Monaco,Ligue-1
2061,Eliesse Ben Seghir,ma MAR,"MF,FW",19.0,19.4,31,22,12,12,7,18,32,56.3,14,20,0,20,13,44,4,0,Matches,Monaco,Ligue-1
2062,Philipp Köhn,ch SUI,GK,26.0,19.0,0,0,0,0,0,0,1,0.0,1,0,0,0,0,0,11,2,Matches,Monaco,Ligue-1
2063,Christian Mawissa,fr FRA,DF,19.0,16.7,42,29,27,13,2,26,44,59.1,18,25,6,19,26,68,48,1,Matches,Monaco,Ligue-1
2064,Mika Biereth,dk DEN,FW,21.0,13.6,5,5,0,3,2,3,7,42.9,4,11,0,11,4,9,7,0,Matches,Monaco,Ligue-1
2065,Radosław Majecki,pl POL,GK,24.0,15.0,0,0,0,0,0,0,2,0.0,2,0,0,0,0,0,8,1,Matches,Monaco,Ligue-1
2066,Aleksandr Golovin,ru RUS,"MF,FW",28.0,12.8,38,24,9,20,9,17,39,43.6,22,16,4,12,12,50,7,0,Matches,Monaco,Ligue-1
2067,Soungoutou Magassa,fr FRA,MF,20.0,11.4,47,25,14,27,6,25,46,54.3,21,16,3,13,21,68,19,1,Matches,Monaco,Ligue-1
2068,Mohammed Salisu,gh GHA,DF,25.0,11.4,28,18,16,11,1,13,16,81.3,3,10,8,2,16,44,54,2,Matches,Monaco,Ligue-1
2069,Jordan Teze,nl NED,DF,24.0,6.3,18,9,8,9,1,7,16,43.8,9,12,1,11,6,24,15,0,Matches,Monaco,Ligue-1
2070,Folarin Balogun,us USA,FW,23.0,6.8,1,1,0,0,1,0,4,0.0,4,0,0,0,1,2,0,0,Matches,Monaco,Ligue-1
2071,George Ilenikhena,ng NGA,FW,17.0,8.0,4,2,0,3,1,1,2,50.0,1,0,0,0,2,6,0,0,Matches,Monaco,Ligue-1
2072,Kassoum Ouattara,fr FRA,"DF,FW",19.0,4.3,9,7,5,4,0,4,14,28.6,10,6,0,6,5,14,2,1,Matches,Monaco,Ligue-1
2073,Krépin Diatta,sn SEN,"DF,FW",25.0,5.6,18,12,13,2,3,14,24,58.3,10,5,1,4,9,27,12,2,Matches,Monaco,Ligue-1
2074,Almoatasem Al Musrati,ly LBY,MF,28.0,4.3,14,11,5,8,1,7,11,63.6,4,3,1,2,5,19,9,0,Matches,Monaco,Ligue-1
2075,Ismail Jakobs,sn SEN,DF,24.0,2.0,5,5,3,0,2,3,5,60.0,2,0,0,0,2,7,6,0,Matches,Monaco,Ligue-1
2076,Saïmon Bouabré,fr FRA,"MF,FW",18.0,1.1,1,0,0,1,0,0,3,0.0,3,1,0,1,0,1,0,0,Matches,Monaco,Ligue-1
2077,Eliot Matazo,be BEL,MF,22.0,0.8,3,2,0,3,0,0,0,,0,0,0,0,1,4,2,0,Matches,Monaco,Ligue-1
2078,Lucas Michal,fr FRA,"FW,MF",19.0,1.3,5,3,3,2,0,2,4,50.0,2,2,0,2,1,6,2,0,Matches,Monaco,Ligue-1
2079,Mamadou Coulibaly,fr FRA,MF,20.0,0.1,1,0,0,1,0,0,0,,0,0,0,0,0,1,0,0,Matches,Monaco,Ligue-1
2080,Benjamin Lecomte,fr FRA,GK,33.0,30.0,0,0,0,0,0,0,0,,0,0,0,0,0,0,18,2,Matches,Montpellier,Ligue-1
2081,Téji Savanier,fr FRA,MF,32.0,26.3,29,25,7,16,6,18,43,41.9,25,16,1,15,15,44,21,4,Matches,Montpellier,Ligue-1
2082,Modibo Sagnan,ml MLI,DF,25.0,23.8,57,35,38,16,3,26,44,59.1,18,24,13,11,29,86,110,5,Matches,Montpellier,Ligue-1
2083,Joris Chotard,fr FRA,MF,22.0,21.0,39,27,17,20,2,20,46,43.5,26,28,10,18,19,58,52,1,Matches,Montpellier,Ligue-1
2084,Enzo Tchato,cm CMR,DF,21.0,21.1,48,26,26,18,4,26,44,59.1,18,30,10,20,22,70,59,0,Matches,Montpellier,Ligue-1
2085,Becir Omeragic,ch SUI,DF,22.0,20.0,32,16,19,12,1,16,21,76.2,5,32,21,11,13,45,78,0,Matches,Montpellier,Ligue-1
2086,Jordan Ferri,fr FRA,MF,32.0,19.7,42,23,18,22,2,18,44,40.9,26,20,3,17,9,51,20,0,Matches,Montpellier,Ligue-1
2087,Rabby Nzingoula,cg CGO,MF,18.0,18.8,64,42,26,31,7,27,58,46.6,31,27,5,22,29,93,23,0,Matches,Montpellier,Ligue-1
2088,Tanguy Coulibaly,fr FRA,"FW,MF",23.0,16.5,32,24,13,15,4,14,33,42.4,19,18,2,16,11,43,3,1,Matches,Montpellier,Ligue-1
2089,Issiaga Sylla,gn GUI,DF,30.0,12.8,25,10,17,7,1,15,29,51.7,14,13,4,9,10,35,34,1,Matches,Montpellier,Ligue-1
2090,Falaye Sacko,ml MLI,DF,29.0,13.7,14,8,9,4,1,9,19,47.4,10,17,7,10,13,27,21,0,Matches,Montpellier,Ligue-1
2091,Arnaud Nordin,fr FRA,FW,26.0,13.0,24,15,6,16,2,11,21,52.4,10,12,0,12,5,29,7,0,Matches,Montpellier,Ligue-1
2092,Akor Adams,ng NGA,FW,24.0,11.9,4,3,1,2,1,3,4,75.0,1,2,1,1,1,5,5,1,Matches,Montpellier,Ligue-1
2093,Musa Al-Taamari,jo JOR,"FW,MF",27.0,12.4,14,10,4,5,5,8,15,53.3,7,2,0,2,3,17,3,2,Matches,Montpellier,Ligue-1
2094,Théo Sainte-Luce,fr FRA,DF,25.0,11.3,24,11,16,4,4,16,33,48.5,17,16,4,12,12,36,33,1,Matches,Montpellier,Ligue-1
2095,Wahbi Khazri,tn TUN,"FW,MF",33.0,12.4,25,18,5,16,4,8,21,38.1,13,13,1,12,5,30,7,0,Matches,Montpellier,Ligue-1
2096,Khalil Fayad,fr FRA,"MF,FW",20.0,11.4,31,16,12,17,2,15,28,53.6,13,18,1,17,10,41,15,1,Matches,Montpellier,Ligue-1
2097,Yael Mouanga,fr FRA,DF,19.0,10.5,14,8,9,3,2,7,9,77.8,2,16,8,8,10,24,50,0,Matches,Montpellier,Ligue-1
2098,Boubakar Kouyaté,ml MLI,DF,27.0,8.4,22,17,16,6,0,11,19,57.9,8,17,11,6,12,34,54,0,Matches,Montpellier,Ligue-1
2099,Lucas Mincarelli,fr FRA,DF,20.0,7.9,17,10,6,9,2,6,13,46.2,7,8,5,3,9,26,27,0,Matches,Montpellier,Ligue-1
2100,Andy Delort,dz ALG,FW,32.0,6.7,4,3,1,2,1,1,2,50.0,1,3,1,2,0,4,3,0,Matches,Montpellier,Ligue-1
2101,Nikola Maksimović,rs SRB,DF,32.0,6.5,9,5,6,3,0,6,7,85.7,1,5,4,1,6,15,30,1,Matches,Montpellier,Ligue-1
2102,Bamo Meïté,ci CIV,DF,22.0,4.7,5,3,2,1,2,1,2,50.0,1,3,3,0,4,9,14,3,Matches,Montpellier,Ligue-1
2103,Nicolas Pays,fr FRA,"FW,MF",20.0,5.0,13,6,3,4,6,4,8,50.0,4,1,0,1,4,17,2,0,Matches,Montpellier,Ligue-1
2104,Junior Ndiaye,fr FRA,FW,19.0,4.9,3,2,2,1,0,1,4,25.0,3,2,1,1,0,3,2,0,Matches,Montpellier,Ligue-1
2105,Dimitry Bertaud,cd COD,GK,26.0,4.0,0,0,0,0,0,0,0,,0,0,0,0,0,0,2,0,Matches,Montpellier,Ligue-1
2106,Wilfried Ndollo,cm CMR,DF,19.0,4.5,6,5,4,1,1,4,8,50.0,4,9,1,8,7,13,11,0,Matches,Montpellier,Ligue-1
2107,Othmane Maamma,ma MAR,"FW,MF",18.0,4.0,3,1,2,1,0,1,4,25.0,3,4,0,4,1,4,2,1,Matches,Montpellier,Ligue-1
2108,Birama Touré,ml MLI,"MF,DF",32.0,3.3,8,5,5,2,1,4,6,66.7,2,3,2,1,6,14,7,0,Matches,Montpellier,Ligue-1
2109,Stefan Džodić,rs SRB,"DF,MF",19.0,2.7,8,5,3,5,0,5,8,62.5,3,5,4,1,5,13,10,1,Matches,Montpellier,Ligue-1
2110,Théo Chennahi,fr FRA,DF,19.0,2.0,6,3,3,3,0,4,7,57.1,3,3,0,3,2,8,6,0,Matches,Montpellier,Ligue-1
2111,Yanis Issoufou,fr FRA,"MF,FW",17.0,0.9,6,4,4,1,1,3,5,60.0,2,1,0,1,0,6,1,0,Matches,Montpellier,Ligue-1
2112,Gabriel Bares,ch SUI,"MF,DF",23.0,0.6,2,2,2,0,0,1,2,50.0,1,0,0,0,1,3,3,0,Matches,Montpellier,Ligue-1
2113,Axel Gueguin,fr FRA,FW,19.0,0.3,1,1,0,1,0,1,1,100.0,0,0,0,0,0,1,0,0,Matches,Montpellier,Ligue-1
2114,Simon Cara,fr FRA,"MF,FW",19.0,0.1,0,0,0,0,0,0,0,,0,0,0,0,0,0,0,0,Matches,Montpellier,Ligue-1
2115,Matthis Abline,fr FRA,FW,21.0,30.8,11,5,2,4,5,3,9,33.3,6,15,1,14,4,15,36,1,Matches,Nantes,Ligue-1
2116,Moses Simon,ng NGA,"FW,MF",29.0,29.0,20,14,4,7,9,7,22,31.8,15,11,0,11,12,32,13,0,Matches,Nantes,Ligue-1
2117,Jean-Charles Castelletto,cm CMR,"DF,MF",29.0,29.1,34,17,17,15,2,17,27,63.0,10,27,18,9,25,59,151,0,Matches,Nantes,Ligue-1
2118,Pedro Chirivella,es ESP,MF,27.0,26.1,44,29,23,16,5,19,42,45.2,23,25,4,21,19,63,45,0,Matches,Nantes,Ligue-1
2119,Douglas,br BRA,MF,27.0,25.6,69,42,29,31,9,26,44,59.1,18,51,11,40,32,101,47,0,Matches,Nantes,Ligue-1
2120,Kelvin Amian,fr FRA,DF,26.0,24.1,55,31,40,14,1,29,35,82.9,6,18,11,7,13,68,85,0,Matches,Nantes,Ligue-1
2121,Nicolas Cozza,fr FRA,"DF,MF",25.0,22.8,59,41,35,18,6,31,47,66.0,16,25,10,15,25,84,69,0,Matches,Nantes,Ligue-1
2122,Johann Lepenant,fr FRA,MF,21.0,22.8,68,33,30,27,11,32,71,45.1,39,35,3,32,18,86,25,0,Matches,Nantes,Ligue-1
2123,Nicolas Pallois,fr FRA,DF,36.0,22.4,61,27,44,13,4,37,63,58.7,26,48,18,30,28,89,164,3,Matches,Nantes,Ligue-1
2124,Anthony Lopes,pt POR,GK,33.0,17.4,1,0,1,0,0,1,1,100.0,0,0,0,0,1,2,7,1,Matches,Nantes,Ligue-1
2125,Nathan Zeze,fr FRA,DF,19.0,16.8,38,22,22,16,0,23,33,69.7,10,22,9,13,23,61,120,1,Matches,Nantes,Ligue-1
2126,Sorba Thomas,wls WAL,"FW,MF",24.0,14.7,14,6,7,5,2,10,18,55.6,8,12,2,10,9,23,27,1,Matches,Nantes,Ligue-1
2127,Alban Lafont,fr FRA,GK,25.0,12.0,1,1,1,0,0,1,1,100.0,0,2,0,2,0,1,8,1,Matches,Nantes,Ligue-1
2128,Mostafa Mohamed,eg EGY,FW,26.0,13.9,18,9,6,8,4,4,12,33.3,8,10,2,8,10,28,27,0,Matches,Nantes,Ligue-1
2129,Marcus Coco,fr FRA,DF,28.0,10.6,27,21,15,9,3,16,31,51.6,15,16,5,11,11,38,46,0,Matches,Nantes,Ligue-1
2130,Saidou Sow,gn GUI,DF,22.0,8.9,17,11,13,4,0,6,10,60.0,4,19,12,7,13,30,46,1,Matches,Nantes,Ligue-1
2131,Louis Leroux,fr FRA,"MF,DF",18.0,9.1,25,18,10,12,3,16,22,72.7,6,22,2,20,8,33,19,1,Matches,Nantes,Ligue-1
2132,Jean-Kevin Duverne,ht HAI,DF,27.0,6.0,21,12,13,4,4,15,27,55.6,12,10,3,7,8,29,23,0,Matches,Nantes,Ligue-1
2133,Tino Kadewere,zw ZIM,"MF,FW",28.0,5.7,14,8,5,3,6,6,13,46.2,7,3,0,3,6,20,8,0,Matches,Nantes,Ligue-1
2134,Patrik Carlgren,se SWE,GK,32.0,4.6,0,0,0,0,0,0,0,,0,0,0,0,0,0,0,0,Matches,Nantes,Ligue-1
2135,Fabien Centonze,fr FRA,DF,28.0,2.9,8,4,5,2,1,4,6,66.7,2,4,1,3,2,10,17,0,Matches,Nantes,Ligue-1
2136,Florent Mollet,fr FRA,"MF,FW",32.0,2.7,2,2,1,1,0,1,1,100.0,0,2,0,2,1,3,4,0,Matches,Nantes,Ligue-1
2137,Francis Coquelin,fr FRA,MF,33.0,2.5,9,5,5,3,1,3,4,75.0,1,3,1,2,6,15,3,0,Matches,Nantes,Ligue-1
2138,Bahereba Guirassy,fr FRA,"FW,MF",17.0,3.9,12,8,6,3,3,7,13,53.8,6,10,0,10,1,13,4,0,Matches,Nantes,Ligue-1
2139,Jean-Philippe Gbamin,ci CIV,MF,28.0,2.4,2,1,0,2,0,1,4,25.0,3,5,2,3,3,5,2,0,Matches,Nantes,Ligue-1
2140,Ignatius Ganago,cm CMR,"FW,MF",25.0,2.7,1,1,0,1,0,1,2,50.0,1,3,1,2,4,5,2,0,Matches,Nantes,Ligue-1
2141,Meschak Elia,cd COD,FW,26.0,1.9,7,5,3,2,2,1,1,100.0,0,3,0,3,0,7,2,0,Matches,Nantes,Ligue-1
2142,Dehmaine Assoumani,fr FRA,"MF,FW",19.0,1.1,6,3,0,4,2,4,5,80.0,1,1,0,1,1,7,4,0,Matches,Nantes,Ligue-1
2143,Plamedi Nsingi,,MF,23.0,0.2,1,0,1,0,0,0,1,0.0,1,0,0,0,0,1,0,0,Matches,Nantes,Ligue-1
2144,Sékou Doucoure,fr FRA,DF,19.0,0.1,0,0,0,0,0,0,0,,0,0,0,0,0,0,3,0,Matches,Nantes,Ligue-1
2145,Marcin Bułka,pl POL,GK,24.0,34.0,0,0,0,0,0,0,1,0.0,1,0,0,0,0,0,16,6,Matches,Nice,Ligue-1
2146,Evann Guessand,ci CIV,"FW,MF",23.0,28.5,44,29,12,15,17,6,14,42.9,8,27,3,24,15,59,16,0,Matches,Nice,Ligue-1
2147,Hicham Boudaoui,dz ALG,MF,24.0,27.1,76,52,28,37,11,31,53,58.5,22,40,11,29,22,98,45,1,Matches,Nice,Ligue-1
2148,Jonathan Clauss,fr FRA,"DF,MF",31.0,25.6,52,35,27,19,6,28,56,50.0,28,25,2,23,48,100,68,3,Matches,Nice,Ligue-1
2149,Moïse Bombito,ca CAN,DF,24.0,24.4,37,25,22,12,3,24,35,68.6,11,35,19,16,18,55,121,7,Matches,Nice,Ligue-1
2150,Melvin Bard,fr FRA,"DF,MF",23.0,21.5,53,36,35,13,5,24,42,57.1,18,38,13,25,29,82,60,3,Matches,Nice,Ligue-1
2151,Youssouf Ndayishimiye,bi BDI,DF,25.0,21.5,40,21,25,14,1,16,27,59.3,11,35,19,16,21,61,117,4,Matches,Nice,Ligue-1
2152,Dante,br BRA,DF,40.0,21.8,32,15,17,13,2,15,29,51.7,14,29,14,15,34,66,74,1,Matches,Nice,Ligue-1
2153,Pablo Rosario,do DOM,"MF,DF",27.0,19.7,30,20,6,19,5,11,20,55.0,9,19,11,8,31,61,43,2,Matches,Nice,Ligue-1
2154,Mohamed Ali Cho,fr FRA,"FW,MF",20.0,18.0,13,9,4,5,4,4,12,33.3,8,17,1,16,5,18,8,0,Matches,Nice,Ligue-1
2155,Gaëtan Laborde,fr FRA,FW,30.0,20.3,19,13,9,8,2,9,22,40.9,13,16,4,12,6,25,20,0,Matches,Nice,Ligue-1
2156,Ali Abdi,tn TUN,"DF,MF",30.0,15.5,43,25,18,14,11,28,43,65.1,15,20,6,14,20,63,37,0,Matches,Nice,Ligue-1
2157,Tanguy Ndombele,fr FRA,MF,27.0,12.6,35,23,10,21,4,12,20,60.0,8,9,0,9,14,49,9,0,Matches,Nice,Ligue-1
2158,Jeremie Boga,ci CIV,"MF,FW",27.0,11.7,10,5,2,5,3,4,8,50.0,4,13,0,13,3,13,2,1,Matches,Nice,Ligue-1
2159,Badredine Bouanani,dz ALG,"MF,FW",19.0,12.2,11,4,4,4,3,6,18,33.3,12,16,3,13,11,22,4,0,Matches,Nice,Ligue-1
2160,Baptiste Santamaria,fr FRA,MF,29.0,10.3,20,10,10,7,3,13,22,59.1,9,14,3,11,18,38,19,1,Matches,Nice,Ligue-1
2161,Mohamed Abdelmoneim,eg EGY,DF,25.0,9.5,21,14,12,6,3,13,22,59.1,9,11,5,6,15,36,56,1,Matches,Nice,Ligue-1
2162,Sofiane Diop,fr FRA,"MF,FW",24.0,11.8,23,16,16,3,4,9,22,40.9,13,19,2,17,17,40,7,1,Matches,Nice,Ligue-1
2163,Antoine Mendy,sn SEN,DF,20.0,9.2,30,21,16,14,0,19,29,65.5,10,9,5,4,8,38,29,1,Matches,Nice,Ligue-1
2164,Tom Louchet,fr FRA,"DF,MF",21.0,8.6,27,17,17,5,5,17,23,73.9,6,12,4,8,18,45,20,0,Matches,Nice,Ligue-1
2165,Morgan Sanson,fr FRA,MF,29.0,2.6,6,3,2,4,0,1,3,33.3,2,3,0,3,4,10,2,0,Matches,Nice,Ligue-1
2166,Youssoufa Moukoko,de GER,"FW,MF",19.0,2.3,3,2,2,1,0,1,2,50.0,1,2,0,2,0,3,0,0,Matches,Nice,Ligue-1
2167,Yael Nandjou,fr FRA,DF,19.0,1.7,4,1,2,1,1,4,8,50.0,4,4,1,3,4,8,7,0,Matches,Nice,Ligue-1
2168,Bilal Brahimi,dz ALG,MF,24.0,0.8,0,0,0,0,0,0,0,,0,1,0,1,0,0,2,0,Matches,Nice,Ligue-1
2169,Terem Moffi,ng NGA,FW,25.0,0.6,0,0,0,0,0,0,0,,0,0,0,0,0,0,0,0,Matches,Nice,Ligue-1
2170,Amidou Doumbouya,fr FRA,DF,16.0,0.5,1,1,0,0,1,1,1,100.0,0,3,1,2,1,2,1,0,Matches,Nice,Ligue-1
2171,Victor Orakpo,ng NGA,FW,18.0,0.4,0,0,0,0,0,0,0,,0,0,0,0,0,0,0,0,Matches,Nice,Ligue-1
2172,Jordan Lotomba,ch SUI,"MF,DF",25.0,0.4,0,0,0,0,0,0,0,,0,0,0,0,0,0,1,0,Matches,Nice,Ligue-1
2173,Issiaga Camara,gn GUI,MF,19.0,0.2,2,1,0,2,0,0,1,0.0,1,0,0,0,3,5,0,0,Matches,Nice,Ligue-1
2174,Rareş Ilie,ro ROU,MF,21.0,0.1,1,1,1,0,0,1,1,100.0,0,0,0,0,0,1,0,0,Matches,Nice,Ligue-1
2175,Bernard Nguene,cm CMR,FW,17.0,0.1,0,0,0,0,0,0,0,,0,0,0,0,0,0,0,0,Matches,Nice,Ligue-1
2176,Bradley Barcola,fr FRA,FW,21.0,24.2,27,17,10,8,9,8,31,25.8,23,25,2,23,19,46,12,0,Matches,Paris-Saint-Germain,Ligue-1
2177,Gianluigi Donnarumma,it ITA,GK,25.0,23.2,1,1,1,0,0,1,2,50.0,1,0,0,0,0,1,14,0,Matches,Paris-Saint-Germain,Ligue-1
2178,Achraf Hakimi,ma MAR,DF,25.0,23.0,48,36,18,20,10,27,55,49.1,28,25,2,23,31,79,18,3,Matches,Paris-Saint-Germain,Ligue-1
2179,Willian Pacho,ec ECU,DF,22.0,23.7,56,32,34,22,0,23,32,71.9,9,35,22,13,40,96,91,1,Matches,Paris-Saint-Germain,Ligue-1
2180,Warren Zaïre-Emery,fr FRA,"MF,DF",18.0,22.8,51,26,17,21,13,23,45,51.1,22,35,6,29,23,74,20,2,Matches,Paris-Saint-Germain,Ligue-1
2181,Lucas Beraldo,br BRA,DF,20.0,22.3,38,31,30,8,0,23,37,62.2,14,16,8,8,21,59,63,3,Matches,Paris-Saint-Germain,Ligue-1
2182,João Neves,pt POR,"MF,DF",19.0,20.5,63,31,20,26,17,27,45,60.0,18,29,9,20,23,86,22,1,Matches,Paris-Saint-Germain,Ligue-1
2183,Fabián Ruiz Peña,es ESP,MF,28.0,21.4,37,24,13,15,9,21,47,44.7,26,25,3,22,16,53,27,1,Matches,Paris-Saint-Germain,Ligue-1
2184,Vitinha,pt POR,MF,24.0,22.7,43,23,13,27,3,25,48,52.1,23,26,7,19,14,57,19,2,Matches,Paris-Saint-Germain,Ligue-1
2185,Ousmane Dembélé,fr FRA,FW,27.0,19.2,11,5,0,7,4,4,12,33.3,8,3,0,3,9,20,2,1,Matches,Paris-Saint-Germain,Ligue-1
2186,Marquinhos,br BRA,DF,30.0,19.2,30,19,8,16,6,25,33,75.8,8,27,15,12,11,41,64,0,Matches,Paris-Saint-Germain,Ligue-1
2187,Nuno Mendes,pt POR,DF,22.0,18.6,30,19,15,12,3,23,39,59.0,16,25,8,17,18,48,37,2,Matches,Paris-Saint-Germain,Ligue-1
2188,Lee Kang-in,kr KOR,"FW,MF",23.0,18.5,25,17,7,11,7,19,35,54.3,16,11,1,10,3,28,3,1,Matches,Paris-Saint-Germain,Ligue-1
2189,Désiré Doué,fr FRA,"FW,MF",19.0,19.2,48,30,15,19,14,24,51,47.1,27,26,0,26,13,61,7,0,Matches,Paris-Saint-Germain,Ligue-1
2190,Gonçalo Ramos,pt POR,FW,23.0,11.8,11,6,5,5,1,3,6,50.0,3,5,1,4,0,11,5,0,Matches,Paris-Saint-Germain,Ligue-1
2191,Khvicha Kvaratskhelia,ge GEO,FW,23.0,10.2,19,13,4,12,3,13,23,56.5,10,7,0,7,2,21,4,0,Matches,Paris-Saint-Germain,Ligue-1
2192,Lucas Hernández,fr FRA,DF,28.0,9.7,24,18,13,9,2,14,23,60.9,9,12,5,7,7,31,37,2,Matches,Paris-Saint-Germain,Ligue-1
2193,Matvei Safonov,ru RUS,GK,25.0,9.8,0,0,0,0,0,0,0,,0,1,0,1,1,1,3,0,Matches,Paris-Saint-Germain,Ligue-1
2194,Senny Mayulu,fr FRA,MF,18.0,9.0,25,16,8,14,3,8,14,57.1,6,8,3,5,5,30,12,0,Matches,Paris-Saint-Germain,Ligue-1
2195,Marco Asensio,es ESP,"FW,MF",28.0,6.9,4,3,1,3,0,0,6,0.0,6,1,0,1,0,4,1,0,Matches,Paris-Saint-Germain,Ligue-1
2196,Milan Škriniar,sk SVK,DF,29.0,4.2,7,5,3,4,0,3,3,100.0,0,7,6,1,3,10,16,0,Matches,Paris-Saint-Germain,Ligue-1
2197,Ibrahim Mbaye,fr FRA,"FW,MF",16.0,3.8,4,2,1,2,1,3,8,37.5,5,2,0,2,2,6,2,0,Matches,Paris-Saint-Germain,Ligue-1
2198,Randal Kolo Muani,fr FRA,FW,25.0,4.0,4,4,1,1,2,0,2,0.0,2,1,0,1,0,4,5,0,Matches,Paris-Saint-Germain,Ligue-1
2199,Yoram Zague,fr FRA,"DF,FW",18.0,2.0,8,6,3,1,4,6,8,75.0,2,3,0,3,2,10,2,0,Matches,Paris-Saint-Germain,Ligue-1
2200,Axel Tapé,fr FRA,"DF,MF",16.0,2.0,3,1,1,2,0,2,2,100.0,0,2,2,0,1,4,5,0,Matches,Paris-Saint-Germain,Ligue-1
2201,Arnau Tenas,es ESP,GK,23.0,1.0,0,0,0,0,0,0,0,,0,0,0,0,0,0,0,0,Matches,Paris-Saint-Germain,Ligue-1
2202,Noham Kamara,fr FRA,DF,17.0,0.8,1,1,0,1,0,0,0,,0,1,1,0,1,2,1,0,Matches,Paris-Saint-Germain,Ligue-1
2203,Presnel Kimpembe,fr FRA,DF,28.0,0.3,1,0,1,0,0,0,0,,0,2,2,0,0,1,1,0,Matches,Paris-Saint-Germain,Ligue-1
2204,Yehvann Diouf,sn SEN,GK,24.0,34.0,2,1,2,0,0,1,3,33.3,2,0,0,0,1,3,22,4,Matches,Reims,Ligue-1
2205,Valentin Atangana Edoa,fr FRA,MF,18.0,31.7,69,50,32,30,7,28,38,73.7,10,31,15,16,37,106,64,0,Matches,Reims,Ligue-1
2206,Junya Ito,jp JPN,"FW,MF",31.0,29.9,45,30,19,16,10,17,60,28.3,43,33,3,30,13,58,15,2,Matches,Reims,Ligue-1
2207,Keito Nakamura,jp JPN,"FW,MF",24.0,29.4,24,16,7,10,7,11,31,35.5,20,21,1,20,13,37,19,0,Matches,Reims,Ligue-1
2208,Sergio Akieme,es ESP,DF,26.0,28.0,34,23,30,3,1,22,36,61.1,14,26,9,17,17,51,97,4,Matches,Reims,Ligue-1
2209,Cédric Kipré,ci CIV,DF,27.0,24.3,42,30,30,11,1,29,39,74.4,10,42,27,15,32,74,162,2,Matches,Reims,Ligue-1
2210,Aurélio Buta,pt POR,DF,27.0,21.9,37,24,22,11,4,21,42,50.0,21,19,5,14,22,59,59,0,Matches,Reims,Ligue-1
2211,Joseph Okumu,ke KEN,DF,27.0,18.8,30,15,21,9,0,15,24,62.5,9,33,21,12,25,55,137,2,Matches,Reims,Ligue-1
2212,Oumar Diakité,ci CIV,FW,20.0,18.1,20,13,7,8,5,9,19,47.4,10,13,2,11,3,23,9,0,Matches,Reims,Ligue-1
2213,Marshall Munetsi,zw ZIM,MF,28.0,18.8,36,18,22,9,5,22,38,57.9,16,27,3,24,17,53,35,0,Matches,Reims,Ligue-1
2214,Amadou Koné,ml MLI,MF,19.0,14.4,49,32,32,16,1,22,35,62.9,13,18,4,14,19,68,38,2,Matches,Reims,Ligue-1
2215,Emmanuel Agbadou,ci CIV,DF,27.0,14.0,25,17,19,3,3,19,26,73.1,7,22,13,9,19,44,64,1,Matches,Reims,Ligue-1
2216,Mory Gbane,ci CIV,"DF,MF",23.0,12.5,20,11,16,4,0,13,24,54.2,11,12,10,2,18,38,90,1,Matches,Reims,Ligue-1
2217,Nhoa Sangui,fr FRA,"DF,MF",18.0,12.9,16,9,6,6,4,9,12,75.0,3,8,4,4,8,24,23,0,Matches,Reims,Ligue-1
2218,Hiroki Sekine,jp JPN,DF,21.0,9.9,9,7,6,2,1,7,17,41.2,10,22,11,11,5,14,51,1,Matches,Reims,Ligue-1
2219,Teddy Teuma,mt MLT,MF,30.0,8.3,18,10,6,6,6,7,25,28.0,18,12,2,10,12,30,8,1,Matches,Reims,Ligue-1
2220,Yaya Kader Fofana,ml MLI,"MF,FW",20.0,7.0,17,11,8,5,4,4,12,33.3,8,11,2,9,3,20,2,0,Matches,Reims,Ligue-1
2221,Jordan Pefok,us USA,FW,28.0,4.2,3,2,0,3,0,2,3,66.7,1,3,1,2,2,5,5,0,Matches,Reims,Ligue-1
2222,Mamadou Diakhon,fr FRA,"FW,MF",18.0,9.5,12,8,4,3,5,9,18,50.0,9,5,1,4,4,16,5,0,Matches,Reims,Ligue-1
2223,John Joe,ie IRL,MF,20.0,6.1,24,15,11,10,3,7,19,36.8,12,11,2,9,6,30,9,0,Matches,Reims,Ligue-1
2224,Hafiz Ibrahim,ng NGA,FW,18.0,4.3,3,2,0,1,2,0,5,0.0,5,4,2,2,2,5,6,0,Matches,Reims,Ligue-1
2225,Amine Salama,fr FRA,FW,24.0,4.1,3,2,0,2,1,0,3,0.0,3,2,1,1,1,4,0,0,Matches,Reims,Ligue-1
2226,Thibault De Smet,be BEL,DF,26.0,2.1,6,4,5,1,0,4,4,100.0,0,5,3,2,4,10,12,0,Matches,Reims,Ligue-1
2227,Ange Martial Tia,ml MLI,"MF,DF",17.0,1.9,4,3,1,2,1,2,6,33.3,4,3,0,3,2,6,4,0,Matches,Reims,Ligue-1
2228,Malcolm Jeng,se SWE,DF,19.0,1.2,0,0,0,0,0,0,0,,0,1,0,1,3,3,10,0,Matches,Reims,Ligue-1
2229,Abdoul Koné,fr FRA,DF,19.0,1.5,5,3,4,1,0,3,5,60.0,2,2,1,1,1,6,5,0,Matches,Reims,Ligue-1
2230,Gabriel Moscardo,br BRA,"MF,DF",18.0,0.9,3,1,2,1,0,1,3,33.3,2,3,1,2,0,3,1,0,Matches,Reims,Ligue-1
2231,Reda Khadra,de GER,"MF,FW",23.0,0.9,1,1,1,0,0,0,1,0.0,1,0,0,0,0,1,1,0,Matches,Reims,Ligue-1
2232,Niama Sissoko,ml MLI,"FW,MF",18.0,0.5,0,0,0,0,0,0,0,,0,1,0,1,0,0,0,0,Matches,Reims,Ligue-1
2233,Martin Adeline,fr FRA,MF,20.0,0.3,1,1,0,1,0,1,2,50.0,1,0,0,0,0,1,2,0,Matches,Reims,Ligue-1
2234,Eloge Zabi,ci CIV,"DF,MF",17.0,0.2,0,0,0,0,0,0,0,,0,0,0,0,0,0,1,0,Matches,Reims,Ligue-1
2235,Mohamed Daramy,dk DEN,FW,22.0,0.2,0,0,0,0,0,0,0,,0,0,0,0,0,0,1,0,Matches,Reims,Ligue-1
2236,Mohamed Bamba,ci CIV,MF,19.0,0.1,0,0,0,0,0,0,1,0.0,1,2,1,1,0,0,1,0,Matches,Reims,Ligue-1
2237,Ike Orazi,ie IRL,MF,17.0,0.0,0,0,0,0,0,0,0,,0,0,0,0,0,0,0,0,Matches,Reims,Ligue-1
2238,Adrien Truffert,fr FRA,"DF,MF",22.0,30.6,61,36,27,21,13,32,48,66.7,16,44,6,38,27,88,56,1,Matches,Rennes,Ligue-1
2239,Arnaud Kalimuendo,fr FRA,"FW,MF",22.0,28.6,19,12,6,9,4,7,15,46.7,8,9,2,7,4,23,16,1,Matches,Rennes,Ligue-1
2240,Lorenz Assignon,tg TOG,"DF,MF",24.0,26.2,49,27,25,22,2,19,43,44.2,24,20,3,17,25,74,74,0,Matches,Rennes,Ligue-1
2241,Ludovic Blas,fr FRA,"MF,FW",26.0,25.5,38,25,9,12,17,23,42,54.8,19,16,2,14,13,51,11,0,Matches,Rennes,Ligue-1
2242,Azor Matusiwa,nl NED,MF,26.0,23.1,64,39,32,30,2,32,43,74.4,11,29,10,19,34,98,52,0,Matches,Rennes,Ligue-1
2243,Hans Hateboer,nl NED,DF,30.0,18.7,31,16,14,12,5,18,36,50.0,18,19,6,13,29,60,64,2,Matches,Rennes,Ligue-1
2244,Brice Samba,fr FRA,GK,30.0,17.0,2,1,2,0,0,1,2,50.0,1,0,0,0,0,2,12,3,Matches,Rennes,Ligue-1
2245,Steve Mandanda,fr FRA,GK,39.0,16.5,0,0,0,0,0,0,1,0.0,1,0,0,0,0,0,6,2,Matches,Rennes,Ligue-1
2246,Christopher Wooh,cm CMR,DF,22.0,16.2,36,19,21,13,2,18,27,66.7,9,22,8,14,23,59,63,0,Matches,Rennes,Ligue-1
2247,Lilian Brassier,fr FRA,DF,24.0,13.7,15,12,11,4,0,9,11,81.8,2,17,10,7,22,37,62,1,Matches,Rennes,Ligue-1
2248,Leo Skiri Østigård,no NOR,DF,24.0,13.6,20,18,16,4,0,15,22,68.2,7,12,10,2,15,35,81,1,Matches,Rennes,Ligue-1
2249,Jordan James,wls WAL,MF,20.0,13.1,30,19,8,18,4,16,30,53.3,14,14,1,13,14,44,17,1,Matches,Rennes,Ligue-1
2250,Djaoui Cissé,fr FRA,MF,20.0,12.5,33,18,12,15,6,16,26,61.5,10,29,4,25,13,46,11,1,Matches,Rennes,Ligue-1
2251,Amine Gouiri,dz ALG,"MF,FW",24.0,11.5,9,6,4,4,1,2,8,25.0,6,8,0,8,2,11,5,0,Matches,Rennes,Ligue-1
2252,Anthony Rouault,fr FRA,DF,23.0,10.8,12,8,10,2,0,4,4,100.0,0,13,11,2,8,20,65,0,Matches,Rennes,Ligue-1
2253,Jérémy Jacquet,fr FRA,DF,19.0,10.3,26,17,11,8,7,14,22,63.6,8,9,3,6,27,53,45,1,Matches,Rennes,Ligue-1
2254,Alidu Seidu,gh GHA,DF,24.0,8.9,22,18,14,6,2,12,15,80.0,3,13,6,7,14,36,17,0,Matches,Rennes,Ligue-1
2255,Seko Fofana,ci CIV,MF,29.0,9.4,11,7,4,6,1,2,7,28.6,5,7,1,6,7,18,7,0,Matches,Rennes,Ligue-1
2256,Albert Grønbaek,dk DEN,"MF,FW",23.0,9.0,21,11,10,7,4,10,28,35.7,18,9,1,8,4,25,6,0,Matches,Rennes,Ligue-1
2257,Glen Kamara,fi FIN,MF,28.0,7.4,23,11,10,11,2,11,17,64.7,6,7,0,7,7,30,7,0,Matches,Rennes,Ligue-1
2258,Mikayil Ngor Faye,sn SEN,DF,20.0,7.6,15,12,10,3,2,7,9,77.8,2,9,4,5,12,27,30,0,Matches,Rennes,Ligue-1
2259,Musa Al-Taamari,jo JOR,"FW,MF",27.0,6.3,4,1,1,1,2,0,4,0.0,4,5,0,5,2,6,2,0,Matches,Rennes,Ligue-1
2260,Mohamed Meité,fr FRA,FW,16.0,6.0,2,0,0,2,0,1,1,100.0,0,1,0,1,0,2,5,0,Matches,Rennes,Ligue-1
2261,Baptiste Santamaria,fr FRA,MF,29.0,5.4,11,4,7,3,1,6,11,54.5,5,10,4,6,12,23,7,0,Matches,Rennes,Ligue-1
2262,Ismaël Koné,ca CAN,MF,22.0,5.2,9,6,4,4,1,5,7,71.4,2,9,2,7,4,13,5,0,Matches,Rennes,Ligue-1
2263,Mahamadou Nagida,cm CMR,DF,19.0,4.8,8,6,4,3,1,4,5,80.0,1,3,0,3,9,17,6,0,Matches,Rennes,Ligue-1
2264,Jota,pt POR,"FW,MF",25.0,3.7,5,2,2,3,0,4,7,57.1,3,1,0,1,3,8,2,0,Matches,Rennes,Ligue-1
2265,Kazeem Olaigbe,be BEL,"MF,FW",21.0,3.3,6,4,3,3,0,3,6,50.0,3,3,1,2,0,6,0,0,Matches,Rennes,Ligue-1
2266,Carlos Gómez,co COL,"MF,DF",21.0,4.2,8,6,3,4,1,3,9,33.3,6,6,0,6,2,10,2,0,Matches,Rennes,Ligue-1
2267,Kyogo Furuhashi,jp JPN,FW,29.0,1.4,2,2,1,1,0,1,1,100.0,0,0,0,0,0,2,0,0,Matches,Rennes,Ligue-1
2268,Benjamin Bourigeaud,fr FRA,MF,30.0,0.9,1,0,0,1,0,0,2,0.0,2,2,1,1,2,3,1,0,Matches,Rennes,Ligue-1
2269,Henrik Meister,dk DEN,FW,20.0,0.7,2,0,0,2,0,0,0,,0,4,0,4,1,3,0,0,Matches,Rennes,Ligue-1
2270,Naouirou Ahamada,fr FRA,"MF,FW",22.0,0.6,0,0,0,0,0,0,0,,0,0,0,0,2,2,2,0,Matches,Rennes,Ligue-1
2271,Gauthier Gallon,fr FRA,GK,31.0,0.5,0,0,0,0,0,0,0,,0,0,0,0,0,0,0,0,Matches,Rennes,Ligue-1
2272,Ayanda Sishuba,be BEL,FW,19.0,0.0,1,0,1,0,0,1,1,100.0,0,0,0,0,0,1,0,0,Matches,Rennes,Ligue-1
2273,Gautier Larsonneur,fr FRA,GK,27.0,34.0,1,0,1,0,0,0,2,0.0,2,1,0,1,0,1,25,1,Matches,Saint-Etienne,Ligue-1
2274,Zuriko Davitashvili,ge GEO,"FW,MF",23.0,30.9,22,14,9,7,6,15,49,30.6,34,20,0,20,14,36,14,0,Matches,Saint-Etienne,Ligue-1
2275,Léo Pétrot,fr FRA,DF,27.0,29.3,62,39,38,19,5,34,51,66.7,17,50,27,23,42,104,103,1,Matches,Saint-Etienne,Ligue-1
2276,Pierre Ekwah Elimby,fr FRA,MF,22.0,28.6,54,33,18,30,6,34,56,60.7,22,26,12,14,47,101,72,1,Matches,Saint-Etienne,Ligue-1
2277,Mickael Nade,fr FRA,DF,25.0,25.6,59,43,40,19,0,28,36,77.8,8,37,19,18,33,92,132,8,Matches,Saint-Etienne,Ligue-1
2278,Lucas Stassin,be BEL,FW,19.0,21.0,16,11,3,5,8,6,20,30.0,14,10,0,10,3,19,8,0,Matches,Saint-Etienne,Ligue-1
2279,Dennis Appiah,fr FRA,DF,32.0,23.6,71,43,42,22,7,41,71,57.7,30,36,8,28,29,100,89,2,Matches,Saint-Etienne,Ligue-1
2280,Dylan Batubinsika,cd COD,DF,28.0,22.4,26,13,19,6,1,13,22,59.1,9,23,14,9,39,65,140,3,Matches,Saint-Etienne,Ligue-1
2281,Benjamin Bouchouari,ma MAR,MF,22.0,19.7,33,27,15,13,5,16,46,34.8,30,21,1,20,17,50,15,2,Matches,Saint-Etienne,Ligue-1
2282,Florian Tardieu,fr FRA,MF,32.0,13.9,18,14,6,9,3,6,17,35.3,11,18,5,13,15,33,21,0,Matches,Saint-Etienne,Ligue-1
2283,Irvin Cardona,fr FRA,FW,26.0,11.8,6,5,3,3,0,2,14,14.3,12,16,3,13,4,10,6,2,Matches,Saint-Etienne,Ligue-1
2284,Aimen Moueffek,fr FRA,MF,23.0,11.5,20,12,3,11,6,10,23,43.5,13,20,7,13,5,25,26,1,Matches,Saint-Etienne,Ligue-1
2285,Louis Mouton,fr FRA,MF,22.0,11.6,49,25,14,25,10,22,37,59.5,15,17,3,14,10,59,19,0,Matches,Saint-Etienne,Ligue-1
2286,Yunis Abdelhamid,ma MAR,DF,36.0,11.5,17,11,15,2,0,10,16,62.5,6,26,18,8,14,31,57,1,Matches,Saint-Etienne,Ligue-1
2287,Yvann Macon,fr FRA,DF,25.0,8.8,19,11,9,7,3,10,21,47.6,11,14,4,10,2,21,10,1,Matches,Saint-Etienne,Ligue-1
2288,Mathis Amougou,fr FRA,MF,18.0,9.5,21,15,15,5,1,10,19,52.6,9,10,0,10,12,33,4,0,Matches,Saint-Etienne,Ligue-1
2289,Maxime Bernauer,fr FRA,DF,26.0,8.5,9,9,5,2,2,5,8,62.5,3,7,3,4,5,14,44,1,Matches,Saint-Etienne,Ligue-1
2290,Mathieu Cafaro,fr FRA,"MF,FW",27.0,8.1,10,7,4,4,2,4,15,26.7,11,7,1,6,7,17,3,0,Matches,Saint-Etienne,Ligue-1
2291,Ibrahim Sissoko,ml MLI,FW,28.0,9.1,11,9,5,3,3,2,5,40.0,3,10,2,8,2,13,13,0,Matches,Saint-Etienne,Ligue-1
2292,Augustine Boakye,gh GHA,"FW,MF",23.0,8.1,7,3,3,4,0,3,11,27.3,8,5,0,5,6,13,4,0,Matches,Saint-Etienne,Ligue-1
2293,Pierre Cornud,fr FRA,DF,27.0,6.4,12,10,6,4,2,8,17,47.1,9,9,4,5,9,21,28,1,Matches,Saint-Etienne,Ligue-1
2294,Ben Old,nz NZL,"FW,MF",21.0,5.9,7,5,3,3,1,3,11,27.3,8,8,1,7,2,9,2,0,Matches,Saint-Etienne,Ligue-1
2295,Lamine Fomba,fr FRA,MF,26.0,2.4,8,6,2,5,1,2,7,28.6,5,7,1,6,4,12,5,1,Matches,Saint-Etienne,Ligue-1
2296,Djylian N'Guessan,fr FRA,FW,15.0,2.0,6,4,5,1,0,2,5,40.0,3,1,0,1,0,6,1,0,Matches,Saint-Etienne,Ligue-1
2297,Ibrahima Wadji,sn SEN,"FW,MF",29.0,3.9,7,6,3,3,1,3,7,42.9,4,1,0,1,1,8,0,0,Matches,Saint-Etienne,Ligue-1
2298,Marwann Nzuzi,fr FRA,DF,20.0,1.4,2,2,1,0,1,1,2,50.0,1,0,0,0,2,4,6,0,Matches,Saint-Etienne,Ligue-1
2299,Ayman Aiki,fr FRA,"FW,MF",19.0,1.4,3,3,1,2,0,1,1,100.0,0,1,0,1,1,4,0,0,Matches,Saint-Etienne,Ligue-1
2300,Beres Owusu,fr FRA,DF,20.0,1.0,2,2,1,1,0,2,2,100.0,0,2,2,0,0,2,5,0,Matches,Saint-Etienne,Ligue-1
2301,Igor Miladinović,rs SRB,"FW,MF",21.0,0.3,0,0,0,0,0,0,0,,0,0,0,0,1,1,1,0,Matches,Saint-Etienne,Ligue-1
2302,Kévin Pedro,fr FRA,DF,18.0,0.1,3,0,2,1,0,3,3,100.0,0,1,0,1,2,5,1,0,Matches,Saint-Etienne,Ligue-1
2303,Jibril Othman,tn TUN,FW,20.0,0.1,0,0,0,0,0,0,0,,0,0,0,0,0,0,0,0,Matches,Saint-Etienne,Ligue-1
2304,Anthony Briançon,fr FRA,DF,29.0,0.0,0,0,0,0,0,0,0,,0,0,0,0,0,0,0,0,Matches,Saint-Etienne,Ligue-1
2305,Andrey Santos,br BRA,MF,20.0,31.7,110,74,47,51,12,51,87,58.6,36,46,14,32,32,142,67,1,Matches,Strasbourg,Ligue-1
2306,Đorđe Petrović,rs SRB,GK,24.0,31.0,1,1,1,0,0,0,0,,0,0,0,0,0,1,24,1,Matches,Strasbourg,Ligue-1
2307,Ismaël Doukouré,fr FRA,"DF,MF",21.0,29.3,40,22,19,18,3,17,25,68.0,8,31,14,17,25,65,102,3,Matches,Strasbourg,Ligue-1
2308,Guela Doué,ci CIV,DF,21.0,30.2,65,45,40,15,10,37,54,68.5,17,38,6,32,34,99,154,1,Matches,Strasbourg,Ligue-1
2309,Diego Moreira,pt POR,"DF,MF",19.0,28.5,44,28,17,19,8,24,50,48.0,26,23,4,19,35,79,65,0,Matches,Strasbourg,Ligue-1
2310,Dilane Bakwa,fr FRA,"MF,DF",21.0,27.7,26,14,11,8,7,12,24,50.0,12,21,1,20,15,41,27,0,Matches,Strasbourg,Ligue-1
2311,Mamadou Sarr,fr FRA,DF,18.0,26.3,37,21,24,11,2,16,24,66.7,8,26,20,6,25,62,117,3,Matches,Strasbourg,Ligue-1
2312,Habib Diarra,sn SEN,"MF,FW",20.0,26.1,22,13,6,13,3,8,20,40.0,12,22,6,16,13,35,46,3,Matches,Strasbourg,Ligue-1
2313,Emanuel Emegha,nl NED,FW,21.0,25.5,6,6,1,2,3,2,6,33.3,4,18,5,13,1,7,30,0,Matches,Strasbourg,Ligue-1
2314,Sebastian Nanasi,se SWE,"MF,FW",22.0,23.4,20,13,6,12,2,8,22,36.4,14,24,3,21,7,27,18,0,Matches,Strasbourg,Ligue-1
2315,Félix Lemaréchal,fr FRA,"MF,FW",20.0,19.8,35,24,13,17,5,14,29,48.3,15,35,4,31,14,49,19,0,Matches,Strasbourg,Ligue-1
2316,Valentín Barco,ar ARG,"MF,DF",20.0,12.9,36,22,24,10,2,22,30,73.3,8,8,3,5,13,49,28,1,Matches,Strasbourg,Ligue-1
2317,Saidou Sow,gn GUI,DF,22.0,11.3,9,5,6,3,0,6,12,50.0,6,15,9,6,15,24,37,2,Matches,Strasbourg,Ligue-1
2318,Abakar Sylla,ci CIV,DF,21.0,10.6,27,15,14,11,2,15,17,88.2,2,18,10,8,11,38,63,0,Matches,Strasbourg,Ligue-1
2319,Sekou Mara,fr FRA,"FW,MF",22.0,8.5,9,6,0,5,4,3,9,33.3,6,11,0,11,3,12,3,0,Matches,Strasbourg,Ligue-1
2320,Andrew Omobamidele,ie IRL,DF,22.0,6.0,7,4,4,3,0,2,5,40.0,3,12,8,4,8,15,41,0,Matches,Strasbourg,Ligue-1
2321,Guimissongui Ouattara,fr FRA,"DF,FW",18.0,5.2,6,4,3,1,2,3,5,60.0,2,10,0,10,9,15,12,2,Matches,Strasbourg,Ligue-1
2322,Samuel Amo-Ameyaw,eng ENG,"DF,MF",18.0,3.6,5,3,3,2,0,2,9,22.2,7,3,0,3,3,8,2,0,Matches,Strasbourg,Ligue-1
2323,Karl-Johan Johnsson,se SWE,GK,34.0,3.0,0,0,0,0,0,0,1,0.0,1,0,0,0,0,0,3,0,Matches,Strasbourg,Ligue-1
2324,Caleb Wiley,us USA,"DF,MF",19.0,3.0,1,0,0,1,0,0,1,0.0,1,3,1,2,4,5,5,0,Matches,Strasbourg,Ligue-1
2325,Junior Mwanga,fr FRA,MF,21.0,3.3,17,9,9,7,1,5,9,55.6,4,2,0,2,2,19,2,0,Matches,Strasbourg,Ligue-1
2326,Marvin Senaya,tg TOG,DF,23.0,2.5,8,3,5,2,1,6,12,50.0,6,6,2,4,7,15,12,0,Matches,Strasbourg,Ligue-1
2327,Jérémy Sebas,mq MTQ,"FW,MF",21.0,2.1,3,2,1,1,1,2,3,66.7,1,2,0,2,0,3,4,0,Matches,Strasbourg,Ligue-1
2328,Pape Daouda Diongue,sn SEN,"MF,FW",,0.9,2,0,1,1,0,1,2,50.0,1,0,0,0,3,5,2,0,Matches,Strasbourg,Ligue-1
2329,Eduard Sobol,ua UKR,DF,29.0,1.1,0,0,0,0,0,0,2,0.0,2,2,1,1,2,2,14,0,Matches,Strasbourg,Ligue-1
2330,Óscar Perea,co COL,"MF,DF",18.0,0.2,0,0,0,0,0,0,0,,0,0,0,0,0,0,0,0,Matches,Strasbourg,Ligue-1
2331,Milos Lukovic,rs SRB,"FW,MF",18.0,0.1,0,0,0,0,0,0,0,,0,0,0,0,0,0,0,0,Matches,Strasbourg,Ligue-1
2332,Nordine Kandil,fr FRA,MF,22.0,0.1,0,0,0,0,0,0,0,,0,0,0,0,0,0,1,0,Matches,Strasbourg,Ligue-1
2333,Thomas Delaine,fr FRA,DF,32.0,0.1,1,1,1,0,0,1,1,100.0,0,0,0,0,1,2,1,0,Matches,Strasbourg,Ligue-1
2334,Karol Fila,pl POL,MF,26.0,0.1,0,0,0,0,0,0,0,,0,0,0,0,0,0,0,0,Matches,Strasbourg,Ligue-1
2335,Cristian Cásseres Jr.,ve VEN,MF,24.0,30.0,96,61,41,43,12,46,88,52.3,42,35,9,26,42,138,36,1,Matches,Toulouse,Ligue-1
2336,Aron Dønnum,no NOR,"DF,MF",26.0,29.9,56,35,25,24,7,31,55,56.4,24,29,4,25,28,84,37,1,Matches,Toulouse,Ligue-1
2337,Charlie Cresswell,eng ENG,DF,21.0,28.8,35,23,19,15,1,28,46,60.9,18,44,28,16,28,63,191,3,Matches,Toulouse,Ligue-1
2338,Guillaume Restes,fr FRA,GK,19.0,28.3,2,1,2,0,0,2,3,66.7,1,0,0,0,1,3,16,1,Matches,Toulouse,Ligue-1
2339,Mark McKenzie,us USA,DF,25.0,27.7,52,31,31,20,1,33,45,73.3,12,31,18,13,22,74,141,1,Matches,Toulouse,Ligue-1
2340,Vincent Sierro,ch SUI,MF,28.0,26.7,44,27,15,23,6,27,56,48.2,29,34,9,25,16,60,44,1,Matches,Toulouse,Ligue-1
2341,Yann Gboho,fr FRA,"MF,FW",23.0,25.9,31,18,7,15,9,14,35,40.0,21,20,0,20,6,37,4,1,Matches,Toulouse,Ligue-1
2342,Djibril Sidibé,fr FRA,DF,32.0,23.3,65,36,34,22,9,31,50,62.0,19,11,3,8,20,85,64,1,Matches,Toulouse,Ligue-1
2343,Gabriel Suazo,cl CHI,DF,26.0,24.0,59,39,25,22,12,30,72,41.7,42,27,3,24,36,95,40,1,Matches,Toulouse,Ligue-1
2344,Zakaria Aboukhlal,ma MAR,"MF,FW",24.0,21.1,22,13,7,8,7,4,23,17.4,19,16,1,15,6,28,9,0,Matches,Toulouse,Ligue-1
2345,Joshua King,no NOR,"FW,MF",32.0,18.6,11,11,4,4,3,5,12,41.7,7,10,3,7,6,17,19,0,Matches,Toulouse,Ligue-1
2346,Frank Magri,cm CMR,"FW,MF",24.0,16.8,8,2,1,6,1,3,8,37.5,5,16,2,14,4,12,11,0,Matches,Toulouse,Ligue-1
2347,Jaydee Canvot,fr FRA,"DF,MF",18.0,12.3,23,11,16,5,2,12,18,66.7,6,10,2,8,11,34,54,1,Matches,Toulouse,Ligue-1
2348,Shavy Babicka,ga GAB,"MF,FW",24.0,13.2,21,12,6,11,4,10,21,47.6,11,14,0,14,3,24,4,3,Matches,Toulouse,Ligue-1
2349,Warren Kamanzi,no NOR,"DF,MF",23.0,11.4,29,13,12,12,5,14,28,50.0,14,7,3,4,9,38,25,0,Matches,Toulouse,Ligue-1
2350,Rasmus Nicolaisen,dk DEN,DF,27.0,6.9,6,3,4,2,0,3,5,60.0,2,10,5,5,10,16,25,0,Matches,Toulouse,Ligue-1
2351,Ümit Akdag,ro ROU,DF,20.0,5.6,8,4,3,4,1,5,12,41.7,7,10,8,2,11,19,19,0,Matches,Toulouse,Ligue-1
2352,Kjetil Haug,no NOR,GK,26.0,5.5,0,0,0,0,0,0,0,,0,0,0,0,0,0,3,0,Matches,Toulouse,Ligue-1
2353,Rafik Messali,fr FRA,DF,21.0,5.1,15,8,6,6,3,7,8,87.5,1,9,1,8,10,25,12,0,Matches,Toulouse,Ligue-1
2354,Denis Genreau,au AUS,MF,25.0,2.5,7,5,4,1,2,4,8,50.0,4,3,0,3,3,10,4,0,Matches,Toulouse,Ligue-1
2355,Niklas Schmidt,de GER,MF,26.0,2.3,6,4,1,5,0,4,7,57.1,3,0,0,0,1,7,4,0,Matches,Toulouse,Ligue-1
2356,Miha Zajc,si SVN,MF,30.0,2.9,4,4,1,2,1,3,5,60.0,2,2,1,1,3,7,7,0,Matches,Toulouse,Ligue-1
2357,Noah Edjouma,fr FRA,"MF,FW",18.0,1.9,2,2,0,1,1,1,2,50.0,1,1,1,0,2,4,2,0,Matches,Toulouse,Ligue-1
2358,Logan Costa,cv CPV,DF,23.0,1.0,2,1,0,2,0,1,1,100.0,0,2,2,0,2,4,4,0,Matches,Toulouse,Ligue-1
2359,Álex Domínguez,es ESP,GK,26.0,0.2,0,0,0,0,0,0,0,,0,0,0,0,0,0,0,0,Matches,Toulouse,Ligue-1
2360,Edhy Zuliani,fr FRA,DF,19.0,0.1,0,0,0,0,0,0,0,,0,0,0,0,1,1,0,0,Matches,Toulouse,Ligue-1
2361,Naatan Skyttä,fi FIN,FW,22.0,0.1,1,0,0,0,1,0,0,,0,0,0,0,0,1,0,0,Matches,Toulouse,Ligue-1
2362,Jeffrey Gouweleeuw,nl NED,DF,33.0,32.7,50,28,25,21,4,27,40,67.5,13,34,15,19,35,85,183,0,Matches,Augsburg,Bundesliga
2363,Dimitris Giannoulis,gr GRE,DF,28.0,29.4,47,32,27,16,4,26,44,59.1,18,49,11,38,47,94,75,0,Matches,Augsburg,Bundesliga
2364,Frank Onyeka,ng NGA,MF,26.0,28.7,58,45,22,28,8,22,40,55.0,18,36,9,27,36,94,36,2,Matches,Augsburg,Bundesliga
2365,Chrislain Matsima,fr FRA,DF,22.0,28.3,31,20,19,11,1,17,26,65.4,9,48,29,19,52,83,163,0,Matches,Augsburg,Bundesliga
2366,Marius Wolf,de GER,DF,29.0,23.8,27,16,13,11,3,16,43,37.2,27,29,5,24,24,51,51,1,Matches,Augsburg,Bundesliga
2367,Kristijan Jakić,hr CRO,MF,27.0,25.6,46,23,20,19,7,22,43,51.2,21,42,9,33,28,74,50,1,Matches,Augsburg,Bundesliga
2368,Alexis Claude-Maurice,fr FRA,"MF,FW",26.0,23.4,41,26,12,15,14,17,34,50.0,17,16,0,16,15,56,8,1,Matches,Augsburg,Bundesliga
2369,Elvis Rexhbeçaj,xk KVX,MF,26.0,19.8,27,19,9,14,4,15,35,42.9,20,40,9,31,16,43,22,1,Matches,Augsburg,Bundesliga
2370,Samuel Essende,cd COD,FW,26.0,18.2,7,6,1,3,3,3,4,75.0,1,13,2,11,0,7,11,1,Matches,Augsburg,Bundesliga
2371,Finn Dahmen,de GER,GK,26.0,19.0,1,0,1,0,0,1,2,50.0,1,0,0,0,0,1,9,0,Matches,Augsburg,Bundesliga
2372,Phillip Tietz,de GER,FW,27.0,18.7,11,6,2,7,2,5,8,62.5,3,10,1,9,5,16,26,1,Matches,Augsburg,Bundesliga
2373,Nediljko Labrović,hr CRO,GK,24.0,15.0,0,0,0,0,0,0,0,,0,0,0,0,0,0,12,1,Matches,Augsburg,Bundesliga
2374,Keven Schlotterbeck,de GER,DF,27.0,14.4,19,17,9,9,1,12,16,75.0,4,13,6,7,15,34,73,1,Matches,Augsburg,Bundesliga
2375,Cedric Zesiger,ch SUI,DF,26.0,13.6,13,7,7,6,0,8,13,61.5,5,17,10,7,21,34,96,1,Matches,Augsburg,Bundesliga
2376,Fredrik Jensen,fi FIN,MF,26.0,8.5,7,7,1,3,3,4,5,80.0,1,10,1,9,4,11,17,0,Matches,Augsburg,Bundesliga
2377,Maximilian Bauer,de GER,DF,24.0,7.3,14,8,5,7,2,9,14,64.3,5,10,4,6,6,20,35,1,Matches,Augsburg,Bundesliga
2378,Arne Maier,de GER,MF,25.0,10.4,13,7,4,8,1,7,13,53.8,6,15,1,14,6,19,14,1,Matches,Augsburg,Bundesliga
2379,Mert Kömür,de GER,MF,19.0,7.3,3,2,2,0,1,0,3,0.0,3,9,3,6,3,6,7,1,Matches,Augsburg,Bundesliga
2380,Henri Koudossou,de GER,DF,24.0,8.3,18,10,6,11,1,11,19,57.9,8,8,2,6,15,33,37,0,Matches,Augsburg,Bundesliga
2381,Ruben Vargas,ch SUI,"MF,FW",25.0,3.4,2,1,1,1,0,1,4,25.0,3,1,0,1,2,4,1,1,Matches,Augsburg,Bundesliga
2382,Noahkai Banks,us USA,DF,17.0,3.1,11,5,6,4,1,3,7,42.9,4,4,1,3,5,16,28,0,Matches,Augsburg,Bundesliga
2383,Robert Gumny,pl POL,DF,26.0,3.0,3,3,1,2,0,2,6,33.3,4,2,0,2,1,4,6,0,Matches,Augsburg,Bundesliga
2384,Mads Pedersen,dk DEN,DF,27.0,2.6,8,7,5,2,1,4,5,80.0,1,4,0,4,2,10,6,0,Matches,Augsburg,Bundesliga
2385,Tim Breithaupt,de GER,MF,22.0,1.3,1,1,0,1,0,0,4,0.0,4,1,0,1,2,3,0,0,Matches,Augsburg,Bundesliga
2386,Steve Mounié,bj BEN,"FW,MF",29.0,3.9,4,4,0,1,3,0,1,0.0,1,1,1,0,1,5,5,1,Matches,Augsburg,Bundesliga
2387,Arne Engels,be BEL,"MF,FW",20.0,0.9,0,0,0,0,0,0,0,,0,1,1,0,0,0,0,0,Matches,Augsburg,Bundesliga
2388,Yusuf Kabadayı,de GER,"FW,MF",20.0,0.8,1,0,0,1,0,0,0,,0,1,0,1,0,1,0,0,Matches,Augsburg,Bundesliga
2389,Mergim Berisha,de GER,FW,26.0,0.4,1,0,0,1,0,1,1,100.0,0,2,1,1,0,1,0,0,Matches,Augsburg,Bundesliga
2390,Niklas Dorsch,de GER,MF,26.0,0.4,0,0,0,0,0,0,0,,0,1,0,1,0,0,0,0,Matches,Augsburg,Bundesliga
2391,Joshua Kimmich,de GER,MF,29.0,31.6,47,29,11,29,7,30,50,60.0,20,23,3,20,25,72,34,3,Matches,Bayern-Munich,Bundesliga
2392,Harry Kane,eng ENG,FW,31.0,26.5,13,11,3,8,2,2,6,33.3,4,16,2,14,2,15,16,0,Matches,Bayern-Munich,Bundesliga
2393,Michael Olise,fr FRA,"FW,MF",22.0,25.9,36,23,10,21,5,17,38,44.7,21,23,1,22,8,44,16,2,Matches,Bayern-Munich,Bundesliga
2394,Kim Min-jae,kr KOR,DF,27.0,25.4,35,20,18,13,4,11,21,52.4,10,23,10,13,37,72,91,4,Matches,Bayern-Munich,Bundesliga
2395,Manuel Neuer,de GER,GK,38.0,22.0,1,0,1,0,0,1,1,100.0,0,0,0,0,0,1,9,1,Matches,Bayern-Munich,Bundesliga
2396,Jamal Musiala,de GER,MF,21.0,20.0,36,21,7,16,13,12,29,41.4,17,30,0,30,8,44,5,1,Matches,Bayern-Munich,Bundesliga
2397,Dayot Upamecano,fr FRA,DF,25.0,19.5,36,22,18,16,2,16,29,55.2,13,17,7,10,34,70,45,1,Matches,Bayern-Munich,Bundesliga
2398,Konrad Laimer,at AUT,DF,27.0,18.9,49,27,19,22,8,23,48,47.9,25,24,1,23,8,57,24,1,Matches,Bayern-Munich,Bundesliga
2399,Raphaël Guerreiro,pt POR,"DF,MF",30.0,17.5,19,12,9,7,3,12,16,75.0,4,9,0,9,10,29,19,1,Matches,Bayern-Munich,Bundesliga
2400,Aleksandar Pavlovic,de GER,MF,20.0,16.1,38,21,13,15,10,22,32,68.8,10,18,3,15,5,43,14,0,Matches,Bayern-Munich,Bundesliga
2401,Leroy Sané,de GER,FW,28.0,18.2,23,15,4,8,11,12,23,52.2,11,8,0,8,7,30,3,0,Matches,Bayern-Munich,Bundesliga
2402,Alphonso Davies,ca CAN,DF,23.0,17.3,30,17,7,17,6,17,26,65.4,9,14,1,13,13,43,22,2,Matches,Bayern-Munich,Bundesliga
2403,Eric Dier,eng ENG,DF,30.0,16.3,19,11,8,9,2,13,20,65.0,7,19,8,11,20,39,77,1,Matches,Bayern-Munich,Bundesliga
2404,Kingsley Coman,fr FRA,FW,28.0,14.2,17,12,6,6,5,8,12,66.7,4,12,0,12,8,25,15,0,Matches,Bayern-Munich,Bundesliga
2405,Leon Goretzka,de GER,"MF,DF",29.0,14.7,21,11,5,12,4,10,20,50.0,10,27,7,20,20,41,25,1,Matches,Bayern-Munich,Bundesliga
2406,Serge Gnabry,de GER,"FW,MF",29.0,13.8,20,11,6,7,7,8,12,66.7,4,11,0,11,6,26,9,0,Matches,Bayern-Munich,Bundesliga
2407,Thomas Müller,de GER,"MF,FW",34.0,13.6,8,5,2,3,3,4,16,25.0,12,10,0,10,2,10,14,0,Matches,Bayern-Munich,Bundesliga
2408,Josip Stanišić,hr CRO,DF,24.0,9.7,13,11,6,4,3,7,15,46.7,8,10,6,4,6,19,29,1,Matches,Bayern-Munich,Bundesliga
2409,Jonas Urbig,de GER,GK,20.0,8.0,0,0,0,0,0,0,0,,0,0,0,0,0,0,9,2,Matches,Bayern-Munich,Bundesliga
2410,João Palhinha,pt POR,MF,29.0,7.5,20,14,6,11,3,11,16,68.8,5,13,1,12,4,24,9,1,Matches,Bayern-Munich,Bundesliga
2411,Sacha Boey,fr FRA,DF,23.0,6.6,20,5,6,6,8,13,18,72.2,5,6,0,6,2,22,14,0,Matches,Bayern-Munich,Bundesliga
2412,Daniel Peretz,il ISR,GK,24.0,3.0,0,0,0,0,0,0,1,0.0,1,0,0,0,0,0,2,0,Matches,Bayern-Munich,Bundesliga
2413,Hiroki Ito,jp JPN,DF,25.0,2.8,2,0,1,1,0,1,1,100.0,0,3,2,1,6,8,15,1,Matches,Bayern-Munich,Bundesliga
2414,Mathys Tel,fr FRA,"FW,MF",19.0,2.8,2,2,0,2,0,0,0,,0,0,0,0,1,3,1,0,Matches,Bayern-Munich,Bundesliga
2415,Sven Ulreich,de GER,GK,35.0,1.0,0,0,0,0,0,0,0,,0,0,0,0,0,0,0,0,Matches,Bayern-Munich,Bundesliga
2416,Gabriel Vidovic,hr CRO,MF,20.0,0.3,0,0,0,0,0,0,0,,0,2,0,2,0,0,0,0,Matches,Bayern-Munich,Bundesliga
2417,Adam Aznou,ma MAR,DF,18.0,0.2,0,0,0,0,0,0,0,,0,0,0,0,0,0,1,0,Matches,Bayern-Munich,Bundesliga
2418,Jonah Kusi-Asare,se SWE,FW,17.0,0.0,1,0,0,0,1,0,0,,0,0,0,0,0,1,0,0,Matches,Bayern-Munich,Bundesliga
2419,Arijon Ibrahimović,de GER,FW,18.0,0.0,0,0,0,0,0,0,0,,0,0,0,0,0,0,0,0,Matches,Bayern-Munich,Bundesliga
2420,Maximilian Wittek,de GER,DF,28.0,30.1,65,42,40,19,6,38,54,70.4,16,54,8,46,27,92,89,3,Matches,Bochum,Bundesliga
2421,Ibrahima Sissoko,ml MLI,MF,26.0,29.0,66,44,30,31,5,24,45,53.3,21,39,11,28,36,102,61,0,Matches,Bochum,Bundesliga
2422,Felix Passlack,de GER,"DF,MF",26.0,25.9,53,23,32,13,8,30,55,54.5,25,42,11,31,18,71,63,1,Matches,Bochum,Bundesliga
2423,Matúš Bero,sk SVK,MF,28.0,28.5,65,35,33,21,11,29,60,48.3,31,37,9,28,17,82,35,1,Matches,Bochum,Bundesliga
2424,Philipp Hofmann,de GER,FW,31.0,25.3,17,12,4,6,7,8,15,53.3,7,14,1,13,4,21,33,0,Matches,Bochum,Bundesliga
2425,Tim Oermann,de GER,DF,20.0,24.6,50,31,25,21,4,26,43,60.5,17,32,16,16,22,72,64,0,Matches,Bochum,Bundesliga
2426,Patrick Drewes,de GER,GK,31.0,21.0,0,0,0,0,0,0,1,0.0,1,1,0,1,0,0,11,1,Matches,Bochum,Bundesliga
2427,Ivan Ordets,ua UKR,DF,32.0,20.7,18,8,13,5,0,10,13,76.9,3,29,16,13,41,59,139,3,Matches,Bochum,Bundesliga
2428,Bernardo,br BRA,DF,29.0,19.8,46,28,32,13,1,27,37,73.0,10,38,17,21,26,72,103,4,Matches,Bochum,Bundesliga
2429,Jakov Medić,hr CRO,DF,25.0,17.8,13,11,9,3,1,8,18,44.4,10,32,21,11,22,35,111,4,Matches,Bochum,Bundesliga
2430,Moritz Broschinski,de GER,"FW,MF",23.0,15.4,19,14,6,6,7,6,15,40.0,9,18,0,18,1,20,18,0,Matches,Bochum,Bundesliga
2431,Timo Horn,de GER,GK,31.0,13.0,0,0,0,0,0,0,0,,0,0,0,0,0,0,9,2,Matches,Bochum,Bundesliga
2432,Anthony Losilla,fr FRA,MF,38.0,12.6,30,16,15,12,3,17,33,51.5,16,22,7,15,18,48,27,1,Matches,Bochum,Bundesliga
2433,Tom Krauß,de GER,MF,23.0,12.0,35,18,20,13,2,19,38,50.0,19,26,2,24,11,46,19,1,Matches,Bochum,Bundesliga
2434,Gerrit Holtmann,ph PHI,"DF,FW",29.0,12.6,24,19,14,8,2,12,24,50.0,12,18,5,13,16,40,15,0,Matches,Bochum,Bundesliga
2435,Giorgos Masouras,gr GRE,"FW,MF",30.0,11.7,18,10,6,7,5,7,16,43.8,9,9,1,8,4,22,3,1,Matches,Bochum,Bundesliga
2436,Dani de Wit,nl NED,"MF,FW",26.0,12.8,29,17,11,15,3,18,31,58.1,13,17,4,13,12,41,23,1,Matches,Bochum,Bundesliga
2437,Myron Boadu,nl NED,FW,23.0,11.6,2,1,0,0,2,1,5,20.0,4,3,0,3,1,3,4,0,Matches,Bochum,Bundesliga
2438,Erhan Mašović,rs SRB,DF,25.0,10.1,14,10,10,4,0,13,28,46.4,15,17,11,6,12,26,55,0,Matches,Bochum,Bundesliga
2439,Koji Miyoshi,jp JPN,"FW,MF",27.0,5.2,8,5,2,1,5,4,9,44.4,5,10,1,9,2,10,2,0,Matches,Bochum,Bundesliga
2440,Lukas Daschner,de GER,"MF,FW",25.0,4.6,4,2,1,2,1,2,9,22.2,7,5,0,5,0,4,5,0,Matches,Bochum,Bundesliga
2441,Mats Pannewig,de GER,MF,19.0,3.0,10,6,7,3,0,3,12,25.0,9,8,1,7,2,12,8,0,Matches,Bochum,Bundesliga
2442,Cristian Gamboa,cr CRC,DF,34.0,2.5,8,3,5,3,0,3,9,33.3,6,2,0,2,2,10,8,0,Matches,Bochum,Bundesliga
2443,Moritz-Broni Kwarteng,gh GHA,"MF,FW",26.0,1.9,4,3,1,1,2,1,2,50.0,1,0,0,0,0,4,1,0,Matches,Bochum,Bundesliga
2444,Aliou Badara Baldé,gn GUI,"MF,FW",21.0,1.0,1,1,1,0,0,0,0,,0,2,0,2,0,1,0,0,Matches,Bochum,Bundesliga
2445,Samuel Bamba,de GER,"FW,MF",20.0,0.3,1,1,1,0,0,0,0,,0,0,0,0,0,1,0,0,Matches,Bochum,Bundesliga
2446,Kacper Koscierski,de GER,DF,17.0,0.1,0,0,0,0,0,0,0,,0,0,0,0,0,0,0,0,Matches,Bochum,Bundesliga
2447,Gregor Kobel,ch SUI,GK,26.0,32.0,0,0,0,0,0,0,0,,0,0,0,0,1,1,23,3,Matches,Dortmund,Bundesliga
2448,Serhou Guirassy,gn GUI,FW,28.0,28.9,7,6,2,2,3,2,5,40.0,3,10,3,7,4,11,38,0,Matches,Dortmund,Bundesliga
2449,Pascal Groß,de GER,"MF,DF",33.0,25.9,44,28,11,26,7,15,51,29.4,36,46,13,33,9,53,30,1,Matches,Dortmund,Bundesliga
2450,Julian Brandt,de GER,MF,28.0,25.6,26,11,13,8,5,15,43,34.9,28,17,0,17,14,40,13,1,Matches,Dortmund,Bundesliga
2451,Julian Ryerson,no NOR,DF,26.0,25.1,46,30,26,13,7,25,44,56.8,19,29,2,27,22,68,26,1,Matches,Dortmund,Bundesliga
2452,Emre Can,de GER,"DF,MF",30.0,23.4,50,28,30,16,4,18,36,50.0,18,31,17,14,20,70,89,3,Matches,Dortmund,Bundesliga
2453,Ramy Bensebaini,dz ALG,DF,29.0,22.5,51,25,25,18,8,33,51,64.7,18,42,9,33,33,84,86,1,Matches,Dortmund,Bundesliga
2454,Nico Schlotterbeck,de GER,DF,24.0,22.0,38,24,21,16,1,27,45,60.0,18,31,15,16,22,60,79,1,Matches,Dortmund,Bundesliga
2455,Waldemar Anton,de GER,DF,28.0,21.7,34,21,18,10,6,17,23,73.9,6,33,16,17,30,64,112,1,Matches,Dortmund,Bundesliga
2456,Jamie Gittens,eng ENG,"FW,MF",19.0,19.7,31,19,12,12,7,14,18,77.8,4,16,0,16,10,41,4,0,Matches,Dortmund,Bundesliga
2457,Felix Nmecha,de GER,MF,23.0,16.8,34,22,6,19,9,12,22,54.5,10,20,5,15,23,57,30,1,Matches,Dortmund,Bundesliga
2458,Marcel Sabitzer,at AUT,MF,30.0,18.0,29,19,7,15,7,16,27,59.3,11,19,6,13,10,39,29,1,Matches,Dortmund,Bundesliga
2459,Maximilian Beier,de GER,"FW,MF",21.0,17.7,25,16,8,11,6,12,31,38.7,19,15,1,14,7,32,14,1,Matches,Dortmund,Bundesliga
2460,Karim Adeyemi,de GER,"FW,MF",22.0,15.9,20,14,6,6,8,8,20,40.0,12,14,1,13,7,27,5,0,Matches,Dortmund,Bundesliga
2461,Niklas Süle,de GER,DF,28.0,11.7,14,12,9,5,0,10,14,71.4,4,11,6,5,4,18,46,1,Matches,Dortmund,Bundesliga
2462,Yan Couto,br BRA,"DF,FW",22.0,9.9,24,16,17,2,5,14,25,56.0,11,12,1,11,10,34,32,2,Matches,Dortmund,Bundesliga
2463,Daniel Svensson,se SWE,"DF,FW",22.0,8.7,15,11,5,6,4,7,11,63.6,4,10,4,6,5,20,30,0,Matches,Dortmund,Bundesliga
2464,Donyell Malen,nl NED,"FW,MF",25.0,6.8,0,0,0,0,0,0,2,0.0,2,2,0,2,3,3,6,0,Matches,Dortmund,Bundesliga
2465,Salih Özcan,tr TUR,MF,26.0,4.3,11,7,6,4,1,7,13,53.8,6,7,0,7,11,22,10,0,Matches,Dortmund,Bundesliga
2466,Gio Reyna,us USA,MF,21.0,3.9,7,0,3,0,4,4,5,80.0,1,3,1,2,0,7,9,0,Matches,Dortmund,Bundesliga
2467,Julien Duranville,be BEL,"FW,MF",18.0,3.1,3,0,0,3,0,1,2,50.0,1,1,0,1,0,3,3,0,Matches,Dortmund,Bundesliga
2468,Alexander Meyer,de GER,GK,33.0,2.0,0,0,0,0,0,0,0,,0,0,0,0,0,0,0,0,Matches,Dortmund,Bundesliga
2469,Carney Chukwuemeka,eng ENG,MF,20.0,2.8,7,5,3,2,2,1,1,100.0,0,5,0,5,1,8,1,0,Matches,Dortmund,Bundesliga
2470,Almugera Kabar,de GER,DF,18.0,1.5,5,3,2,2,1,3,3,100.0,0,1,0,1,1,6,4,0,Matches,Dortmund,Bundesliga
2471,Yannik Lührs,de GER,DF,20.0,1.4,1,1,1,0,0,0,0,,0,0,0,0,2,3,4,0,Matches,Dortmund,Bundesliga
2472,Ayman Azhil,ma MAR,MF,23.0,0.3,1,1,1,0,0,0,0,,0,0,0,0,0,1,0,0,Matches,Dortmund,Bundesliga
2473,Cole Campbell,us USA,"MF,FW",18.0,0.2,0,0,0,0,0,0,0,,0,0,0,0,0,0,1,0,Matches,Dortmund,Bundesliga
2474,Kjell-Arik Wätjen,de GER,MF,18.0,0.2,0,0,0,0,0,0,0,,0,0,0,0,0,0,2,0,Matches,Dortmund,Bundesliga
2475,Arthur Theate,be BEL,DF,24.0,30.0,36,25,19,16,1,22,44,50.0,22,42,19,23,39,75,170,3,Matches,Eintracht-Frankfurt,Bundesliga
2476,Hugo Ekitike,fr FRA,FW,22.0,28.5,16,12,3,8,5,4,12,33.3,8,13,1,12,7,23,24,0,Matches,Eintracht-Frankfurt,Bundesliga
2477,Robin Koch,de GER,DF,28.0,28.7,24,11,14,8,2,10,22,45.5,12,39,25,14,25,49,197,4,Matches,Eintracht-Frankfurt,Bundesliga
2478,Rasmus Kristensen,dk DEN,DF,27.0,27.9,59,33,37,17,5,40,67,59.7,27,50,13,37,20,79,97,1,Matches,Eintracht-Frankfurt,Bundesliga
2479,Hugo Larsson,se SWE,MF,20.0,26.6,47,27,17,25,5,21,42,50.0,21,42,11,31,30,77,35,1,Matches,Eintracht-Frankfurt,Bundesliga
2480,Kevin Trapp,de GER,GK,34.0,25.5,0,0,0,0,0,0,0,,0,0,0,0,0,0,13,3,Matches,Eintracht-Frankfurt,Bundesliga
2481,Tuta,br BRA,"DF,MF",25.0,25.3,44,27,25,17,2,28,40,70.0,12,42,21,21,40,84,135,1,Matches,Eintracht-Frankfurt,Bundesliga
2482,Ellyes Skhiri,tn TUN,MF,29.0,24.8,40,22,15,21,4,18,44,40.9,26,30,7,23,31,71,45,4,Matches,Eintracht-Frankfurt,Bundesliga
2483,Nathaniel Brown,de GER,"DF,MF",21.0,21.6,71,42,39,18,14,44,55,80.0,11,30,0,30,15,86,55,1,Matches,Eintracht-Frankfurt,Bundesliga
2484,Ansgar Knauff,de GER,"MF,DF",22.0,17.7,41,22,18,16,7,12,26,46.2,14,23,4,19,12,53,24,0,Matches,Eintracht-Frankfurt,Bundesliga
2485,Mario Götze,de GER,"MF,FW",32.0,17.1,41,28,18,20,3,15,36,41.7,21,15,1,14,7,48,8,0,Matches,Eintracht-Frankfurt,Bundesliga
2486,Omar Marmoush,eg EGY,FW,25.0,16.1,12,8,0,3,9,3,7,42.9,4,7,1,6,2,14,2,0,Matches,Eintracht-Frankfurt,Bundesliga
2487,Nnamdi Collins,de GER,DF,20.0,16.5,33,24,24,7,2,17,22,77.3,5,22,11,11,16,49,74,3,Matches,Eintracht-Frankfurt,Bundesliga
2488,Fares Chaïbi,dz ALG,"MF,FW",21.0,11.3,13,9,4,5,4,7,20,35.0,13,10,0,10,10,23,32,1,Matches,Eintracht-Frankfurt,Bundesliga
2489,Jean Mattéo Bahoya,fr FRA,"MF,FW",19.0,10.2,29,18,11,13,5,16,26,61.5,10,14,2,12,4,33,10,1,Matches,Eintracht-Frankfurt,Bundesliga
2490,Kauã Santos,br BRA,GK,21.0,8.5,0,0,0,0,0,0,0,,0,0,0,0,0,0,10,2,Matches,Eintracht-Frankfurt,Bundesliga
2491,Oscar Højlund,dk DEN,MF,19.0,8.0,21,12,8,9,4,8,16,50.0,8,15,7,8,5,26,11,1,Matches,Eintracht-Frankfurt,Bundesliga
2492,Can Uzun,tr TUR,"MF,FW",18.0,7.5,10,4,1,4,5,5,10,50.0,5,9,0,9,1,11,3,0,Matches,Eintracht-Frankfurt,Bundesliga
2493,Niels Nkounkou,fr FRA,"DF,MF",23.0,4.2,13,10,7,3,3,4,7,57.1,3,5,2,3,7,20,15,0,Matches,Eintracht-Frankfurt,Bundesliga
2494,Mahmoud Dahoud,de GER,MF,28.0,4.0,9,4,4,5,0,4,6,66.7,2,5,1,4,2,11,5,0,Matches,Eintracht-Frankfurt,Bundesliga
2495,Michy Batshuayi,be BEL,FW,30.0,3.3,1,1,1,0,0,1,1,100.0,0,2,0,2,1,2,0,0,Matches,Eintracht-Frankfurt,Bundesliga
2496,Junior Dina Ebimbe,fr FRA,"MF,FW",23.0,3.3,3,2,1,2,0,1,3,33.3,2,4,0,4,7,10,6,0,Matches,Eintracht-Frankfurt,Bundesliga
2497,Igor Matanovic,hr CRO,FW,21.0,3.5,2,0,0,2,0,0,1,0.0,1,3,0,3,1,3,9,0,Matches,Eintracht-Frankfurt,Bundesliga
2498,Elye Wahi,fr FRA,"FW,MF",21.0,2.2,0,0,0,0,0,0,1,0.0,1,1,0,1,0,0,1,0,Matches,Eintracht-Frankfurt,Bundesliga
2499,Aurele Amenda,ch SUI,DF,21.0,1.1,1,0,1,0,0,0,0,,0,2,2,0,2,3,11,0,Matches,Eintracht-Frankfurt,Bundesliga
2500,Timothy Chandler,us USA,DF,34.0,0.3,0,0,0,0,0,0,0,,0,0,0,0,3,3,2,0,Matches,Eintracht-Frankfurt,Bundesliga
2501,Ritsu Doan,jp JPN,"FW,MF",26.0,31.8,66,42,33,26,7,25,46,54.3,21,57,2,55,14,80,47,1,Matches,Freiburg,Bundesliga
2502,Maximilian Eggestein,de GER,MF,27.0,31.6,57,32,21,26,10,24,43,55.8,19,37,10,27,39,96,54,1,Matches,Freiburg,Bundesliga
2503,Philipp Lienhart,at AUT,DF,28.0,30.8,22,13,12,10,0,15,31,48.4,16,31,20,11,36,58,124,3,Matches,Freiburg,Bundesliga
2504,Vincenzo Grifo,it ITA,"FW,MF",31.0,27.0,30,22,12,13,5,15,34,44.1,19,24,2,22,9,39,23,2,Matches,Freiburg,Bundesliga
2505,Matthias Ginter,de GER,DF,30.0,28.5,30,17,15,11,4,15,28,53.6,13,35,23,12,19,49,146,5,Matches,Freiburg,Bundesliga
2506,Christian Günter,de GER,DF,31.0,25.7,23,21,12,8,3,16,29,55.2,13,24,10,14,8,31,50,1,Matches,Freiburg,Bundesliga
2507,Patrick Osterhage,de GER,MF,24.0,25.2,45,29,16,27,2,14,30,46.7,16,27,3,24,18,63,37,0,Matches,Freiburg,Bundesliga
2508,Noah Atubolu,de GER,GK,22.0,25.6,0,0,0,0,0,0,0,,0,0,0,0,0,0,13,4,Matches,Freiburg,Bundesliga
2509,Lukas Kübler,de GER,DF,31.0,20.5,40,21,17,20,3,27,48,56.3,21,32,13,19,53,93,61,3,Matches,Freiburg,Bundesliga
2510,Lucas Höler,de GER,"FW,MF",30.0,20.7,37,24,18,15,4,9,24,37.5,15,29,7,22,7,44,36,0,Matches,Freiburg,Bundesliga
2511,Junior Adamu,at AUT,FW,23.0,17.2,9,3,3,3,3,3,11,27.3,8,14,0,14,12,21,20,0,Matches,Freiburg,Bundesliga
2512,Max Rosenfelder,de GER,DF,21.0,13.9,27,17,17,10,0,14,19,73.7,5,17,9,8,7,34,65,0,Matches,Freiburg,Bundesliga
2513,Eren Dinkçi,de GER,"MF,FW",22.0,13.3,21,13,8,8,5,7,23,30.4,16,22,2,20,7,28,7,0,Matches,Freiburg,Bundesliga
2514,Merlin Röhl,de GER,"MF,FW",22.0,10.7,16,10,4,10,2,9,11,81.8,2,9,1,8,6,22,2,0,Matches,Freiburg,Bundesliga
2515,Kiliann Sildillia,fr FRA,DF,22.0,8.9,17,10,8,6,3,7,13,53.8,6,16,5,11,11,28,38,0,Matches,Freiburg,Bundesliga
2516,Florian Müller,de GER,GK,26.0,8.4,0,0,0,0,0,0,0,,0,0,0,0,0,0,3,0,Matches,Freiburg,Bundesliga
2517,Nicolas Höfler,de GER,MF,34.0,8.8,33,23,13,18,2,20,31,64.5,11,7,1,6,14,47,28,1,Matches,Freiburg,Bundesliga
2518,Jordy Makengo,fr FRA,DF,22.0,8.3,16,9,10,5,1,10,16,62.5,6,8,3,5,7,23,29,0,Matches,Freiburg,Bundesliga
2519,Michael Gregoritsch,at AUT,FW,30.0,7.1,4,2,1,0,3,1,5,20.0,4,2,1,1,1,5,10,0,Matches,Freiburg,Bundesliga
2520,Johan Manzambi,ch SUI,"FW,MF",18.0,3.7,8,2,1,3,4,1,4,25.0,3,6,0,6,4,12,7,0,Matches,Freiburg,Bundesliga
2521,Jan-Niklas Beste,de GER,"FW,MF",25.0,2.4,2,1,0,1,1,1,7,14.3,6,3,0,3,1,3,7,0,Matches,Freiburg,Bundesliga
2522,Florent Muslija,xk KVX,"FW,MF",26.0,1.9,5,4,3,1,1,2,2,100.0,0,0,0,0,1,6,1,0,Matches,Freiburg,Bundesliga
2523,Noah Weißhaupt,de GER,FW,22.0,0.9,0,0,0,0,0,0,1,0.0,1,0,0,0,0,0,1,0,Matches,Freiburg,Bundesliga
2524,Roland Sallai,hu HUN,"FW,MF",27.0,0.5,2,1,1,1,0,0,0,,0,0,0,0,1,3,0,0,Matches,Freiburg,Bundesliga
2525,Ifechukwu Ogbus,ch SUI,DF,18.0,0.2,1,1,0,0,1,0,1,0.0,1,0,0,0,1,2,2,0,Matches,Freiburg,Bundesliga
2526,Maximilian Philipp,de GER,"MF,FW",30.0,0.2,0,0,0,0,0,0,0,,0,0,0,0,0,0,0,0,Matches,Freiburg,Bundesliga
2527,Julian Weigl,de GER,MF,28.0,32.0,53,25,24,24,5,28,46,60.9,18,54,27,27,48,101,86,3,Matches,Monchengladbach,Bundesliga
2528,Ko Itakura,jp JPN,DF,27.0,31.0,40,29,23,16,1,21,34,61.8,13,41,22,19,28,68,171,0,Matches,Monchengladbach,Bundesliga
2529,Tim Kleindienst,de GER,FW,28.0,30.4,30,15,6,15,9,10,35,28.6,25,45,9,36,12,42,66,1,Matches,Monchengladbach,Bundesliga
2530,Joe Scally,us USA,DF,21.0,28.6,45,32,25,18,2,27,46,58.7,19,35,11,24,16,61,86,2,Matches,Monchengladbach,Bundesliga
2531,Robin Hack,de GER,"FW,MF",25.0,24.1,22,17,11,8,3,12,28,42.9,16,30,2,28,9,31,28,0,Matches,Monchengladbach,Bundesliga
2532,Nico Elvedi,ch SUI,DF,27.0,23.7,38,23,28,6,4,17,23,73.9,6,35,27,8,30,68,163,0,Matches,Monchengladbach,Bundesliga
2533,Lukas Ullrich,de GER,DF,20.0,21.1,25,16,18,6,1,15,42,35.7,27,26,9,17,23,48,74,1,Matches,Monchengladbach,Bundesliga
2534,Alassane Pléa,fr FRA,"MF,FW",31.0,21.1,7,3,0,2,5,4,13,30.8,9,11,0,11,2,9,7,1,Matches,Monchengladbach,Bundesliga
2535,Rocco Reitz,de GER,MF,22.0,20.3,52,24,24,24,4,24,43,55.8,19,39,16,23,53,105,59,2,Matches,Monchengladbach,Bundesliga
2536,Moritz Nicolas,de GER,GK,26.0,18.2,0,0,0,0,0,0,0,,0,1,0,1,1,1,8,1,Matches,Monchengladbach,Bundesliga
2537,Franck Honorat,fr FRA,FW,27.0,16.0,17,7,10,4,3,2,8,25.0,6,9,1,8,5,22,28,1,Matches,Monchengladbach,Bundesliga
2538,Kevin Stöger,at AUT,MF,30.0,17.2,37,21,23,10,4,16,39,41.0,23,24,3,21,16,53,26,3,Matches,Monchengladbach,Bundesliga
2539,Philipp Sander,de GER,MF,26.0,15.6,33,17,16,15,2,10,23,43.5,13,16,7,9,23,56,44,3,Matches,Monchengladbach,Bundesliga
2540,Jonas Omlin,ch SUI,GK,30.0,10.9,0,0,0,0,0,0,1,0.0,1,0,0,0,0,0,5,1,Matches,Monchengladbach,Bundesliga
2541,Marvin Friedrich,de GER,DF,28.0,11.0,15,9,12,3,0,9,16,56.3,7,16,12,4,5,20,57,0,Matches,Monchengladbach,Bundesliga
2542,Nathan N'Goumou,cm CMR,FW,24.0,9.2,17,11,11,4,2,6,11,54.5,5,8,2,6,4,21,16,0,Matches,Monchengladbach,Bundesliga
2543,Luca Netz,de GER,DF,21.0,10.8,24,14,14,8,2,13,19,68.4,6,17,4,13,10,34,36,0,Matches,Monchengladbach,Bundesliga
2544,Tomáš Čvančara,cz CZE,FW,23.0,9.2,4,1,3,1,0,2,7,28.6,5,6,3,3,5,9,17,0,Matches,Monchengladbach,Bundesliga
2545,Stefan Lainer,at AUT,DF,31.0,8.4,22,13,16,5,1,12,14,85.7,2,12,6,6,12,34,30,0,Matches,Monchengladbach,Bundesliga
2546,Tiago Cardoso,lu LUX,GK,18.0,4.2,1,0,1,0,0,1,1,100.0,0,0,0,0,0,1,2,2,Matches,Monchengladbach,Bundesliga
2547,Fabio Chiarodia,it ITA,DF,19.0,4.2,10,4,6,4,0,4,6,66.7,2,8,3,5,9,19,53,1,Matches,Monchengladbach,Bundesliga
2548,Florian Neuhaus,de GER,MF,27.0,4.2,10,3,7,3,0,7,17,41.2,10,9,2,7,6,16,5,1,Matches,Monchengladbach,Bundesliga
2549,Shiō Fukuda,jp JPN,FW,20.0,0.7,0,0,0,0,0,0,0,,0,1,0,1,0,0,0,0,Matches,Monchengladbach,Bundesliga
2550,Tobias Sippel,de GER,GK,36.0,0.7,0,0,0,0,0,0,0,,0,0,0,0,0,0,0,0,Matches,Monchengladbach,Bundesliga
2551,Grant Ranos,am ARM,FW,21.0,0.2,1,0,0,1,0,0,1,0.0,1,2,0,2,0,1,0,0,Matches,Monchengladbach,Bundesliga
2552,Noah Pesch,hr CRO,FW,19.0,0.1,1,0,0,0,1,0,0,,0,0,0,0,0,1,0,0,Matches,Monchengladbach,Bundesliga
2553,Patrick Mainka,de GER,DF,29.0,34.0,58,30,36,20,2,35,55,63.6,20,61,36,25,68,126,206,0,Matches,Heidenheim,Bundesliga
2554,Kevin Müller,de GER,GK,33.0,32.7,3,2,3,0,0,3,3,100.0,0,0,0,0,0,3,13,4,Matches,Heidenheim,Bundesliga
2555,Jan Schöppner,de GER,MF,25.0,29.8,56,30,19,27,10,20,58,34.5,38,38,6,32,43,99,95,1,Matches,Heidenheim,Bundesliga
2556,Benedikt Gimber,de GER,DF,27.0,29.7,72,46,48,23,1,38,63,60.3,25,53,19,34,31,103,131,1,Matches,Heidenheim,Bundesliga
2557,Omar Traoré,de GER,DF,26.0,29.1,50,26,31,16,3,25,41,61.0,16,35,6,29,21,71,66,0,Matches,Heidenheim,Bundesliga
2558,Marvin Pieringer,de GER,"FW,MF",24.0,24.5,23,13,5,12,6,5,10,50.0,5,21,2,19,8,31,32,0,Matches,Heidenheim,Bundesliga
2559,Jonas Föhrenbach,de GER,DF,28.0,20.4,45,24,25,15,5,22,35,62.9,13,29,3,26,16,61,57,0,Matches,Heidenheim,Bundesliga
2560,Paul Wanner,de GER,"MF,FW",18.0,19.7,40,27,16,21,3,15,32,46.9,17,15,0,15,4,44,20,0,Matches,Heidenheim,Bundesliga
2561,Niklas Dorsch,de GER,MF,26.0,14.8,27,16,12,15,0,13,22,59.1,9,14,1,13,17,44,17,2,Matches,Heidenheim,Bundesliga
2562,Adrian Beck,de GER,"MF,FW",27.0,17.8,36,17,18,12,6,12,35,34.3,23,31,2,29,9,45,17,0,Matches,Heidenheim,Bundesliga
2563,Marnon Busch,de GER,"DF,MF",29.0,15.5,26,17,19,7,0,23,32,71.9,9,23,10,13,13,39,65,5,Matches,Heidenheim,Bundesliga
2564,Frans Krätzig,de GER,"DF,MF",21.0,13.5,32,18,14,12,6,12,21,57.1,9,12,1,11,17,49,15,0,Matches,Heidenheim,Bundesliga
2565,Tim Siersleben,de GER,DF,24.0,13.1,21,14,12,8,1,7,17,41.2,10,19,6,13,20,41,66,0,Matches,Heidenheim,Bundesliga
2566,Léo Scienza,br BRA,"FW,MF",25.0,12.8,17,12,10,5,2,7,18,38.9,11,13,1,12,5,22,9,1,Matches,Heidenheim,Bundesliga
2567,Mathias Honsak,at AUT,"FW,DF",27.0,13.1,15,8,10,5,0,10,23,43.5,13,19,4,15,10,25,31,0,Matches,Heidenheim,Bundesliga
2568,Budu Zivzivadze,ge GEO,FW,30.0,10.6,17,11,1,9,7,4,8,50.0,4,9,0,9,3,20,7,0,Matches,Heidenheim,Bundesliga
2569,Lennard Maloney,us USA,MF,24.0,8.4,20,11,12,7,1,14,23,60.9,9,9,2,7,14,34,38,0,Matches,Heidenheim,Bundesliga
2570,Luca Kerber,de GER,"MF,DF",22.0,8.7,26,16,17,8,1,16,31,51.6,15,14,4,10,5,31,25,1,Matches,Heidenheim,Bundesliga
2571,Sirlord Conteh,de GER,"FW,MF",28.0,9.9,9,5,3,6,0,2,7,28.6,5,1,1,0,1,10,8,0,Matches,Heidenheim,Bundesliga
2572,Mikkel Kaufmann,dk DEN,FW,23.0,4.1,6,4,1,3,2,2,5,40.0,3,5,2,3,2,8,7,0,Matches,Heidenheim,Bundesliga
2573,Maximilian Breunig,de GER,"FW,MF",23.0,3.9,4,3,1,2,1,3,6,50.0,3,9,2,7,1,5,3,0,Matches,Heidenheim,Bundesliga
2574,Thomas Keller,de GER,"DF,MF",24.0,1.6,6,5,5,1,0,4,6,66.7,2,3,1,2,4,10,11,0,Matches,Heidenheim,Bundesliga
2575,Frank Feller,de GER,GK,20.0,1.3,0,0,0,0,0,0,0,,0,0,0,0,0,0,1,0,Matches,Heidenheim,Bundesliga
2576,Stefan Schimmer,de GER,"FW,MF",30.0,2.7,2,0,1,1,0,1,2,50.0,1,1,0,1,0,2,4,0,Matches,Heidenheim,Bundesliga
2577,Julian Niehues,de GER,MF,23.0,1.7,3,1,3,0,0,1,5,20.0,4,1,0,1,0,3,8,0,Matches,Heidenheim,Bundesliga
2578,Norman Theuerkauf,de GER,MF,37.0,0.2,0,0,0,0,0,0,0,,0,0,0,0,0,0,0,0,Matches,Heidenheim,Bundesliga
2579,Denis Thomalla,de GER,MF,31.0,0.0,0,0,0,0,0,0,0,,0,0,0,0,0,0,0,0,Matches,Heidenheim,Bundesliga
2580,Andrej Kramarić,hr CRO,"MF,FW",33.0,30.7,15,8,5,8,2,6,11,54.5,5,16,3,13,7,22,11,1,Matches,Hoffenheim,Bundesliga
2581,Tom Bischof,de GER,"MF,FW",19.0,28.4,95,53,36,45,14,40,77,51.9,37,66,11,55,30,125,53,1,Matches,Hoffenheim,Bundesliga
2582,Anton Stach,de GER,"MF,DF",25.0,28.7,66,46,25,37,4,32,47,68.1,15,47,13,34,46,112,101,2,Matches,Hoffenheim,Bundesliga
2583,Oliver Baumann,de GER,GK,34.0,28.0,2,2,2,0,0,2,4,50.0,2,0,0,0,0,2,15,2,Matches,Hoffenheim,Bundesliga
2584,Arthur Chaves,br BRA,DF,23.0,24.3,51,36,28,19,4,25,50,50.0,25,47,20,27,37,88,136,3,Matches,Hoffenheim,Bundesliga
2585,Kevin Akpoguma,ng NGA,DF,29.0,24.7,54,27,36,12,6,30,46,65.2,16,65,37,28,29,83,115,1,Matches,Hoffenheim,Bundesliga
2586,Adam Hložek,cz CZE,"FW,MF",22.0,20.8,22,10,7,8,7,11,20,55.0,9,13,1,12,4,26,20,0,Matches,Hoffenheim,Bundesliga
2587,Marius Bülter,de GER,"FW,DF",31.0,19.2,13,10,5,6,2,9,17,52.9,8,10,3,7,4,17,14,1,Matches,Hoffenheim,Bundesliga
2588,Alexander Prass,at AUT,DF,23.0,17.4,42,23,24,15,3,24,59,40.7,35,33,6,27,9,51,53,4,Matches,Hoffenheim,Bundesliga
2589,Pavel Kadeřábek,cz CZE,DF,32.0,17.5,25,14,14,4,7,15,31,48.4,16,13,3,10,20,45,54,1,Matches,Hoffenheim,Bundesliga
2590,Stanley N'Soki,fr FRA,DF,25.0,14.5,22,16,13,7,2,12,23,52.2,11,22,7,15,26,48,58,3,Matches,Hoffenheim,Bundesliga
2591,Valentin Gendrey,fr FRA,DF,24.0,15.7,30,12,19,9,2,11,18,61.1,7,19,5,14,15,45,53,0,Matches,Hoffenheim,Bundesliga
2592,Leo Skiri Østigård,no NOR,DF,24.0,10.3,9,7,5,4,0,4,6,66.7,2,17,9,8,9,18,111,0,Matches,Hoffenheim,Bundesliga
2593,Florian Grillitsch,at AUT,MF,28.0,6.7,15,9,5,9,1,8,14,57.1,6,6,2,4,8,23,18,0,Matches,Hoffenheim,Bundesliga
2594,Dennis Geiger,de GER,"MF,FW",26.0,8.2,24,11,9,13,2,12,19,63.2,7,15,2,13,7,31,6,1,Matches,Hoffenheim,Bundesliga
2595,Gift Orban,ng NGA,FW,22.0,7.6,3,1,2,1,0,1,6,16.7,5,7,0,7,0,3,3,0,Matches,Hoffenheim,Bundesliga
2596,Finn Ole Becker,de GER,MF,24.0,7.4,11,5,4,6,1,1,4,25.0,3,7,3,4,10,21,20,0,Matches,Hoffenheim,Bundesliga
2597,Bazoumana Touré,ci CIV,"FW,MF",18.0,6.8,12,10,2,7,3,2,8,25.0,6,4,0,4,3,15,2,0,Matches,Hoffenheim,Bundesliga
2598,Haris Tabakovic,ba BIH,FW,30.0,9.1,3,1,1,0,2,0,3,0.0,3,4,2,2,1,4,16,0,Matches,Hoffenheim,Bundesliga
2599,David Jurásek,cz CZE,DF,23.0,6.9,6,3,3,2,1,2,5,40.0,3,5,0,5,6,12,17,0,Matches,Hoffenheim,Bundesliga
2600,Luca Philipp,de GER,GK,23.0,6.0,1,0,1,0,0,1,1,100.0,0,0,0,0,0,1,1,0,Matches,Hoffenheim,Bundesliga
2601,Diadie Samassékou,ml MLI,MF,28.0,3.2,5,5,1,2,2,2,4,50.0,2,4,2,2,5,10,5,0,Matches,Hoffenheim,Bundesliga
2602,Max Moerstedt,de GER,FW,,5.0,5,5,1,3,1,1,2,50.0,1,4,0,4,0,5,5,0,Matches,Hoffenheim,Bundesliga
2603,Tim Drexler,de GER,DF,19.0,4.0,17,7,11,6,0,9,12,75.0,3,6,4,2,1,18,9,1,Matches,Hoffenheim,Bundesliga
2604,Jacob Bruun Larsen,dk DEN,"FW,MF",25.0,4.4,4,3,1,2,1,3,8,37.5,5,5,1,4,1,5,2,0,Matches,Hoffenheim,Bundesliga
2605,Umut Tohumcu,de GER,"MF,FW",19.0,4.2,9,5,3,5,1,5,7,71.4,2,5,0,5,3,12,6,0,Matches,Hoffenheim,Bundesliga
2606,Mergim Berisha,de GER,"FW,MF",26.0,3.7,3,3,1,2,0,0,3,0.0,3,2,1,1,0,3,3,0,Matches,Hoffenheim,Bundesliga
2607,Erencan Yardimci,tr TUR,"FW,MF",22.0,3.5,4,3,1,3,0,1,2,50.0,1,2,0,2,1,5,2,0,Matches,Hoffenheim,Bundesliga
2608,Robin Hranáč,cz CZE,DF,24.0,2.4,0,0,0,0,0,0,1,0.0,1,3,2,1,5,5,9,1,Matches,Hoffenheim,Bundesliga
2609,Grischa Prömel,de GER,MF,29.0,1.9,0,0,0,0,0,0,1,0.0,1,1,1,0,2,2,4,0,Matches,Hoffenheim,Bundesliga
2610,Florian Micheler,at AUT,MF,19.0,0.4,0,0,0,0,0,0,2,0.0,2,0,0,0,0,0,0,0,Matches,Hoffenheim,Bundesliga
2611,Hannes Behrens,de GER,DF,,0.3,1,1,0,1,0,0,0,,0,1,0,1,2,3,0,0,Matches,Hoffenheim,Bundesliga
2612,David Mokwa,fr FRA,"DF,FW",20.0,0.2,1,0,1,0,0,0,0,,0,0,0,0,0,1,0,0,Matches,Hoffenheim,Bundesliga
2613,Paul Hennrich,de GER,MF,19.0,0.1,0,0,0,0,0,0,0,,0,1,1,0,0,0,0,0,Matches,Hoffenheim,Bundesliga
2614,Ihlas Bebou,tg TOG,MF,30.0,0.1,0,0,0,0,0,0,0,,0,0,0,0,0,0,0,0,Matches,Hoffenheim,Bundesliga
2615,Timo Becker,de GER,DF,27.0,27.2,53,33,39,9,5,34,46,73.9,12,30,17,13,17,70,110,1,Matches,Holstein-Kiel,Bundesliga
2616,Nicolai Remberg,de GER,MF,24.0,26.9,45,25,24,17,4,19,41,46.3,22,46,20,26,29,74,100,0,Matches,Holstein-Kiel,Bundesliga
2617,Timon Weiner,de GER,GK,25.0,25.0,0,0,0,0,0,0,1,0.0,1,0,0,0,0,0,17,3,Matches,Holstein-Kiel,Bundesliga
2618,Shuto Machino,jp JPN,"FW,MF",24.0,21.7,8,5,4,3,1,6,16,37.5,10,12,3,9,7,15,28,1,Matches,Holstein-Kiel,Bundesliga
2619,Armin Gigovic,ba BIH,MF,22.0,21.1,25,13,14,8,3,5,21,23.8,16,20,1,19,21,46,33,0,Matches,Holstein-Kiel,Bundesliga
2620,Magnus Knudsen,no NOR,MF,23.0,20.6,48,29,21,21,6,25,44,56.8,19,18,4,14,12,60,44,0,Matches,Holstein-Kiel,Bundesliga
2621,Lasse Rosenboom,de GER,DF,22.0,19.3,47,35,25,16,6,32,47,68.1,15,28,9,19,19,66,71,3,Matches,Holstein-Kiel,Bundesliga
2622,Finn Porath,de GER,"DF,MF",27.0,21.9,45,26,24,14,7,26,53,49.1,27,27,9,18,21,66,67,0,Matches,Holstein-Kiel,Bundesliga
2623,Marko Ivezić,rs SRB,DF,22.0,18.4,29,19,20,6,3,15,42,35.7,27,25,13,12,27,56,103,2,Matches,Holstein-Kiel,Bundesliga
2624,David Zec,si SVN,DF,24.0,17.1,23,10,17,6,0,13,20,65.0,7,32,18,14,17,40,93,3,Matches,Holstein-Kiel,Bundesliga
2625,Phil Harres,de GER,FW,22.0,17.2,10,10,3,4,3,4,8,50.0,4,17,3,14,5,15,20,0,Matches,Holstein-Kiel,Bundesliga
2626,Marco Komenda,hr CRO,DF,27.0,14.5,26,17,12,13,1,11,15,73.3,4,23,11,12,6,32,68,0,Matches,Holstein-Kiel,Bundesliga
2627,Steven Skrzybski,de GER,"MF,FW",31.0,14.7,19,6,7,6,6,7,24,29.2,17,16,0,16,11,30,11,0,Matches,Holstein-Kiel,Bundesliga
2628,Alexander Bernhardsson,se SWE,"FW,MF",25.0,14.0,29,15,9,9,11,20,31,64.5,11,14,0,14,5,34,25,0,Matches,Holstein-Kiel,Bundesliga
2629,Max Geschwill,de GER,DF,23.0,14.2,26,21,13,12,1,14,19,73.7,5,14,9,5,30,56,53,1,Matches,Holstein-Kiel,Bundesliga
2630,Lewis Holtby,de GER,MF,33.0,13.8,34,20,19,10,5,12,28,42.9,16,14,2,12,21,55,26,3,Matches,Holstein-Kiel,Bundesliga
2631,Patrick Erras,de GER,DF,29.0,9.2,8,5,6,2,0,2,9,22.2,7,13,11,2,9,17,64,0,Matches,Holstein-Kiel,Bundesliga
2632,Thomas Dähne,de GER,GK,30.0,9.0,0,0,0,0,0,0,0,,0,0,0,0,0,0,7,2,Matches,Holstein-Kiel,Bundesliga
2633,John Tolkin,us USA,"DF,MF",22.0,8.2,18,11,11,7,0,12,14,85.7,2,10,2,8,8,26,54,0,Matches,Holstein-Kiel,Bundesliga
2634,Benedikt Pichler,at AUT,FW,27.0,8.7,5,2,1,0,4,2,4,50.0,2,4,2,2,2,7,11,0,Matches,Holstein-Kiel,Bundesliga
2635,Carl Johansson,se SWE,DF,30.0,6.3,4,2,4,0,0,3,7,42.9,4,12,8,4,10,14,54,1,Matches,Holstein-Kiel,Bundesliga
2636,Tymoteusz Puchacz,pl POL,DF,25.0,4.4,9,4,6,3,0,5,7,71.4,2,4,1,3,3,12,11,0,Matches,Holstein-Kiel,Bundesliga
2637,Dominik Javorček,sk SVK,"DF,MF",21.0,4.3,3,0,3,0,0,1,5,20.0,4,7,3,4,5,8,26,1,Matches,Holstein-Kiel,Bundesliga
2638,Jann-Fiete Arp,de GER,"FW,MF",24.0,7.9,13,10,5,2,6,4,13,30.8,9,6,0,6,3,16,8,1,Matches,Holstein-Kiel,Bundesliga
2639,Marvin Schulz,de GER,"MF,DF",29.0,3.4,6,5,2,2,2,2,8,25.0,6,12,8,4,0,6,17,0,Matches,Holstein-Kiel,Bundesliga
2640,Andu Kelati,de GER,"MF,DF",21.0,3.2,7,4,2,4,1,2,5,40.0,3,4,1,3,3,10,3,0,Matches,Holstein-Kiel,Bundesliga
2641,Ivan Nekić,hr CRO,DF,23.0,0.8,1,1,1,0,0,1,2,50.0,1,1,0,1,3,4,2,0,Matches,Holstein-Kiel,Bundesliga
2642,Jonathan Tah,de GER,DF,28.0,33.0,19,12,12,6,1,10,16,62.5,6,22,16,6,36,55,157,2,Matches,Bayer-Leverkusen,Bundesliga
2643,Granit Xhaka,ch SUI,MF,31.0,32.1,48,26,15,27,6,24,42,57.1,18,30,7,23,12,60,52,6,Matches,Bayer-Leverkusen,Bundesliga
2644,Álex Grimaldo,es ESP,DF,28.0,29.3,24,14,13,7,4,16,42,38.1,26,22,3,19,16,40,43,3,Matches,Bayer-Leverkusen,Bundesliga
2645,Lukáš Hrádecký,fi FIN,GK,34.0,29.0,0,0,0,0,0,0,1,0.0,1,0,0,0,0,0,8,2,Matches,Bayer-Leverkusen,Bundesliga
2646,Edmond Tapsoba,bf BFA,DF,25.0,27.9,39,24,19,16,4,22,39,56.4,17,21,14,7,24,63,89,3,Matches,Bayer-Leverkusen,Bundesliga
2647,Piero Hincapié,ec ECU,DF,22.0,29.7,52,40,27,15,10,25,41,61.0,16,40,20,20,32,84,114,1,Matches,Bayer-Leverkusen,Bundesliga
2648,Florian Wirtz,de GER,"MF,FW",21.0,26.1,32,20,10,12,10,9,22,40.9,13,32,3,29,10,42,6,1,Matches,Bayer-Leverkusen,Bundesliga
2649,Jeremie Frimpong,nl NED,"DF,MF",23.0,25.7,33,25,14,12,7,16,29,55.2,13,25,0,25,8,41,22,1,Matches,Bayer-Leverkusen,Bundesliga
2650,Patrik Schick,cz CZE,FW,28.0,18.7,6,5,1,3,2,1,5,20.0,4,9,1,8,4,10,17,1,Matches,Bayer-Leverkusen,Bundesliga
2651,Robert Andrich,de GER,"MF,DF",29.0,17.8,24,12,8,14,2,7,14,50.0,7,16,8,8,29,53,23,0,Matches,Bayer-Leverkusen,Bundesliga
2652,Aleix García,es ESP,MF,27.0,16.2,13,7,4,6,3,7,15,46.7,8,12,2,10,11,24,24,1,Matches,Bayer-Leverkusen,Bundesliga
2653,Nathan Tella,ng NGA,"MF,FW",25.0,15.1,16,11,4,7,5,5,13,38.5,8,15,1,14,4,20,10,0,Matches,Bayer-Leverkusen,Bundesliga
2654,Victor Boniface,ng NGA,FW,23.0,11.2,5,4,0,3,2,3,4,75.0,1,1,0,1,0,5,5,0,Matches,Bayer-Leverkusen,Bundesliga
2655,Exequiel Palacios,ar ARG,MF,25.0,12.8,22,15,8,10,4,10,18,55.6,8,14,1,13,13,35,15,1,Matches,Bayer-Leverkusen,Bundesliga
2656,Nordi Mukiele,fr FRA,DF,26.0,10.0,20,16,8,8,4,12,18,66.7,6,10,0,10,16,36,37,2,Matches,Bayer-Leverkusen,Bundesliga
2657,Arthur,br BRA,DF,21.0,8.4,14,11,3,9,2,5,10,50.0,5,8,0,8,9,23,29,0,Matches,Bayer-Leverkusen,Bundesliga
2658,Martin Terrier,fr FRA,"MF,FW",27.0,6.5,4,2,1,0,3,1,4,25.0,3,3,0,3,1,5,1,0,Matches,Bayer-Leverkusen,Bundesliga
2659,Amine Adli,ma MAR,"MF,FW",24.0,8.5,15,9,4,2,9,4,11,36.4,7,11,0,11,0,15,4,0,Matches,Bayer-Leverkusen,Bundesliga
2660,Matej Kovar,cz CZE,GK,24.0,5.0,0,0,0,0,0,0,0,,0,0,0,0,0,0,0,1,Matches,Bayer-Leverkusen,Bundesliga
2661,Jonas Hofmann,de GER,"MF,DF",32.0,4.0,2,0,0,2,0,1,4,25.0,3,2,0,2,0,2,3,0,Matches,Bayer-Leverkusen,Bundesliga
2662,Mario Hermoso,es ESP,DF,29.0,3.3,0,0,0,0,0,0,0,,0,3,1,2,9,9,15,1,Matches,Bayer-Leverkusen,Bundesliga
2663,Emi Buendía,ar ARG,MF,27.0,2.9,6,5,1,4,1,5,8,62.5,3,6,0,6,0,6,0,0,Matches,Bayer-Leverkusen,Bundesliga
2664,Jeanuël Belocian,fr FRA,"DF,MF",19.0,0.8,1,1,1,0,0,1,1,100.0,0,0,0,0,0,1,2,0,Matches,Bayer-Leverkusen,Bundesliga
2665,Kaishu Sano,jp JPN,MF,23.0,33.8,61,36,22,31,8,25,52,48.1,27,66,14,52,65,126,56,1,Matches,Mainz-05,Bundesliga
2666,Anthony Caci,fr FRA,DF,27.0,29.8,60,40,23,25,12,28,44,63.6,16,33,8,25,27,87,47,2,Matches,Mainz-05,Bundesliga
2667,Robin Zentner,de GER,GK,29.0,32.0,2,1,2,0,0,1,2,50.0,1,0,0,0,0,2,31,4,Matches,Mainz-05,Bundesliga
2668,Phillipp Mwene,at AUT,DF,30.0,29.0,51,29,23,22,6,19,46,41.3,27,27,6,21,24,75,51,1,Matches,Mainz-05,Bundesliga
2669,Lee Jae-sung,kr KOR,MF,31.0,29.4,42,21,16,19,7,15,39,38.5,24,39,3,36,35,77,38,0,Matches,Mainz-05,Bundesliga
2670,Nadiem Amiri,de GER,MF,27.0,27.5,50,23,13,28,9,19,46,41.3,27,19,4,15,16,66,30,2,Matches,Mainz-05,Bundesliga
2671,Dominik Kohr,de GER,"DF,MF",30.0,25.5,62,46,34,21,7,35,55,63.6,20,43,24,19,42,104,127,0,Matches,Mainz-05,Bundesliga
2672,Jonathan Burkardt,de GER,FW,24.0,23.4,15,8,1,7,7,6,10,60.0,4,11,1,10,1,16,14,0,Matches,Mainz-05,Bundesliga
2673,Paul Nebel,de GER,MF,21.0,26.1,38,24,11,18,9,11,35,31.4,24,54,4,50,13,51,30,2,Matches,Mainz-05,Bundesliga
2674,Danny da Costa,de GER,DF,31.0,22.3,42,23,23,15,4,17,27,63.0,10,19,10,9,27,69,95,3,Matches,Mainz-05,Bundesliga
2675,Moritz Jenz,de GER,DF,25.0,17.8,36,20,18,18,0,16,21,76.2,5,23,14,9,30,66,128,2,Matches,Mainz-05,Bundesliga
2676,Stefan Bell,de GER,DF,32.0,16.0,22,12,16,6,0,9,14,64.3,5,16,14,2,28,50,107,1,Matches,Mainz-05,Bundesliga
2677,Andreas Hanche-Olsen,no NOR,DF,27.0,14.3,21,13,12,8,1,9,12,75.0,3,25,18,7,12,33,85,2,Matches,Mainz-05,Bundesliga
2678,Nelson Weiper,de GER,"FW,MF",19.0,7.8,5,4,2,3,0,2,4,50.0,2,5,0,5,2,7,5,1,Matches,Mainz-05,Bundesliga
2679,Maxim Leitsch,de GER,DF,26.0,7.5,12,4,6,4,2,7,9,77.8,2,12,4,8,10,22,42,1,Matches,Mainz-05,Bundesliga
2680,Armindo Sieb,de GER,"FW,MF",21.0,8.5,10,4,4,5,1,3,10,30.0,7,4,0,4,1,11,7,0,Matches,Mainz-05,Bundesliga
2681,Hong Hyunseok,kr KOR,MF,25.0,5.9,8,3,3,3,2,1,4,25.0,3,7,1,6,7,15,9,0,Matches,Mainz-05,Bundesliga
2682,Silvan Widmer,ch SUI,DF,31.0,5.6,11,5,3,6,2,8,12,66.7,4,7,1,6,5,16,27,0,Matches,Mainz-05,Bundesliga
2683,Nikolas Veratschnig,at AUT,"DF,MF",21.0,4.0,9,6,1,4,4,2,3,66.7,1,4,0,4,5,14,8,0,Matches,Mainz-05,Bundesliga
2684,Lasse Rieß,de GER,GK,23.0,2.0,0,0,0,0,0,0,0,,0,0,0,0,0,0,5,0,Matches,Mainz-05,Bundesliga
2685,Karim Onisiwo,at AUT,"MF,FW",32.0,1.2,1,1,0,0,1,0,0,,0,0,0,0,0,1,0,0,Matches,Mainz-05,Bundesliga
2686,Arnaud Nordin,fr FRA,"DF,MF",26.0,0.9,2,0,0,2,0,1,1,100.0,0,2,1,1,0,2,2,0,Matches,Mainz-05,Bundesliga
2687,Aymen Barkok,ma MAR,MF,26.0,0.8,2,1,1,1,0,1,1,100.0,0,1,1,0,2,4,0,0,Matches,Mainz-05,Bundesliga
2688,Lennard Maloney,us USA,MF,24.0,0.3,2,1,0,1,1,1,1,100.0,0,2,0,2,0,2,3,0,Matches,Mainz-05,Bundesliga
2689,Gabriel Vidovic,hr CRO,MF,20.0,0.0,0,0,0,0,0,0,0,,0,0,0,0,0,0,0,0,Matches,Mainz-05,Bundesliga
2690,Péter Gulácsi,hu HUN,GK,34.0,29.2,1,1,1,0,0,1,2,50.0,1,0,0,0,0,1,16,4,Matches,RB-Leipzig,Bundesliga
2691,Benjamin Šeško,si SVN,"FW,MF",21.0,26.4,7,3,0,4,3,3,11,27.3,8,15,4,11,5,12,20,0,Matches,RB-Leipzig,Bundesliga
2692,Loïs Openda,be BEL,"FW,MF",24.0,27.3,9,4,3,4,2,3,11,27.3,8,19,1,18,5,14,12,0,Matches,RB-Leipzig,Bundesliga
2693,Willi Orban,hu HUN,DF,31.0,24.7,38,21,23,14,1,23,32,71.9,9,45,31,14,21,59,169,4,Matches,RB-Leipzig,Bundesliga
2694,Xavi Simons,nl NED,MF,21.0,23.9,28,21,5,15,8,12,26,46.2,14,19,3,16,12,40,19,1,Matches,RB-Leipzig,Bundesliga
2695,David Raum,de GER,DF,26.0,19.8,38,28,16,14,8,20,35,57.1,15,25,8,17,9,47,47,4,Matches,RB-Leipzig,Bundesliga
2696,Nicolas Seiwald,at AUT,"MF,DF",23.0,23.2,53,31,19,29,5,25,50,50.0,25,43,10,33,31,84,76,2,Matches,RB-Leipzig,Bundesliga
2697,Lukas Klostermann,de GER,DF,28.0,20.4,27,14,18,7,2,14,24,58.3,10,31,17,14,24,51,143,3,Matches,RB-Leipzig,Bundesliga
2698,Christoph Baumgartner,at AUT,MF,24.0,17.9,44,28,13,19,12,17,42,40.5,25,45,9,36,12,56,24,2,Matches,RB-Leipzig,Bundesliga
2699,Kevin Kampl,si SVN,MF,33.0,17.7,27,18,11,10,6,16,26,61.5,10,25,6,19,24,51,25,0,Matches,RB-Leipzig,Bundesliga
2700,Castello Lukeba,fr FRA,DF,21.0,17.5,31,17,15,12,4,17,24,70.8,7,29,12,17,17,48,74,0,Matches,RB-Leipzig,Bundesliga
2701,Arthur Vermeeren,be BEL,MF,19.0,17.5,32,19,14,13,5,14,47,29.8,33,34,12,22,23,55,25,2,Matches,RB-Leipzig,Bundesliga
2702,Lutsharel Geertruida,nl NED,DF,24.0,17.3,35,24,24,11,0,15,31,48.4,16,15,4,11,16,51,59,4,Matches,RB-Leipzig,Bundesliga
2703,Antonio Nusa,no NOR,"MF,DF",19.0,17.3,30,17,16,9,5,18,36,50.0,18,22,2,20,8,38,11,0,Matches,RB-Leipzig,Bundesliga
2704,Amadou Haidara,ml MLI,MF,26.0,14.7,30,17,12,16,2,12,29,41.4,17,42,12,30,18,48,56,1,Matches,RB-Leipzig,Bundesliga
2705,Ridle Baku,de GER,"DF,MF",26.0,14.2,24,19,9,13,2,9,23,39.1,14,18,2,16,9,33,45,0,Matches,RB-Leipzig,Bundesliga
2706,El Chadaille Bitshiabu,fr FRA,DF,19.0,12.6,27,18,17,9,1,10,19,52.6,9,25,14,11,13,40,97,2,Matches,RB-Leipzig,Bundesliga
2707,Benjamin Henrichs,de GER,DF,27.0,10.4,32,16,18,10,4,14,27,51.9,13,22,3,19,15,47,33,0,Matches,RB-Leipzig,Bundesliga
2708,Kosta Nedeljković,rs SRB,DF,18.0,5.3,11,8,5,6,0,6,10,60.0,4,6,4,2,2,13,14,0,Matches,RB-Leipzig,Bundesliga
2709,Maarten Vandevoordt,be BEL,GK,22.0,4.8,1,0,1,0,0,1,1,100.0,0,0,0,0,0,1,4,0,Matches,RB-Leipzig,Bundesliga
2710,Yussuf Poulsen,dk DEN,"FW,MF",30.0,4.2,10,5,2,6,2,4,8,50.0,4,7,2,5,0,10,14,0,Matches,RB-Leipzig,Bundesliga
2711,Xaver Schlager,at AUT,MF,26.0,2.0,4,2,2,1,1,3,7,42.9,4,7,0,7,0,4,3,0,Matches,RB-Leipzig,Bundesliga
2712,Tidiam Gomis,fr FRA,"MF,FW",17.0,1.7,0,0,0,0,0,0,0,,0,2,0,2,1,1,0,0,Matches,RB-Leipzig,Bundesliga
2713,Mohamed Simakan,fr FRA,DF,24.0,0.6,0,0,0,0,0,0,0,,0,0,0,0,2,2,0,0,Matches,RB-Leipzig,Bundesliga
2714,André Silva,pt POR,"FW,MF",28.0,1.5,1,1,1,0,0,0,1,0.0,1,1,0,1,1,2,2,0,Matches,RB-Leipzig,Bundesliga
2715,Assan Ouedraogo,de GER,MF,18.0,0.6,0,0,0,0,0,0,0,,0,1,0,1,0,0,0,0,Matches,RB-Leipzig,Bundesliga
2716,Elif Elmas,mk MKD,MF,24.0,0.5,3,1,3,0,0,1,3,33.3,2,2,0,2,0,3,2,0,Matches,RB-Leipzig,Bundesliga
2717,Viggo Gebel,de GER,MF,16.0,0.2,0,0,0,0,0,0,0,,0,0,0,0,0,0,0,0,Matches,RB-Leipzig,Bundesliga
2718,Faik Sakar,de GER,MF,16.0,0.0,0,0,0,0,0,0,0,,0,0,0,0,0,0,0,0,Matches,RB-Leipzig,Bundesliga
2719,Hauke Wahl,de GER,DF,30.0,33.0,36,27,21,13,2,23,38,60.5,15,44,25,19,31,67,170,4,Matches,St-Pauli,Bundesliga
2720,Nikola Vasilj,ba BIH,GK,28.0,33.0,0,0,0,0,0,0,2,0.0,2,0,0,0,0,0,22,3,Matches,St-Pauli,Bundesliga
2721,Philipp Treu,de GER,"MF,DF",23.0,32.0,61,42,35,17,9,39,68,57.4,29,52,12,40,19,80,87,2,Matches,St-Pauli,Bundesliga
2722,Eric Smith,se SWE,"DF,MF",27.0,31.4,46,29,26,17,3,23,40,57.5,17,37,10,27,37,83,104,4,Matches,St-Pauli,Bundesliga
2723,Jackson Irvine,au AUS,MF,31.0,29.0,56,28,24,26,6,25,45,55.6,20,27,5,22,36,92,63,2,Matches,St-Pauli,Bundesliga
2724,Manolis Saliakas,gr GRE,"MF,DF",27.0,25.7,46,22,24,18,4,25,49,51.0,24,38,8,30,20,66,62,0,Matches,St-Pauli,Bundesliga
2725,David Nemeth,at AUT,DF,23.0,23.7,43,29,25,16,2,25,43,58.1,18,29,11,18,18,61,94,2,Matches,St-Pauli,Bundesliga
2726,Johannes Eggestein,de GER,FW,26.0,20.6,5,3,0,2,3,1,5,20.0,4,5,0,5,0,5,8,0,Matches,St-Pauli,Bundesliga
2727,Morgan Guilavogui,gn GUI,"FW,MF",26.0,20.1,32,17,11,16,5,14,31,45.2,17,28,0,28,13,45,33,0,Matches,St-Pauli,Bundesliga
2728,Carlo Boukhalfa,ma MAR,MF,25.0,18.3,26,11,7,17,2,7,19,36.8,12,22,3,19,12,38,25,1,Matches,St-Pauli,Bundesliga
2729,Oladapo Afolayan,eng ENG,"FW,MF",26.0,18.2,17,8,4,8,5,7,19,36.8,12,17,1,16,8,25,20,0,Matches,St-Pauli,Bundesliga
2730,Danel Sinani,lu LUX,"FW,MF",27.0,13.9,14,11,2,7,5,6,14,42.9,8,12,1,11,1,15,13,0,Matches,St-Pauli,Bundesliga
2731,Noah Weißhaupt,de GER,"FW,MF",22.0,12.9,6,4,3,0,3,3,8,37.5,5,7,0,7,2,8,8,1,Matches,St-Pauli,Bundesliga
2732,Lars Ritzka,de GER,"DF,MF",26.0,10.2,49,29,28,16,5,25,41,61.0,16,16,2,14,11,60,41,0,Matches,St-Pauli,Bundesliga
2733,Siebe Van Der Heyden,be BEL,"DF,MF",26.0,9.7,17,10,10,7,0,8,18,44.4,10,8,4,4,17,34,43,2,Matches,St-Pauli,Bundesliga
2734,Karol Mets,ee EST,DF,31.0,10.0,13,8,6,7,0,4,7,57.1,3,9,3,6,12,25,60,0,Matches,St-Pauli,Bundesliga
2735,Elias Saad,tn TUN,"FW,MF",24.0,10.0,20,13,7,8,5,10,20,50.0,10,14,0,14,3,23,1,0,Matches,St-Pauli,Bundesliga
2736,James Sands,us USA,"MF,DF",24.0,5.0,15,6,5,8,2,4,4,100.0,0,5,1,4,5,20,8,0,Matches,St-Pauli,Bundesliga
2737,Robert Wagner,de GER,MF,21.0,4.5,8,3,2,6,0,4,13,30.8,9,8,0,8,2,10,12,0,Matches,St-Pauli,Bundesliga
2738,Connor Metcalfe,au AUS,"MF,FW",24.0,4.0,2,0,1,1,0,0,5,0.0,5,4,0,4,3,5,8,0,Matches,St-Pauli,Bundesliga
2739,Adam Dźwigała,pl POL,"DF,MF",28.0,4.1,20,10,13,6,1,11,16,68.8,5,6,1,5,4,24,28,0,Matches,St-Pauli,Bundesliga
2740,Ben Alexander Voll,de GER,GK,23.0,1.0,0,0,0,0,0,0,0,,0,0,0,0,0,0,0,0,Matches,St-Pauli,Bundesliga
2741,Scott Banks,sct SCO,"FW,MF",22.0,1.3,1,1,1,0,0,0,2,0.0,2,0,0,0,2,3,2,0,Matches,St-Pauli,Bundesliga
2742,Andreas Albers,dk DEN,FW,34.0,0.7,1,1,0,0,1,0,1,0.0,1,0,0,0,0,1,1,0,Matches,St-Pauli,Bundesliga
2743,Abdoulie Ceesay,gm GAM,FW,20.0,0.7,3,3,1,1,1,2,3,66.7,1,2,0,2,0,3,1,0,Matches,St-Pauli,Bundesliga
2744,Erik Ahlstrand,se SWE,"FW,MF",22.0,0.5,0,0,0,0,0,0,0,,0,1,0,1,1,1,1,0,Matches,St-Pauli,Bundesliga
2745,Maurides,br BRA,FW,30.0,0.0,0,0,0,0,0,0,0,,0,0,0,0,0,0,0,0,Matches,St-Pauli,Bundesliga
2746,Finley Stevens,wls WAL,DF,21.0,0.0,0,0,0,0,0,0,0,,0,0,0,0,0,0,0,0,Matches,St-Pauli,Bundesliga
2747,Alexander Nübel,de GER,GK,27.0,34.0,0,0,0,0,0,0,1,0.0,1,0,0,0,0,0,18,3,Matches,Stuttgart,Bundesliga
2748,Angelo Stiller,de GER,MF,23.0,30.5,49,27,18,25,6,14,30,46.7,16,29,9,20,26,75,50,4,Matches,Stuttgart,Bundesliga
2749,Atakan Karazor,,MF,27.0,29.1,59,29,19,28,12,29,57,50.9,28,39,7,32,32,91,51,1,Matches,Stuttgart,Bundesliga
2750,Maximilian Mittelstädt,de GER,DF,27.0,27.4,79,54,42,30,7,53,73,72.6,20,47,11,36,47,126,96,2,Matches,Stuttgart,Bundesliga
2751,Julian Chabot,de GER,DF,26.0,25.2,37,24,19,15,3,15,32,46.9,17,29,19,10,38,75,135,0,Matches,Stuttgart,Bundesliga
2752,Chris Führich,de GER,"MF,FW",26.0,22.0,15,10,5,5,5,13,27,48.1,14,23,2,21,6,21,19,0,Matches,Stuttgart,Bundesliga
2753,Enzo Millot,fr FRA,"MF,FW",22.0,20.5,30,13,10,15,5,12,35,34.3,23,27,0,27,13,43,6,1,Matches,Stuttgart,Bundesliga
2754,Jamie Leweling,de GER,"MF,FW",23.0,18.5,16,6,6,3,7,11,25,44.0,14,22,1,21,11,27,17,1,Matches,Stuttgart,Bundesliga
2755,Ermedin Demirović,ba BIH,FW,26.0,20.6,12,7,3,4,5,3,12,25.0,9,14,3,11,3,15,12,0,Matches,Stuttgart,Bundesliga
2756,Deniz Undav,de GER,"FW,MF",28.0,19.2,11,10,2,3,6,1,17,5.9,16,15,2,13,3,14,10,0,Matches,Stuttgart,Bundesliga
2757,Josha Vagnoman,de GER,"DF,MF",23.0,20.4,26,14,11,13,2,17,34,50.0,17,16,2,14,14,40,57,1,Matches,Stuttgart,Bundesliga
2758,Nick Woltemade,de GER,"FW,MF",22.0,18.0,10,7,2,4,4,6,10,60.0,4,23,2,21,1,11,15,1,Matches,Stuttgart,Bundesliga
2759,Anthony Rouault,fr FRA,DF,23.0,13.5,15,11,10,3,2,10,15,66.7,5,18,9,9,19,34,63,1,Matches,Stuttgart,Bundesliga
2760,Leonidas Stergiou,ch SUI,DF,22.0,9.5,24,13,9,11,4,16,19,84.2,3,16,5,11,14,38,39,0,Matches,Stuttgart,Bundesliga
2761,Ramon Hendriks,nl NED,DF,23.0,12.8,20,9,11,7,2,9,13,69.2,4,15,7,8,19,39,63,0,Matches,Stuttgart,Bundesliga
2762,Finn Jeltsch,de GER,DF,18.0,8.7,18,13,6,11,1,12,15,80.0,3,12,6,6,13,31,27,2,Matches,Stuttgart,Bundesliga
2763,Fabian Rieder,ch SUI,"MF,FW",22.0,9.6,17,14,4,9,4,7,23,30.4,16,10,1,9,10,27,7,1,Matches,Stuttgart,Bundesliga
2764,Anrie Chase,jp JPN,DF,20.0,8.2,10,4,6,4,0,5,7,71.4,2,10,6,4,9,19,35,0,Matches,Stuttgart,Bundesliga
2765,Ameen Al-Dakhil,be BEL,DF,22.0,4.8,6,6,4,2,0,4,4,100.0,0,12,8,4,9,15,30,1,Matches,Stuttgart,Bundesliga
2766,Pascal Stenzel,de GER,DF,28.0,3.2,3,2,1,0,2,2,5,40.0,3,5,1,4,2,5,6,0,Matches,Stuttgart,Bundesliga
2767,Jacob Bruun Larsen,dk DEN,"MF,FW",25.0,4.6,1,1,1,0,0,0,2,0.0,2,7,0,7,1,2,4,1,Matches,Stuttgart,Bundesliga
2768,El Bilal Touré,ml MLI,"FW,MF",22.0,4.0,4,1,1,1,2,3,3,100.0,0,1,0,1,0,4,1,0,Matches,Stuttgart,Bundesliga
2769,Yannik Keitel,de GER,MF,24.0,3.0,9,6,3,5,1,9,10,90.0,1,5,2,3,4,13,6,0,Matches,Stuttgart,Bundesliga
2770,Luca Jaquez,ch SUI,DF,21.0,2.8,3,0,3,0,0,1,3,33.3,2,2,0,2,3,6,4,0,Matches,Stuttgart,Bundesliga
2771,Frans Krätzig,de GER,DF,21.0,0.6,2,1,1,0,1,1,3,33.3,2,2,1,1,0,2,1,0,Matches,Stuttgart,Bundesliga
2772,Justin Diehl,de GER,"FW,DF",19.0,1.2,1,0,0,1,0,1,1,100.0,0,2,0,2,0,1,0,0,Matches,Stuttgart,Bundesliga
2773,Dan-Axel Zagadou,fr FRA,"DF,MF",25.0,0.3,0,0,0,0,0,0,0,,0,0,0,0,1,1,1,0,Matches,Stuttgart,Bundesliga
2774,Nikolas Nartey,dk DEN,MF,24.0,0.2,0,0,0,0,0,0,0,,0,0,0,0,0,0,4,0,Matches,Stuttgart,Bundesliga
2775,Jarzinho Malanga,de GER,DF,18.0,0.0,0,0,0,0,0,0,0,,0,0,0,0,0,0,0,0,Matches,Stuttgart,Bundesliga
2776,Danilho Doekhi,nl NED,DF,26.0,34.0,37,24,18,16,3,13,23,56.5,10,35,16,19,44,81,169,1,Matches,Union-Berlin,Bundesliga
2777,Rani Khedira,de GER,MF,30.0,30.3,68,40,30,35,3,24,38,63.2,14,33,11,22,44,112,55,0,Matches,Union-Berlin,Bundesliga
2778,Benedict Hollerbach,de GER,"FW,MF",23.0,28.2,43,22,8,23,12,21,51,41.2,30,35,0,35,2,45,13,1,Matches,Union-Berlin,Bundesliga
2779,Diogo Leite,pt POR,DF,25.0,28.3,64,32,43,17,4,33,50,66.0,17,61,25,36,57,121,162,1,Matches,Union-Berlin,Bundesliga
2780,Frederik Rønnow,dk DEN,GK,31.0,28.0,0,0,0,0,0,0,1,0.0,1,0,0,0,0,0,22,2,Matches,Union-Berlin,Bundesliga
2781,Janik Haberer,de GER,"MF,DF",30.0,18.8,39,29,16,21,2,26,44,59.1,18,16,0,16,17,56,37,0,Matches,Union-Berlin,Bundesliga
2782,Christopher Trimmel,at AUT,"DF,MF",37.0,19.3,38,25,23,14,1,28,42,66.7,14,14,6,8,18,56,92,0,Matches,Union-Berlin,Bundesliga
2783,Tom Rothe,de GER,"DF,MF",19.0,18.6,45,28,27,15,3,29,51,56.9,22,41,5,36,18,63,57,1,Matches,Union-Berlin,Bundesliga
2784,Leopold Querfeld,at AUT,DF,20.0,19.4,25,12,21,4,0,13,18,72.2,5,25,10,15,19,44,144,2,Matches,Union-Berlin,Bundesliga
2785,András Schäfer,hu HUN,MF,25.0,17.0,52,26,23,24,5,25,41,61.0,16,33,6,27,22,74,36,0,Matches,Union-Berlin,Bundesliga
2786,Jeong Woo-yeong,kr KOR,"MF,FW",24.0,14.0,10,7,5,5,0,3,11,27.3,8,10,1,9,11,21,11,0,Matches,Union-Berlin,Bundesliga
2787,Kevin Vogt,de GER,DF,32.0,15.2,12,8,7,5,0,8,13,61.5,5,16,8,8,9,21,75,1,Matches,Union-Berlin,Bundesliga
2788,Josip Juranović,hr CRO,"DF,MF",28.0,12.9,21,13,12,6,3,10,25,40.0,15,13,6,7,7,28,42,2,Matches,Union-Berlin,Bundesliga
2789,Tim Skarke,de GER,"FW,MF",27.0,12.9,14,11,5,8,1,10,19,52.6,9,7,0,7,5,19,17,0,Matches,Union-Berlin,Bundesliga
2790,Andrej Ilic,rs SRB,FW,24.0,10.4,2,2,0,2,0,0,6,0.0,6,7,3,4,5,7,6,1,Matches,Union-Berlin,Bundesliga
2791,Aljoscha Kemlein,de GER,MF,19.0,10.2,10,4,4,5,1,5,14,35.7,9,14,3,11,6,16,15,0,Matches,Union-Berlin,Bundesliga
2792,Robert Skov,dk DEN,"DF,MF",28.0,9.5,15,11,8,7,0,10,20,50.0,10,8,1,7,8,23,9,0,Matches,Union-Berlin,Bundesliga
2793,Jordan Pefok,us USA,FW,28.0,10.1,11,6,6,0,5,3,7,42.9,4,9,2,7,4,15,18,0,Matches,Union-Berlin,Bundesliga
2794,Yorbe Vertessen,be BEL,"MF,FW",23.0,8.0,6,3,3,2,1,2,8,25.0,6,6,0,6,3,9,6,0,Matches,Union-Berlin,Bundesliga
2795,Lucas Tousart,fr FRA,MF,27.0,6.2,17,9,6,9,2,5,12,41.7,7,11,4,7,7,24,27,0,Matches,Union-Berlin,Bundesliga
2796,Alexander Schwolow,de GER,GK,32.0,6.0,0,0,0,0,0,0,0,,0,0,0,0,0,0,2,1,Matches,Union-Berlin,Bundesliga
2797,László Bénes,sk SVK,"MF,FW",26.0,6.5,2,2,1,1,0,1,3,33.3,2,5,1,4,3,5,9,0,Matches,Union-Berlin,Bundesliga
2798,Ivan Prtajin,hr CRO,FW,28.0,1.8,3,2,0,1,2,0,0,,0,2,0,2,0,3,3,0,Matches,Union-Berlin,Bundesliga
2799,Marin Ljubicic,hr CRO,"FW,MF",22.0,3.1,2,1,0,2,0,1,3,33.3,2,2,0,2,0,2,7,0,Matches,Union-Berlin,Bundesliga
2800,Jérôme Roussillon,fr FRA,"DF,MF",31.0,1.5,0,0,0,0,0,0,2,0.0,2,0,0,0,2,2,7,0,Matches,Union-Berlin,Bundesliga
2801,David Preu,de GER,"MF,DF",19.0,1.3,1,1,0,1,0,0,2,0.0,2,4,2,2,0,1,2,0,Matches,Union-Berlin,Bundesliga
2802,Robin Gosens,de GER,DF,30.0,1.0,0,0,0,0,0,0,3,0.0,3,1,0,1,1,1,2,0,Matches,Union-Berlin,Bundesliga
2803,Kevin Volland,de GER,"FW,MF",32.0,0.7,0,0,0,0,0,0,0,,0,1,0,1,0,0,1,0,Matches,Union-Berlin,Bundesliga
2804,Michael Zetterer,de GER,GK,29.0,34.0,0,0,0,0,0,0,1,0.0,1,1,0,1,1,1,10,7,Matches,Werder-Bremen,Bundesliga
2805,Mitchell Weiser,de GER,"DF,MF",30.0,31.9,61,40,19,34,8,28,56,50.0,28,33,3,30,22,83,61,3,Matches,Werder-Bremen,Bundesliga
2806,Romano Schmid,at AUT,MF,24.0,31.5,43,25,10,22,11,24,51,47.1,27,42,3,39,11,54,9,2,Matches,Werder-Bremen,Bundesliga
2807,Senne Lynen,be BEL,MF,25.0,30.4,72,39,36,30,6,39,69,56.5,30,56,13,43,65,137,75,5,Matches,Werder-Bremen,Bundesliga
2808,Marvin Ducksch,de GER,FW,30.0,26.9,10,7,3,5,2,3,14,21.4,11,10,2,8,8,18,26,3,Matches,Werder-Bremen,Bundesliga
2809,Jens Stage,dk DEN,MF,27.0,24.5,49,30,22,24,3,25,46,54.3,21,44,10,34,18,67,42,2,Matches,Werder-Bremen,Bundesliga
2810,Marco Friedl,at AUT,DF,26.0,24.0,62,42,35,26,1,38,66,57.6,28,41,24,17,34,96,130,1,Matches,Werder-Bremen,Bundesliga
2811,Niklas Stark,de GER,DF,29.0,23.4,33,21,20,11,2,14,21,66.7,7,41,27,14,36,69,129,1,Matches,Werder-Bremen,Bundesliga
2812,Felix Agu,ng NGA,DF,24.0,19.5,30,14,12,14,4,12,23,52.2,11,27,9,18,21,51,48,0,Matches,Werder-Bremen,Bundesliga
2813,Anthony Jung,de GER,DF,32.0,21.1,34,22,22,11,1,22,34,64.7,12,23,14,9,25,59,77,1,Matches,Werder-Bremen,Bundesliga
2814,Amos Pieper,de GER,DF,26.0,16.6,32,17,16,11,5,21,33,63.6,12,28,17,11,24,56,98,1,Matches,Werder-Bremen,Bundesliga
2815,Derrick Köhn,de GER,"DF,FW",25.0,14.9,20,10,7,10,3,10,14,71.4,4,21,4,17,10,30,26,0,Matches,Werder-Bremen,Bundesliga
2816,Marco Grüll,at AUT,"FW,MF",26.0,13.1,12,9,1,5,6,4,17,23.5,13,14,2,12,3,15,10,0,Matches,Werder-Bremen,Bundesliga
2817,Miloš Veljković,rs SRB,DF,28.0,11.4,10,5,6,3,1,7,15,46.7,8,14,9,5,2,12,47,1,Matches,Werder-Bremen,Bundesliga
2818,Leonardo Bittencourt,de GER,MF,30.0,10.9,25,9,15,7,3,6,18,33.3,12,8,0,8,15,40,11,0,Matches,Werder-Bremen,Bundesliga
2819,Justin Njinmah,de GER,"FW,MF",23.0,10.6,6,2,1,4,1,3,5,60.0,2,5,0,5,3,9,1,0,Matches,Werder-Bremen,Bundesliga
2820,Oliver Burke,sct SCO,FW,27.0,10.1,11,4,5,1,5,4,6,66.7,2,20,0,20,2,13,6,0,Matches,Werder-Bremen,Bundesliga
2821,Julián Malatini,ar ARG,DF,23.0,5.0,11,9,5,5,1,5,11,45.5,6,8,3,5,7,18,17,0,Matches,Werder-Bremen,Bundesliga
2822,André Silva,pt POR,FW,28.0,4.2,2,2,1,1,0,0,1,0.0,1,3,1,2,0,2,3,0,Matches,Werder-Bremen,Bundesliga
2823,Issa Kaboré,bf BFA,"DF,FW",23.0,3.4,8,4,2,5,1,4,6,66.7,2,8,2,6,2,10,7,0,Matches,Werder-Bremen,Bundesliga
2824,Keke Maximilian Topp,de GER,"FW,MF",20.0,2.8,3,1,0,2,1,1,2,50.0,1,0,0,0,1,4,4,0,Matches,Werder-Bremen,Bundesliga
2825,Skelly Alvero,fr FRA,MF,22.0,2.6,11,6,5,5,1,4,5,80.0,1,4,0,4,2,13,10,0,Matches,Werder-Bremen,Bundesliga
2826,Olivier Deman,be BEL,DF,24.0,0.7,6,3,2,4,0,2,7,28.6,5,3,1,2,3,9,4,0,Matches,Werder-Bremen,Bundesliga
2827,Kamil Grabara,pl POL,GK,25.0,28.7,0,0,0,0,0,0,2,0.0,2,1,0,1,0,0,16,2,Matches,Wolfsburg,Bundesliga
2828,Mohamed Amoura,dz ALG,FW,24.0,27.4,29,22,14,5,10,14,37,37.8,23,42,2,40,9,38,24,0,Matches,Wolfsburg,Bundesliga
2829,Kilian Fischer,de GER,DF,23.0,25.5,64,44,48,12,4,47,89,52.8,42,41,8,33,19,83,98,2,Matches,Wolfsburg,Bundesliga
2830,Konstantinos Koulierakis,gr GRE,DF,20.0,27.4,40,20,25,13,2,25,40,62.5,15,34,14,20,33,73,147,2,Matches,Wolfsburg,Bundesliga
2831,Denis Vavro,sk SVK,DF,28.0,27.3,21,13,16,5,0,11,23,47.8,12,48,32,16,37,58,234,3,Matches,Wolfsburg,Bundesliga
2832,Maximilian Arnold,de GER,MF,30.0,26.2,34,20,13,18,3,15,33,45.5,18,21,11,10,24,58,70,2,Matches,Wolfsburg,Bundesliga
2833,Joakim Mæhle,dk DEN,DF,27.0,24.3,34,15,26,6,2,17,45,37.8,28,24,3,21,25,59,57,2,Matches,Wolfsburg,Bundesliga
2834,Tiago Tomás,pt POR,"FW,MF",22.0,20.9,33,19,15,11,7,15,35,42.9,20,17,4,13,9,42,19,0,Matches,Wolfsburg,Bundesliga
2835,Patrick Wimmer,at AUT,"MF,FW",23.0,19.7,47,35,19,21,7,15,46,32.6,31,31,4,27,32,79,15,2,Matches,Wolfsburg,Bundesliga
2836,Jonas Wind,dk DEN,"FW,MF",25.0,21.8,10,6,1,8,1,4,8,50.0,4,17,3,14,6,16,15,0,Matches,Wolfsburg,Bundesliga
2837,Bence Dárdai,hu HUN,MF,18.0,14.5,24,14,9,13,2,16,30,53.3,14,20,4,16,12,36,28,1,Matches,Wolfsburg,Bundesliga
2838,Yannick Gerhardt,de GER,"MF,DF",30.0,16.9,28,16,13,14,1,11,30,36.7,19,32,8,24,17,45,47,0,Matches,Wolfsburg,Bundesliga
2839,Mattias Svanberg,se SWE,MF,25.0,13.5,20,10,6,11,3,9,19,47.4,10,11,4,7,15,35,26,0,Matches,Wolfsburg,Bundesliga
2840,Ridle Baku,de GER,"FW,MF",26.0,13.0,23,15,9,9,5,8,19,42.1,11,22,1,21,15,38,15,0,Matches,Wolfsburg,Bundesliga
2841,Jakub Kamiński,pl POL,"DF,MF",22.0,12.6,17,8,8,3,6,9,22,40.9,13,17,7,10,13,30,23,1,Matches,Wolfsburg,Bundesliga
2842,Sebastiaan Bornauw,be BEL,DF,25.0,8.8,9,6,4,4,1,4,8,50.0,4,14,12,2,12,21,36,0,Matches,Wolfsburg,Bundesliga
2843,Aster Vranckx,be BEL,MF,21.0,6.2,11,6,3,8,0,3,9,33.3,6,14,3,11,10,21,13,0,Matches,Wolfsburg,Bundesliga
2844,Cedric Zesiger,ch SUI,DF,26.0,5.8,13,8,6,5,2,6,12,50.0,6,6,5,1,3,16,28,0,Matches,Wolfsburg,Bundesliga
2845,Marius Müller,de GER,GK,31.0,5.3,0,0,0,0,0,0,0,,0,0,0,0,0,0,0,0,Matches,Wolfsburg,Bundesliga
2846,Andreas Skov Olsen,dk DEN,"FW,MF",24.0,5.9,8,6,5,3,0,4,4,100.0,0,4,0,4,2,10,12,0,Matches,Wolfsburg,Bundesliga
2847,Lukas Nmecha,de GER,"FW,MF",25.0,5.2,2,0,1,1,0,0,1,0.0,1,3,0,3,2,4,4,0,Matches,Wolfsburg,Bundesliga
2848,Salih Özcan,tr TUR,MF,26.0,3.9,2,2,1,0,1,1,5,20.0,4,5,1,4,7,9,5,0,Matches,Wolfsburg,Bundesliga
2849,Lovro Majer,hr CRO,MF,26.0,3.4,2,1,0,1,1,1,5,20.0,4,5,1,4,1,3,2,1,Matches,Wolfsburg,Bundesliga
2850,Mads Roerslev,dk DEN,DF,25.0,3.3,10,9,8,1,1,6,9,66.7,3,2,2,0,5,15,16,0,Matches,Wolfsburg,Bundesliga
2851,David Odogu,de GER,DF,18.0,2.2,6,4,4,2,0,3,5,60.0,2,2,2,0,2,8,25,1,Matches,Wolfsburg,Bundesliga
2852,Kevin Paredes,us USA,DF,21.0,1.4,3,1,3,0,0,2,3,66.7,1,2,2,0,1,4,0,0,Matches,Wolfsburg,Bundesliga
2853,Kevin Behrens,de GER,FW,33.0,1.9,1,1,0,1,0,0,1,0.0,1,0,0,0,1,2,2,0,Matches,Wolfsburg,Bundesliga
